n,m,range,seed,mean,variance,period,chi,kp,km
26760,28099,1339,16083,2129253657.1657,1546423043325536205.4875,1340,5.7971,0.0156,0.0083
4471,13105,8634,7832,2164482013.225,1521591691008157293.9312,8635,15.7875,0.005,0.0127
14345,93946,79601,23615,2141332582.7414,1531390747474478644.6241,79602,15.5332,0.0035,0.001
15439,106718,91279,32761,2152369299.4656,1535516935469467541.2262,91280,5.1817,0.0003,0.0028
17946,55748,37802,27529,2142962787.2361,1538707762669538229.5376,37803,7.6693,0.0033,0.0012
29946,62212,32266,187,2129897648.7416,1553430500507439627.5495,32267,21.4082,0.0106,0.001
13471,107675,94204,7658,2151338549.4161,1539276200619062558.903,94205,2.985,0.0004,0.0028
13939,52906,38967,1641,2154872068.8246,1535528026728379598.5719,38968,8.5102,0.0008,0.0037
11866,92866,81000,7592,2145630418.1878,1545133594882840955.1595,81001,16.1406,0.0028,0.0015
22356,67920,45564,9715,2147442361.5666,1525794536350111983.0607,45565,7.9416,0.0032,0.0034
5221,101772,96551,16370,2143896357.2349,1542052187128291103.8935,96552,11.2537,0.0038,0.0012
27344,107837,80493,7356,2145024569.1957,1533682052884748381.2795,80494,1.8972,0.0017,0.0008
19198,93390,74192,2258,2156404257.8115,1531565259347967117.4544,74193,10.0995,0.0004,0.0044
15798,21327,5529,5708,2125609256.7297,1517585544715382890.4356,5530,8.4555,0.0121,0.0014
3177,41510,38333,32118,2137678198.0925,1545361043710284192.7966,38334,9.3682,0.0057,0.0019
10090,47423,37333,28782,2138762940.4283,1546821747798085273.1747,37334,7.1233,0.0064,0.0018
26995,88726,61731,18700,2157691927.3482,1533025683308951956.3713,61732,15.6667,0.0001,0.0054
30268,33513,3245,15069,2154758499.4125,1521528781617192050.9115,3246,3.9158,0.0058,0.0097
23005,71131,48126,2358,2143302720.1915,1540985441158428292.2,48127,8.0295,0.0044,0.0014
27569,47359,19790,26559,2173213326.4466,1521954603488666138.5153,19791,17.9779,0.0001,0.0123
2692,68415,65723,13687,2145401431.7506,1538918952617051936.2802,65724,5.5766,0.0028,0.0018
26167,81432,55265,24690,2162374810.7197,1540835090591338719.5151,55266,11.9067,0.0004,0.0062
7020,58734,51714,7401,2154574817.4704,1537911606515746955.2363,51715,6.7073,0.0003,0.0047
15245,16269,1024,18386,2071591121.5893,1567644774273173196.7181,1025,8.6787,0.041,0.0056
21537,67743,46206,24632,2144733252.5377,1531087604488005885.4709,46207,6.3731,0.0029,0.0019
10585,54262,43677,15655,2161314134.3809,1545769660379613137.7695,43678,7.5927,0.0001,0.0065
2641,44797,42156,31026,2152387661.9258,1537779144172331684.2073,42157,12.4511,0.0021,0.0037
28785,66549,37764,26450,2159695592.635,1535448960450431030.6026,37765,9.7373,0.0003,0.005
278,74715,74437,5901,2140439120.8446,1533263886066512466.6712,74438,10.164,0.0038,0.0008
1146,16557,15411,3543,2123980263.8223,1529224240113738788.0693,15412,18.5163,0.0133,0.0001
30406,52924,22518,30639,2131547414.1225,1543699888878678945.9698,22519,13.6084,0.0079,0.000
12647,66756,54109,1856,2150665102.8602,1538536881183511017.8748,54110,3.0967,0.0018,0.0026
7408,62631,55223,9127,2146608248.1533,1537454043717004790.3067,55224,8.4535,0.0018,0.0012
25228,39179,13951,9280,2163373801.2248,1543806822085027252.9632,13952,4.2747,0.0004,0.0075
17193,96082,78889,25108,2138990320.8073,1531173465846082815.2347,78890,11.3741,0.0043,0.0006
23389,103605,80216,174,2137625929.301,1542668343714996487.6647,80217,16.0971,0.0056,0.0005
20767,65140,44373,29512,2132069188.6415,1538980618752320559.6297,44374,13.1164,0.0076,0.0001
23083,26843,3760,26009,2141373899.3879,1518832888607166708.121,3761,7.4116,0.0084,0.0067
18821,51239,32418,30418,2145502025.7297,1546623673220819650.1704,32419,8.7295,0.005,0.0023
31265,57317,26052,15337,2156628226.3294,1519209320748819464.8803,26053,11.558,0.0044,0.0062
32697,72916,40219,28493,2163831746.5512,1545876864618934990.6194,40220,12.5378,0.000,0.0066
29671,117049,87378,29522,2146573526.0967,1534037198961094858.701,87379,2.7243,0.0012,0.0009
11687,85550,73863,26251,2146984245.0605,1546232490922386214.1513,73864,6.8346,0.0024,0.0022
1509,75181,73672,10689,2157386941.4218,1536425504886602690.7852,73673,5.6878,0.0003,0.0041
25659,69726,44067,12359,2146937411.4238,1542047762516610278.3593,44068,4.7227,0.0029,0.0023
23889,62003,38114,13867,2160538228.8819,1536709248987375635.0777,38115,7.1241,0.000,0.0056
2228,2492,264,13076,2060596326.2491,1488279016149325031.6965,265,5.575,0.0441,0.0053
16272,105236,88964,15571,2142124125.6807,1539754734242342618.7184,88965,6.4313,0.004,0.001
25452,45014,19562,847,2155809147.4511,1518444388362391298.9881,19563,8.6669,0.0037,0.0058
32204,100624,68420,2068,2151352240.8108,1532296542105494661.1387,68421,12.0377,0.0016,0.0039
1881,98015,96134,14943,2155505058.4662,1544225230666347876.0367,96135,11.591,0.0008,0.0039
27305,90960,63655,14100,2154067382.3219,1533721505164792390.2277,63656,7.9483,0.0003,0.0034
22426,101985,79559,25513,2151109234.2228,1545477505332944702.9483,79560,22.3627,0.0027,0.0034
5326,96260,90934,12826,2153529788.3795,1546473519540706811.3881,90935,14.841,0.0014,0.004
31703,90163,58460,11022,2153141249.0615,1537419497746948809.3441,58461,12.3799,0.0011,0.0034
24492,118260,93768,16541,2153112666.4376,1540253470800918535.2243,93769,5.2855,0.0005,0.0024
10845,54955,44110,5091,2151897167.9386,1533195203558724159.1884,44111,11.7341,0.0015,0.0045
22795,64350,41555,5220,2163481644.0173,1544909026895678760.2758,41556,13.7537,0.001,0.0067
3132,26627,23495,23668,2130692392.4384,1535152701225037298.4699,23496,19.3888,0.0076,0.000
4003,44989,40986,19903,2146514543.0055,1544690664284700498.167,40987,14.8723,0.0045,0.0036
2993,32528,29535,19331,2168802065.8359,1530627439364004143.9703,29536,17.5184,0.0004,0.0105
22415,97621,75206,13809,2152275280.4542,1528919125299712966.0148,75207,9.6617,0.0018,0.0034
669,76455,75786,17234,2156572604.8075,1541829145852448645.7985,75787,8.7524,0.000,0.004
3854,47028,43174,1025,2137556282.4487,1531232244460580081.5624,43175,12.2403,0.0047,0.0002
10111,36208,26097,9070,2156465273.8176,1515705648812625265.2052,26098,13.7376,0.0026,0.0071
23489,68114,44625,1585,2151441696.8024,1545797172948811215.0336,44626,6.5417,0.0013,0.0034
21941,23854,1913,14853,2133416013.9242,1533806656636325142.325,1914,4.5351,0.0156,0.0055
16752,22642,5890,20284,2150046450.9915,1538878081492420830.2851,5891,10.3022,0.007,0.0072
12262,76077,63815,29634,2136391042.639,1536608607110074013.2357,63816,15.5255,0.0055,0.0009
6232,97764,91532,4979,2150346045.4743,1536509531348970078.2364,91533,7.9045,0.001,0.003
8022,91267,83245,28665,2149202394.5254,1527873719356346510.858,83246,11.6302,0.0023,0.0029
7912,107486,99574,23150,2142624907.5232,1532696502479339965.8208,99575,8.8555,0.0029,0.0011
14710,104690,89980,5352,2156978387.0468,1539183279095636340.4008,89981,9.0795,0.0002,0.004
26416,87437,61021,21482,2151784981.397,1532421966471260162.9953,61022,6.4935,0.0005,0.0029
28208,113574,85366,23357,2144615822.5592,1539882256590443682.9117,85367,5.4829,0.002,0.0006
17178,57643,40465,7520,2137104336.6407,1538332640134229980.3607,40466,7.2416,0.0044,0.000
24398,63543,39145,12100,2148177436.961,1541935707712573200.0954,39146,6.5002,0.0024,0.0022
25142,110840,85698,25572,2145401031.8188,1540109787481743792.0542,85699,4.5032,0.0028,0.0008
17718,38405,20687,5165,2158443512.1667,1528475279397622494.9223,20688,10.219,0.002,0.0061
19794,101783,81989,8013,2136166269.842,1538028337722497605.6946,81990,24.5751,0.0061,0.0007
7805,62695,54890,21363,2150565579.4908,1527845115222746128.1374,54891,12.8656,0.0016,0.0038
21870,68103,46233,1900,2151166297.6729,1545151137614430176.3583,46234,5.8339,0.0014,0.0037
6719,55955,49236,23613,2144444370.5374,1522958880453360097.2505,49237,9.6118,0.004,0.0022
25506,83394,57888,21047,2149430963.564,1532790819456295526.9242,57889,3.0657,0.0013,0.0026
24465,85204,60739,24197,2152096242.4898,1532183145334319625.0866,60740,10.017,0.0016,0.0046
5775,84866,79091,10033,2154673125.2302,1537209751058716449.2265,79092,9.5335,0.0002,0.0037
13580,27450,13870,1277,2141964291.4759,1545659330555286208.0728,13871,6.1985,0.006,0.003
7754,84893,77139,19879,2142323660.2943,1531340511662252969.6744,77140,11.053,0.0033,0.0005
25306,66502,41196,30446,2148922792.4634,1535941141778012021.6038,41197,9.1666,0.0017,0.0031
12893,112175,99282,18258,2149884232.6205,1539439674686512955.3846,99283,3.5337,0.0005,0.0017
11425,85246,73821,15584,2152991722.8963,1547197820276588819.9966,73822,20.0357,0.0025,0.0059
22301,50149,27848,1976,2147271785.4634,1528377905385148564.4639,27849,15.3697,0.0026,0.0033
27487,116443,88956,23856,2145171966.9728,1545221620283387865.75,88957,5.8111,0.0023,0.0014
13836,25781,11945,8722,2149239882.5558,1526341010775786073.8928,11946,6.7349,0.0056,0.005
5225,42350,37125,10696,2153002931.0349,1534629586316343965.612,37126,6.029,0.0004,0.0031
12615,51906,39291,20277,2155660970.0613,1529029827292080218.6567,39292,20.4928,0.0011,0.0068
22926,62292,39366,19577,2150339462.5227,1524143517467748255.7464,39367,8.8416,0.0028,0.0035
30650,86871,56221,10765,2148967457.1713,1536445378246948643.6135,56222,9.3085,0.0014,0.0023
22910,102521,79611,11378,2144289529.8466,1544584182639026755.625,79612,10.7686,0.0031,0.001
10607,60202,49595,30581,2137614416.8846,1533491833818852171.1116,49596,16.9239,0.0053,0.0002
32552,47261,14709,16442,2152056085.4807,1514925026671499750.3002,14710,9.845,0.0035,0.0071
24437,65398,40961,15556,2140208264.5045,1519136647873860161.4592,40962,13.2194,0.0052,0.0026
10525,65162,54637,24943,2153795455.5697,1531784869445122288.362,54638,5.7873,0.0009,0.0034
24640,123675,99035,22667,2145537021.3838,1538771242393771978.8192,99036,10.5561,0.0031,0.002
13017,86586,73569,32567,2139491288.3269,1542094141039517558.011,73570,10.2759,0.0047,0.001
9341,93636,84295,22330,2139190352.4678,1536231634380115292.9284,84296,10.1808,0.0039,0.0003
22965,71182,48217,16431,2143872047.4207,1534960005609284772.3194,48218,11.7976,0.0036,0.002
5914,63592,57678,193,2151949285.917,1538958789375497008.6518,57679,11.5795,0.0013,0.0028
13809,99570,85761,10537,2146699132.8595,1536260366174154726.5713,85762,13.1869,0.0021,0.0016
7588,25001,17413,18547,2129450052.9202,1536778679038519651.8121,17414,16.9469,0.0077,0.0001
11371,18191,6820,23744,2181073475.2325,1531239215779467504.0881,6821,19.9698,0.000,0.0153
1483,79784,78301,1333,2149861497.4673,1544135700905133948.2948,78302,8.4566,0.0017,0.0033
14469,101316,86847,22105,2150263492.9886,1527776887494452277.197,86848,12.7744,0.0013,0.003
12144,29935,17791,1791,2173033976.9245,1538060817684972805.5015,17792,18.2049,0.0007,0.0128
9189,91646,82457,24632,2145092286.6041,1536612118623830262.7099,82458,1.7905,0.0017,0.0006
8970,69645,60675,14660,2143602819.6535,1530204883231303771.3224,60676,10.3061,0.0029,0.0016
17861,49831,31970,24388,2143568961.079,1522747461518874986.2633,31971,10.1118,0.0062,0.0034
3562,101037,97475,15044,2150063180.8269,1540442693912642397.1923,97476,8.5875,0.0009,0.0021
28267,109708,81441,23812,2135983921.7023,1544654419203318559.4932,81442,18.7547,0.0047,0.0008
28314,54233,25919,7090,2160142835.2926,1538818610852328612.7403,25920,3.9639,0.0008,0.0059
25636,67994,42358,6847,2136985274.5308,1535745517796922374.7543,42359,11.7059,0.0067,0.0009
15043,79589,64546,13933,2142410372.5985,1537098144674445165.5151,64547,13.568,0.0028,0.0006
22449,39734,17285,26733,2137263127.2894,1502993528969747352.3313,17286,29.3676,0.0097,0.0073
28984,86571,57587,26973,2145754235.6752,1533610251439293235.9658,57588,4.4157,0.0021,0.0014
30250,64050,33800,32583,2138051914.7786,1545977532888097095.2858,33801,17.0228,0.0049,0.0008
20958,120583,99625,25267,2151027114.5006,1534167979552412098.3574,99626,12.9626,0.0011,0.0029
845,3345,2500,26310,2153215597.6166,1566309152939464940.2332,2501,6.6984,0.0081,0.0124
2748,10716,7968,25463,2148936073.1513,1552730084134909450.7774,7969,5.5937,0.0062,0.0053
21476,32791,11315,16659,2186154808.2275,1555874772549673916.5352,11316,20.3135,0.0004,0.0144
7804,27888,20084,15508,2153189497.1942,1553309036584586976.4739,20085,4.6597,0.0031,0.0055
17308,37243,19935,27292,2160144397.8114,1545203500259607276.7534,19936,3.8559,0.0005,0.0059
25031,109355,84324,3664,2163425743.0053,1546847792827937268.785,84325,24.1511,0.0006,0.0074
23632,87185,63553,18569,2150369358.6441,1533809492557307053.6241,63554,6.8966,0.0018,0.0033
19211,65059,45848,23664,2158334275.3468,1543824659318973785.5521,45849,5.6606,0.0007,0.0058
6643,48897,42254,18686,2159340919.7207,1527044898112099805.0269,42255,16.1444,0.0001,0.0066
20292,107024,86732,8819,2142565412.5935,1540007671422884633.7396,86733,4.6887,0.0025,0.0003
30172,122602,92430,789,2143074760.2694,1536440197874813607.9771,92431,7.3409,0.003,0.0006
6133,54019,47886,30066,2148934331.8285,1538279916132563706.5018,47887,4.2369,0.0013,0.0018
20846,91320,70474,26033,2150522294.3925,1539328813729916431.6359,70475,6.1697,0.0006,0.0021
8963,78767,69804,27961,2144219969.5005,1541865164423859732.1834,69805,5.5232,0.0028,0.0009
31876,65258,33382,4409,2126186407.6913,1545365863048732757.9082,33383,24.6766,0.0098,0.000
1416,25459,24043,29221,2143932429.9871,1540552757211159340.7151,24044,24.1955,0.006,0.0024
3648,87428,83780,20177,2147148439.0786,1536079133048302156.9398,83781,8.0225,0.0023,0.0013
17551,63331,45780,21138,2150574213.8667,1537163499586323333.9116,45781,2.8467,0.0019,0.0039
16466,89046,72580,2750,2148405432.9776,1546332047881346955.3895,72581,6.9745,0.0018,0.0024
31333,75087,43754,17471,2143896723.8815,1534695974418847236.3924,43755,2.8205,0.0022,0.0005
8948,32411,23463,27623,2141877194.6292,1531633463555642070.4375,23464,10.3515,0.0049,0.0029
25675,52559,26884,18877,2147687211.9683,1532004065649209809.6995,26885,7.4114,0.0033,0.0034
23459,82416,58957,18308,2152759167.2849,1536848135256754277.9184,58958,3.5752,0.0004,0.003
31005,127037,96032,11697,2148742329.1791,1526477741917109495.7216,96033,8.5878,0.0025,0.0025
4593,80408,75815,13603,2150886009.404,1539805722948266390.4809,75816,17.1411,0.0018,0.0028
14881,75619,60738,30822,2153576422.4379,1531189528554184785.7938,60739,3.6245,0.0006,0.0035
8538,13634,5096,27508,2166403635.92,1549853995883600651.5306,5097,6.2212,0.0023,0.0104
21260,21784,524,24661,2249288796.6,1572669643805906877.7333,525,8.3933,0,0.0517
18883,49138,30255,27498,2136973104.216,1538741403977088560.7854,30256,16.0517,0.0051,0.0001
19887,71495,51608,28618,2160107028.8729,1526736040813729659.5377,51609,14.1763,0.0004,0.0057
25638,37873,12235,20550,2154553509.9073,1529325961964265314.1083,12236,2.9092,0.0025,0.0062
29345,88951,59606,21077,2160521456.8976,1530717024419022129.8131,59607,22.9551,0.0001,0.0047
27554,120702,93148,14282,2149724484.0814,1536798200164594617.011,93149,6.396,0.0008,0.0022
19754,91363,71609,19329,2146157744.5082,1547943641453798782.2943,71610,9.3529,0.0032,0.0023
9275,68701,59426,18969,2159099504.4492,1542713426932501421.1485,59427,9.5035,0.0002,0.0043
19676,72671,52995,21251,2131356950.8275,1527326341045064112.0873,52996,30.1713,0.0074,0.000
12743,29718,16975,23246,2163027939.2078,1555703184514307897.3088,16976,10.5142,0.003,0.0093
24829,58315,33486,11341,2134817502.635,1549061333457295241.6751,33487,16.5929,0.006,0.000
16666,105604,88938,26336,2159894383.9813,1531614453444887177.6832,88939,18.8559,0.0004,0.0058
6413,83222,76809,22599,2153986250.3855,1535252080757686429.8062,76810,14.8237,0.0004,0.003
24336,79661,55325,26096,2146284473.9391,1531405556290465660.6493,55326,11.4039,0.0027,0.0016
3277,39547,36270,6991,2141664032.8911,1536373151394168328.325,36271,7.2996,0.0034,0.0004
12998,33323,20325,2760,2158405352.9885,1522941590353914780.5504,20326,7.1688,0.0012,0.0063
7941,89608,81667,10229,2152386331.7349,1538807562902658611.4482,81668,8.0795,0.0009,0.0026
7936,51121,43185,4906,2153432373.0916,1526050510045358528.673,43186,7.9984,0.0013,0.0038
18419,91210,72791,28362,2140295340.4871,1538253015117346726.0796,72792,12.6525,0.0036,0.0004
25518,92814,67296,2662,2144400638.0981,1544556511660375376.1233,67297,3.7209,0.0026,0.0013
1370,92568,91198,12174,2153130614.8526,1549509414811367173.5099,91199,16.0612,0.0017,0.0043
21213,108789,87576,22899,2161437821.146,1540601282191593175.0524,87577,15.5225,0.0002,0.006
12847,107810,94963,25355,2141864383.1949,1536868517825169338.0947,94964,5.8206,0.0029,0.0002
17431,33614,16183,2060,2148271980.8772,1528514667951052028.9515,16184,7.632,0.003,0.0042
1651,48994,47343,9579,2160966678.428,1530459124416634232.8954,47344,10.5061,0.0015,0.0067
23225,58359,35134,22630,2147704248.6057,1536498702471954500.1277,35135,4.8338,0.0024,0.0025
21421,81328,59907,21162,2145868754.9825,1528177097522950801.8337,59908,10.690,0.003,0.0024
24328,53933,29605,25106,2134188418.2251,1546569416376941733.8796,29606,17.3828,0.0074,0.0002
10531,108227,97696,32305,2156161109.0795,1530866451173680190.127,97697,13.3663,0.0007,0.0049
4433,64809,60376,32671,2147736679.1492,1531785163749266939.4826,60377,13.0786,0.0027,0.002
18103,67150,49047,17889,2131038439.8484,1531857494593273275.8807,49048,11.7829,0.0064,0.000
26858,30794,3936,14013,2132012106.7455,1530745030619427062.7556,3937,6.7413,0.0114,0.0018
21341,51631,30290,10494,2136514352.7405,1534881826903805879.7547,30291,6.9011,0.0051,0.0007
24894,85820,60926,32223,2148129264.1972,1529939657465817671.1028,60927,3.1342,0.002,0.0021
976,14820,13844,4659,2137889187.2839,1527937384455425736.246,13845,5.1494,0.0084,0.0018
30923,95822,64899,10159,2146250480.0283,1541134212629214778.994,64900,7.6647,0.0025,0.0015
6159,21281,15122,24058,2121530169.4727,1522127235762632740.2768,15123,19.4592,0.011,0.0004
30186,97524,67338,13365,2148816308.7891,1546385758095072407.9772,67339,8.5579,0.0025,0.0022
12512,54402,41890,104,2146402051.1163,1549012540158110039.4927,41891,10.0292,0.0037,0.0029
21119,66975,45856,16772,2152953690.6821,1530996440751484509.3393,45857,7.8537,0.0014,0.0035
3241,34924,31683,1620,2150856531.6199,1540262012022247324.4457,31684,10.0874,0.0025,0.0037
6916,77287,70371,21278,2152626414.109,1530025216418528835.9896,70372,7.0423,0.0011,0.0036
3972,91645,87673,17801,2152435616.977,1551714379793193724.9246,87674,22.5278,0.002,0.0041
31724,72053,40329,1330,2155897450.1777,1538857731589900313.4628,40330,7.9941,0.0008,0.0035
18308,39361,21053,31825,2145048958.0551,1549202217543282235.6751,21054,13.3022,0.0048,0.0032
20323,59730,39407,9804,2152030389.1736,1541494479116725180.3952,39408,8.4942,0.0021,0.0031
26290,32017,5727,21150,2157807886.6508,1550532360246851909.5178,5728,12.6862,0.0056,0.0106
16882,80711,63829,18616,2153757498.3042,1544852721169799191.6305,63830,6.8039,0.0011,0.0043
26616,82376,55760,27,2157558471.8811,1521530198054581593.3527,55761,20.7185,0.0014,0.0068
3159,14570,11411,28358,2147200424.9518,1560261440601128058.8454,11412,13.5995,0.006,0.0063
12271,29310,17039,17734,2149118650.9986,1541051029440720985.3939,17040,7.5986,0.0036,0.0046
10854,85215,74361,19410,2127754829.6994,1537221473689516825.0987,74362,26.7668,0.0074,0.0001
631,39216,38585,7137,2133574912.5671,1536871072226995110.808,38586,11.9695,0.0061,0.000
7829,55581,47752,27981,2159630113.1046,1533574648115738025.4028,47753,12.0447,0.000,0.0049
32663,87348,54685,15419,2149020423.8648,1528916579225685881.4815,54686,10.5505,0.0016,0.0022
27154,32919,5765,2078,2152937396.202,1528564744296071376.5209,5766,1.5458,0.005,0.0081
10600,15931,5331,3398,2148410480.3942,1551426197778857146.9192,5332,22.1017,0.0107,0.0098
6094,56094,50000,7102,2149330678.7575,1537716922930402463.7703,50001,3.0771,0.0015,0.0029
32129,42702,10573,28694,2146684930.9239,1546156482027845266.2513,10574,5.7151,0.0044,0.0065
21301,85705,64404,32233,2141194985.5029,1531135801876567025.7696,64405,7.2963,0.0044,0.001
866,99682,98816,24020,2148387337.7452,1533651736822322789.2777,98817,13.2701,0.0017,0.0018
11101,107004,95903,17180,2155617385.8604,1542323360760688266.7721,95904,8.7449,0.0002,0.0036
16539,81020,64481,12459,2137920215.2737,1532697988300984896.9006,64482,13.2808,0.0054,0.0006
30961,76491,45530,24940,2162401562.9908,1539429422746163970.0681,45531,19.4753,0.000,0.0061
11183,68663,57480,17418,2144828217.9941,1535724907777383076.0732,57481,11.8124,0.0025,0.0021
18361,35927,17566,4659,2151553500.9277,1538366313354654262.0769,17567,1.946,0.0023,0.0036
3984,96998,93014,5373,2149043178.772,1542352335009375067.4362,93015,18.7908,0.003,0.0025
3177,50624,47447,27908,2152623769.7226,1537453493860655505.9196,47448,9.2524,0.0012,0.0034
23610,38359,14749,11474,2127701580.4123,1570969059129902387.5417,14750,19.3024,0.012,0.0026
23133,45198,22065,19601,2155757426.6096,1532920234654883875.8405,22066,5.159,0.0013,0.0048
1697,78723,77026,2666,2147068416.9169,1536177624060508806.4016,77027,2.7603,0.0016,0.0012
3314,20679,17365,12569,2167085137.6013,1528452548324335381.4619,17366,15.6422,0.0014,0.0121
1749,16668,14919,15513,2163036518.3676,1537108446811038025.0566,14920,16.6825,0.0024,0.0092
9967,63944,53977,20600,2139836366.2485,1533953049488422215.0726,53978,9.1006,0.0044,0.001
6345,51408,45063,667,2143797363.7613,1532121028358921042.3571,45064,8.1074,0.0029,0.0017
19545,29462,9917,9675,2152716290.0215,1549081663460077770.3866,9918,1.8629,0.0029,0.0058
2504,91546,89042,21068,2143528847.3928,1530249488868293227.7064,89043,18.397,0.0034,0.0019
7910,55134,47224,15302,2155120888.2874,1550443498958422967.6899,47225,16.7518,0.0022,0.0062
29119,68403,39284,21602,2148042505.9875,1533326558856551203.1372,39285,4.2844,0.0019,0.002
5709,6228,519,18967,2202005221.5923,1441169316170067701.2569,520,6.6548,0.0119,0.0328
24962,37847,12885,30396,2169013637.2849,1536479512289353424.1938,12886,9.9395,0.000,0.009
31686,129326,97640,9917,2154825823.056,1541737075702629316.3566,97641,11.1065,0.0001,0.004
29091,49174,20083,15098,2138781336.4158,1530855041566968443.3528,20084,16.2118,0.0051,0.0014
5259,26381,21122,32171,2140871840.904,1548701998865946893.3183,21123,11.2127,0.0055,0.0024
3721,56594,52873,2105,2159722551.5519,1534383591392358302.6536,52874,17.1165,0.0004,0.0071
9062,72504,63442,20268,2155343071.4137,1534906968370767581.3067,63443,9.1962,0.0002,0.0036
739,31399,30660,14137,2137201693.8149,1527227889476015599.5669,30661,6.1013,0.0054,0.0015
12923,74286,61363,28895,2149374809.8615,1543692722587442561.4802,61364,5.9309,0.0015,0.002
6658,85737,79079,12021,2156384549.046,1537292449158647408.7915,79080,7.6813,0.0003,0.0047
1234,51063,49829,8804,2153911962.2164,1535864210258940364.7862,49830,15.0478,0.0003,0.0031
11390,48001,36611,20150,2143680107.9112,1536587884106612230.1698,36612,3.0377,0.0028,0.0007
14835,112328,97493,18876,2144886346.7749,1537332821005738015.3725,97494,2.1017,0.002,0.0007
31184,51427,20243,5138,2161263119.7403,1549099786911448401.8196,20244,15.6954,0.0017,0.0077
19586,91549,71963,2913,2149376626.6341,1531619196428989391.3307,71964,17.6819,0.0016,0.0026
15892,49794,33902,16007,2145039650.1905,1526733959789818942.0813,33903,8.4081,0.0037,0.0025
21019,80274,59255,5201,2138224715.7176,1549888126983784567.4601,59256,19.7703,0.0051,0.0012
10654,79017,68363,31050,2151008411.6528,1541883375962084829.6742,68364,21.7904,0.0022,0.0043
14350,89100,74750,25648,2147717369.6347,1540165568787443073.2727,74751,14.4343,0.0016,0.0012
15471,28618,13147,30859,2156391332.4687,1546786718788236897.0306,13148,11.9252,0.009,0.008
6068,32481,26413,23228,2150801208.981,1537408128517276925.7761,26414,10.3083,0.0026,0.0045
12693,94847,82154,29971,2145948520.2869,1528515388684118632.1559,82155,23.3688,0.0031,0.0029
4065,73153,69088,20722,2152185098.5367,1532164335197176273.7993,69089,12.976,0.0005,0.0033
5586,81653,76067,14877,2137051238.8748,1540239531478069705.9157,76068,17.6145,0.0048,0.000
6935,74894,67959,10716,2144654807.6843,1542794571471413773.8179,67960,4.2319,0.0025,0.001
25510,30007,4497,1232,2112169561.1292,1555184769628917314.2468,4498,16.0467,0.0161,0.0026
13527,80975,67448,25222,2147350145.2672,1531559703258331981.0613,67449,15.8119,0.0024,0.002
28957,104861,75904,27861,2152789843.4872,1531285435838387678.267,75905,18.1245,0.0007,0.0027
24552,72921,48369,7600,2140926449.1718,1541869564894498478.7029,48370,6.2395,0.0045,0.0012
16341,89488,73147,32403,2148805671.0448,1539458877190726291.1872,73148,7.5884,0.0011,0.0019
8908,55483,46575,8977,2138435402.1032,1551280324389220900.5532,46576,14.3976,0.0065,0.0021
27912,126656,98744,27041,2138954614.6794,1527101568568549576.0708,98745,11.8753,0.0049,0.001
9220,37617,28397,20409,2121933345.2932,1532817628254724764.0112,28398,25.0208,0.0103,0.000
17811,33764,15953,455,2139922168.7606,1545512213982271353.0126,15954,6.1844,0.0061,0.0032
29475,45933,16458,20369,2154275067.2005,1531710140454463906.0548,16459,1.7971,0.0022,0.0048
24786,33275,8489,16994,2136071047.6404,1558697740316964479.5759,8490,9.7518,0.0116,0.005
22779,36454,13675,32239,2165907754.3815,1532318827666941451.3483,13676,13.0959,0.0014,0.0107
6420,88407,81987,12462,2152239433.2852,1531247639806181601.4409,81988,16.9068,0.0015,0.0033
11788,75942,64154,26874,2143338714.7481,1535218813522157212.4232,64155,9.1791,0.0026,0.0006
14728,79984,65256,19519,2147373591.9191,1529741155106217123.6784,65257,8.3528,0.0022,0.0026
29011,62456,33445,22239,2141215279.0929,1540185292331665428.5679,33446,5.1134,0.0044,0.0007
2705,87202,84497,23652,2147216195.8303,1536892574660048147.2358,84498,3.9118,0.0015,0.0017
22861,97533,74672,10056,2151114687.5838,1538824554621220060.1833,74673,3.5219,0.0003,0.002
4706,64759,60053,1278,2146606423.7492,1526033704160373227.8209,60054,7.6597,0.0035,0.0022
25430,85305,59875,23501,2146675772.2425,1535879631377355483.1415,59876,5.0975,0.002,0.0013
3719,13672,9953,30501,2156900882.0501,1548881005935278907.3418,9954,7.8115,0.0024,0.0069
27608,98300,70692,3282,2151579031.935,1533650078190686552.0127,70693,11.940,0.0015,0.0047
27912,35402,7490,17935,2145073991.6441,1526842406239559182.9861,7491,10.1844,0.0068,0.0043
16583,32847,16264,27311,2163298822.1587,1521641329443313774.8076,16265,12.0107,0.0014,0.0082
11011,78155,67144,32180,2144824443.801,1538774840364080103.0652,67145,10.2333,0.0037,0.0019
28763,79500,50737,3746,2160233002.0339,1534427867381524702.4743,50738,12.2635,0.0001,0.0069
31103,130922,99819,12535,2147589478.2162,1540758264875873267.3772,99820,11.1712,0.0015,0.0014
22450,34125,11675,6835,2148737309.833,1530461896702115867.6019,11676,6.2215,0.0045,0.0044
7863,86977,79114,20704,2159089131.3179,1536773937931958178.2639,79115,14.2622,0.000,0.0049
24205,85822,61617,14776,2139957563.5733,1541081551263265115.6778,61618,6.4177,0.0042,0.0008
10659,39188,28529,24648,2153279900.1826,1545799593847636345.457,28530,8.2123,0.0017,0.0043
17382,46555,29173,31862,2135270578.5989,1509555433451917487.9126,29174,23.0514,0.0101,0.0042
19055,62674,43619,6958,2150657531.2684,1543367038751442629.5167,43620,11.3161,0.0014,0.0032
2799,66489,63690,10986,2142610481.409,1533768034246438061.4192,63691,9.8804,0.0034,0.0009
8982,40040,31058,16347,2147947968.4265,1546658639233449447.0777,31059,2.2945,0.0033,0.0029
2035,48786,46751,4452,2138539699.86,1529953634528358703.5701,46752,8.9795,0.0056,0.0012
3443,39408,35965,6870,2153475656.0698,1539310411969616322.8043,35966,3.0562,0.0005,0.0036
8707,60400,51693,16967,2137446033.3425,1536395121109253900.7908,51694,10.3904,0.0046,0.000
31510,76473,44963,3407,2137902295.6454,1530537645291072732.4082,44964,14.9447,0.0049,0.0006
2905,97673,94768,9890,2152971844.1546,1532773111322128732.7557,94769,7.9147,0.0002,0.0028
2192,42454,40262,20288,2154095711.6201,1531231224532168989.1152,40263,8.7984,0.0014,0.0039
16313,52336,36023,12052,2145771419.3708,1542674516741698865.516,36024,3.5021,0.0032,0.0024
4533,10547,6014,9134,2145649170.3744,1516137061006336195.3897,6015,6.7567,0.0078,0.0065
10060,85154,75094,8533,2155116402.784,1536146402456876261.6233,75095,5.089,0.000,0.0032
10736,15942,5206,28140,2182120788.0509,1539839742693231763.2029,5207,8.7033,0,0.0156
24106,62163,38057,24043,2143432164.0794,1543420111940918197.1697,38058,5.751,0.0033,0.0026
8515,99845,91330,3080,2144911372.3371,1535432936273364387.9128,91331,3.8906,0.002,0.0006
32698,98746,66048,16688,2145548582.6757,1530025686342248752.9415,66049,3.2692,0.0026,0.0012
26355,97283,70928,2620,2140237331.5382,1539503251082028830.4962,70929,16.7752,0.0047,0.0007
13711,64345,50634,6394,2144912164.0493,1542387033649915485.9124,50635,8.4973,0.0031,0.0012
25229,99349,74120,24678,2158136241.5886,1529561778319972486.1884,74121,23.2031,0.0006,0.0058
6063,26538,20475,2143,2142926532.4861,1526357176903683237.0877,20476,3.9626,0.0054,0.0036
17248,57458,40210,28934,2149486578.9831,1548142711016998514.9006,40211,7.2287,0.0025,0.0033
5317,34918,29601,16595,2157889095.026,1550773240721543283.945,29602,10.6977,0.0021,0.0089
13792,56215,42423,14065,2140944795.1376,1537064648223887871.8709,42424,5.0358,0.0033,0.0007
15419,102835,87416,25445,2136043490.7026,1533382034938205624.052,87417,18.2805,0.0056,0.0002
7619,21806,14187,15021,2167879748.471,1542858425551390923.1155,14188,8.9657,0.0016,0.0084
24311,71851,47540,24890,2151889502.5993,1543027032531099196.8013,47541,3.2698,0.0008,0.0031
20801,97918,77117,12488,2148793629.7927,1537890198526768822.9373,77118,5.5061,0.001,0.0018
18463,91532,73069,15080,2152218855.0269,1530933503649857963.5923,73070,12.0349,0.0017,0.0035
10513,45705,35192,19713,2163845156.4979,1534012654857768621.9949,35193,12.9161,0.0003,0.0085
9945,16891,6946,4056,2168684488.0688,1519803517496153268.8126,6947,6.4169,0.0012,0.0113
2183,65764,63581,4242,2142297703.281,1531405547844235656.7474,63582,3.4111,0.0032,0.0005
13066,72991,59925,2067,2148114876.0916,1542331142501480378.3707,59926,1.6532,0.0014,0.0021
14582,84626,70044,16140,2160445325.4269,1539600739213763791.6369,70045,20.1069,0.000,0.0055
31497,104672,73175,19623,2151820820.7096,1527817583147907741.7074,73176,9.1837,0.0021,0.0033
3778,76809,73031,108,2152234216.9998,1532042411227995969.0403,73032,6.7434,0.0013,0.0035
28648,45249,16601,17972,2180628974.0052,1518669703487397646.0856,16602,19.000,0.0017,0.0132
11287,80356,69069,22366,2146578047.2252,1524503840266918418.515,69070,14.5826,0.0032,0.0021
10694,42501,31807,21438,2147270359.8219,1520629748820963089.3214,31808,10.3338,0.0038,0.0038
15128,32500,17372,27956,2144965302.6861,1541893383727047637.0579,17373,26.5748,0.007,0.0033
8822,48902,40080,19316,2132569461.7001,1539740984044092728.5971,40081,8.3662,0.0059,0.0013
32280,91928,59648,10863,2136803929.0656,1543984905264568038.9602,59649,13.6033,0.0052,0.0002
15207,89244,74037,4439,2137436592.9282,1532965072952998004.2435,74038,9.4564,0.0043,0.0004
12988,63773,50785,30750,2141899770.9663,1537032798878827036.4681,50786,5.3344,0.0037,0.001
22046,59458,37412,27370,2142893829.0037,1531069191978092699.0146,37413,7.3127,0.0036,0.0016
20154,89886,69732,26941,2140355828.8374,1542500342558348639.1147,69733,10.020,0.0048,0.0002
25328,70458,45130,7162,2134407280.2172,1529635458629469993.5956,45131,9.7733,0.0062,0.0006
30896,76698,45802,13487,2146828140.3676,1533234066815656184.7219,45803,8.2251,0.0021,0.0021
6603,49216,42613,9489,2151027233.6054,1532598182285936872.2307,42614,3.6941,0.0013,0.0034
15086,69701,54615,10080,2144253900.4492,1543248474087559325.2793,54616,2.2268,0.0027,0.0009
12048,71532,59484,31542,2154921135.1839,1536041970954519493.3389,59485,9.4039,0.000,0.0031
25351,122863,97512,899,2144200080.6515,1546025886045536030.4502,97513,10.9086,0.0038,0.0015
17162,39297,22135,1167,2166186849.7197,1558030987145207314.7735,22136,16.2333,0.0016,0.0082
6716,101474,94758,10891,2146381007.5372,1534249297307164700.5117,94759,11.5259,0.0031,0.0016
11221,84068,72847,28149,2155815201.3133,1539598349981258269.2474,72848,14.5965,0.0003,0.0033
15365,104457,89092,13773,2143325589.1179,1537697776947667144.9938,89093,6.6892,0.0027,0.0004
24833,29845,5012,14354,2156142836.461,1525872791006095517.5331,5013,6.2145,0.0044,0.0074
1089,5241,4152,2749,2137078275.308,1568591869892603393.3781,4153,8.1634,0.0112,0.0052
17740,50670,32930,7902,2140754018.3407,1529163437855630428.8493,32931,4.3578,0.0049,0.0018
21540,49898,28358,20778,2135495392.8015,1534673275532853860.1183,28359,11.2981,0.0083,0.0012
30257,86963,56706,13941,2154982119.1441,1541902847478940718.2979,56707,4.9204,0.0007,0.0039
2260,5706,3446,21481,2230478933.5463,1545402698972668195.7431,3447,18.1562,0.0015,0.0312
5273,20860,15587,830,2154972955.56,1538970766445584694.6775,15588,13.5677,0.0024,0.0057
7506,104793,97287,7566,2145636388.2832,1543971104454671407.6268,97288,10.7279,0.0034,0.0021
9994,99031,89037,13478,2150919494.9127,1543503702923847254.504,89038,23.515,0.0019,0.0049
15504,37602,22098,18056,2145704204.9191,1520426104036726061.4264,22099,10.6452,0.0046,0.0042
23086,120967,97881,23021,2141578180.7039,1534127390317390524.784,97882,6.1222,0.0032,0.0001
8070,106223,98153,26199,2144623521.2164,1541347738001075538.1711,98154,6.8067,0.0024,0.0015
11316,51458,40142,26180,2140403113.9666,1533978068369223946.0537,40143,5.5369,0.0045,0.0003
15941,94223,78282,29829,2169340475.7883,1538461941049048017.2447,78283,34.4277,0.0001,0.0091
31894,82663,50769,8402,2143684094.3975,1535997276841157338.0613,50770,12.849,0.0036,0.0012
4912,12509,7597,26454,2142883085.6121,1547192951064484955.1419,7598,9.7882,0.0073,0.0059
4618,43681,39063,9215,2151875767.8338,1549554100955467156.3573,39064,8.6336,0.002,0.0043
26775,55503,28728,16698,2130762411.1418,1524560990298923446.2715,28729,10.4123,0.0077,0.0004
560,38194,37634,24396,2141686114.4953,1528746202643836823.2751,37635,18.5101,0.0051,0.0031
20727,71886,51159,10683,2151066534.8038,1536422076373382467.0776,51160,14.7441,0.0027,0.0028
3860,37292,33432,1700,2132139854.1178,1543399504753082863.118,33433,12.8718,0.0085,0.0015
19037,34286,15249,21696,2169856111.0486,1541978313607698162.3856,15250,8.9592,0.0002,0.0114
21382,70969,49587,20618,2149502197.2478,1547541623597517836.1819,49588,10.0881,0.0025,0.0029
13287,79977,66690,13664,2137549112.6524,1532601173313414903.6769,66691,29.6312,0.0059,0.0013
23148,60921,37773,13941,2160020864.9926,1537147040748681093.8687,37774,5.6643,0.0002,0.0053
31680,38427,6747,9771,2168924994.8515,1553404380769037078.0108,6748,12.5001,0.0038,0.0102
32042,35454,3412,29138,2149372857.1263,1490093792504718739.0532,3413,8.3836,0.0099,0.0109
13763,106991,93228,16376,2158448927.1075,1546352128685024811.6145,93229,14.8675,0.0002,0.0055
2965,55438,52473,5032,2153397442.4219,1547919529058499738.2435,52474,6.8034,0.0015,0.0055
18981,54403,35422,6573,2135246834.097,1537781121170840390.7073,35423,8.663,0.0055,0.0001
22984,120912,97928,6632,2149845676.4695,1534055589149507093.0019,97929,3.2285,0.001,0.0018
5332,82280,76948,13961,2148357661.3706,1546586734203989563.1876,76949,6.2412,0.0022,0.0021
11477,17888,6411,1089,2178126104.2636,1482001276032581804.9545,6412,18.9031,0.0085,0.0187
31462,41110,9648,13198,2152949388.5487,1551369910758579841.045,9649,9.4466,0.0064,0.0074
3231,79220,75989,18487,2154756266.8166,1534504494421835919.6471,75990,15.1232,0.0002,0.0046
14844,21543,6699,9922,2160162654.1722,1571604072136329380.2781,6700,6.2624,0.0053,0.0114
15135,71436,56301,16461,2130250181.2508,1527954786188545956.7339,56302,18.4192,0.0079,0.0001
8591,58898,50307,30391,2153982093.968,1536227362044705707.7443,50308,6.9764,0.0003,0.0035
10600,96132,85532,5851,2155161927.8467,1537425001494780137.7613,85533,9.9835,0.0002,0.0035
11302,23419,12117,19059,2146114950.4137,1534309614585152323.2155,12118,4.5602,0.0033,0.0041
31753,102844,71091,26027,2143204807.8693,1539542209324226072.6021,71092,15.0724,0.0025,0.0005
32593,32693,100,31635,2335447565.1287,1423300467933227475.7359,101,5.7944,0.001,0.0918
12041,107318,95277,6657,2147517506.5722,1536639824202430498.1345,95278,8.1381,0.0013,0.0016
22162,110876,88714,23648,2152064667.9275,1530333597763014642.6958,88715,10.4952,0.0012,0.0033
23669,102001,78332,18473,2140709413.6734,1537704036161986185.2436,78333,11.6473,0.0035,0.0005
20549,96608,76059,3986,2144324030.7378,1547160530876752429.5198,76060,13.4603,0.0035,0.0018
30266,54671,24405,2472,2137912143.8212,1522682136307292485.2813,24406,10.6743,0.0066,0.0015
6340,31874,25534,16806,2133858090.5848,1538398413351664846.3167,25535,15.6169,0.0082,0.0007
15322,29155,13833,13674,2149650467.5173,1545211804551702890.9269,13834,15.4368,0.0075,0.0044
2554,47516,44962,13542,2153117039.9421,1544403463970134754.5698,44963,9.7252,0.0012,0.0046
11325,110443,99118,30686,2152963591.6676,1537604900197079842.5535,99119,10.0449,0.0001,0.003
25550,71636,46086,7942,2138000355.4898,1533266313463265783.1669,46087,5.3653,0.0041,0.0007
25778,85283,59505,3776,2139210169.4456,1537880601165810420.6457,59506,23.9163,0.0073,0.0014
32413,87991,55578,19736,2141250540.6304,1532126617517058878.6846,55579,13.2528,0.004,0.0018
15651,72656,57005,27404,2142360217.348,1527375124713544255.6064,57006,9.4509,0.0041,0.0016
9904,14966,5062,8253,2148003385.2787,1527606523333648519.0555,5063,3.2521,0.0064,0.0065
24708,33786,9078,6824,2135546484.9337,1538152539854290576.8177,9079,4.5222,0.0087,0.0017
21717,53237,31520,18608,2137052438.9853,1527464030656689147.4055,31521,10.5934,0.0075,0.0013
17721,84473,66752,18674,2152425342.9191,1535257377028226453.8685,66753,9.0647,0.0016,0.0027
10973,27854,16881,23387,2138652625.7215,1540880504647474654.9342,16882,2.4349,0.0053,0.0004
24156,98366,74210,14234,2142434814.2554,1528466147811786279.2439,74211,6.3063,0.0034,0.0014
13589,58719,45130,5403,2137649647.0725,1532524460538738322.9667,45131,16.393,0.0063,0.0018
32292,104725,72433,13056,2153879649.0016,1541540298838379269.5061,72434,5.8904,0.0006,0.003
7932,68121,60189,27040,2160407081.9631,1523062339163279660.6003,60190,14.9251,0.0013,0.0063
12849,24690,11841,25336,2152942370.2533,1522625493946891452.2552,11842,3.5208,0.0044,0.006
21117,61837,40720,11511,2152307598.3487,1526764059283177694.5404,40721,14.9757,0.0026,0.0048
24738,95786,71048,19760,2139699744.7552,1536868080066552898.5546,71049,6.3364,0.0035,0.0006
11762,33142,21380,6358,2145301950.5973,1532003158061682377.0068,21381,13.2175,0.0049,0.0029
10497,23828,13331,14361,2139100756.5453,1536061983776106850.1396,13332,3.7331,0.0048,0.0013
5108,28714,23606,7027,2143809860.4631,1534455476341339289.7038,23607,9.3334,0.0052,0.003
24683,109989,85306,19616,2158540939.8185,1540996637255952374.7051,85307,13.4255,0.000,0.005
30299,64052,33753,30831,2153685601.4624,1525363498726902150.3684,33754,10.5668,0.0021,0.0051
6807,8555,1748,32112,2122358955.7559,1502302379525121944.9621,1749,7.1335,0.0156,0.0055
28267,119050,90783,27505,2140810191.1278,1534086515471741137.6723,90784,6.5956,0.0048,0.0004
8890,21672,12782,14556,2139742760.6118,1540104583847526599.3959,12783,11.7492,0.0087,0.0024
8570,90700,82130,4021,2146112825.7436,1535382753186643393.9963,82131,3.3424,0.0014,0.001
29796,83375,53579,31515,2151704949.1533,1539775238617138524.6819,53580,2.161,0.0005,0.0021
22765,95072,72307,1398,2151593033.8662,1529510174496387293.4116,72308,15.4334,0.0019,0.0042
10867,76838,65971,657,2150504958.1676,1542860436776870208.3391,65972,5.6162,0.0012,0.0023
18276,116198,97922,18261,2147753172.8094,1539103010900481428.3024,97923,1.5384,0.001,0.0011
17928,116850,98922,23775,2139018929.1295,1537748006623519081.2506,98923,9.1179,0.0033,0.000
25165,41230,16065,22818,2159513070.115,1562351275735768171.4436,16066,17.5451,0.0044,0.0103
31232,63818,32586,23897,2129992546.9871,1542282383758022909.8973,32587,24.700,0.0103,0.0007
10397,53109,42712,4634,2160156065.0734,1542294668754739485.6717,42713,6.8402,0.0001,0.0056
4547,5760,1213,29978,2142793784.2875,1540464737117467339.4915,1214,9.1985,0.0139,0.0116
22105,84508,62403,10762,2149715765.0287,1534373333181784516.0886,62404,3.9244,0.0015,0.0025
19403,78718,59315,19339,2151768362.5554,1532255247174295585.584,59316,9.777,0.0013,0.0032
15142,91741,76599,25867,2149152818.5268,1542077930629174791.2808,76600,8.7561,0.0013,0.0029
4365,63294,58929,5334,2159939163.3699,1538284903570455933.1024,58930,11.0805,0.0002,0.0051
12415,69107,56692,13706,2137044706.1663,1539648483979061752.0648,56693,8.2915,0.0057,0.0004
6658,43234,36576,10500,2128511547.354,1536705178289740152.3406,36577,12.6295,0.0079,0.0003
4919,83626,78707,9330,2150460258.7093,1530159338630029001.4356,78708,10.0501,0.0014,0.003
359,88088,87729,27459,2151704863.672,1532889894767061379.6011,87730,10.9039,0.0011,0.0034
7986,37894,29908,21250,2132471974.9061,1542526088564980395.3733,29909,9.4741,0.0071,0.000
31548,97695,66147,19936,2155656177.7328,1530608292756224395.9942,66148,10.1549,0.0004,0.0042
26330,102960,76630,9997,2147422269.854,1533760638259827391.5911,76631,3.7701,0.0016,0.0021
28354,55140,26786,22772,2148707876.9156,1522236560248753843.3646,26787,15.5328,0.0027,0.0039
21738,72061,50323,6052,2151368150.4409,1545591706710448494.4469,50324,6.8353,0.0017,0.003
24009,61698,37689,23032,2139109134.0408,1522659156636456749.0263,37690,15.629,0.0072,0.0027
26063,39595,13532,16755,2161360032.1494,1515932036061022969.8195,13533,9.6535,0.0032,0.0088
5391,60769,55378,21869,2135532149.4014,1528392477052065731.0043,55379,14.9286,0.0063,0.0009
10150,11054,904,21835,2135291940.9182,1528338279763190029.2618,905,4.2814,0.0161,0.015
27177,43863,16686,32478,2137079277.4348,1538823986557296570.3413,16687,8.7227,0.0049,0.0006
31567,59462,27895,12208,2138112392.6351,1532951993385813631.5627,27896,15.0546,0.0061,0.0022
2783,37372,34589,32566,2143972197.2403,1547933657715195656.98,34590,6.9244,0.0039,0.0034
27938,111763,83825,1141,2153591699.3996,1536196453644651097.9002,83826,4.6784,0.0003,0.0029
23145,68720,45575,31254,2147189314.6985,1529067325349662513.0544,45576,13.287,0.0024,0.0035
32628,101284,68656,17702,2151322107.0577,1533706146694282399.1624,68657,7.9644,0.001,0.0027
25657,81593,55936,30677,2155898466.4733,1545665809611809869.7325,55937,13.0014,0.0011,0.0051
32489,104136,71647,12166,2142317217.5447,1543196649024477619.7469,71648,12.8698,0.0038,0.0009
13294,65197,51903,9677,2158766872.1535,1537162829221536687.6528,51904,6.7431,0.0003,0.0059
23960,46544,22584,20331,2133023761.7831,1537743349127187641.1653,22585,16.1603,0.0072,0.000
6719,44689,37970,31838,2154073974.1248,1546591240752490553.7755,37971,17.4794,0.0022,0.0056
10708,54645,43937,21646,2156006797.7665,1532085014375365133.1282,43938,13.6406,0.000,0.0041
3768,30119,26351,3817,2128193299.9505,1549356675513089914.5182,26352,24.8012,0.0111,0.0013
13641,19511,5870,2427,2155909505.3458,1510572167875886283.9404,5871,22.5629,0.0045,0.009
9332,73377,64045,24707,2138565907.1539,1529937578386287721.4536,64046,10.1317,0.0055,0.000
25313,114736,89423,29550,2141691369.7784,1529238312298300683.2925,89424,7.1057,0.0034,0.0012
31940,56039,24099,26829,2176304384.2114,1527124410204309483.644,24100,22.8686,0.0002,0.0117
5100,40520,35420,4106,2154406010.1119,1544046989113056302.2544,35421,7.4069,0.0016,0.0059
11913,86924,75011,29736,2137661870.6682,1526259217936146237.7336,75012,9.7657,0.0051,0.0007
18649,21083,2434,19124,2163477226.3992,1536062738874232874.3006,2435,6.3547,0.0046,0.0122
17571,109392,91821,30170,2158360523.7321,1548994064850801979.7503,91822,16.1307,0.0006,0.0052
29816,48345,18529,11013,2135447968.6719,1532479559103862054.9974,18530,10.0786,0.0056,0.001
6169,11085,4916,24404,2109807337.3132,1547854815875121660.6019,4917,10.1363,0.0192,0.0011
16967,83816,66849,813,2151600629.477,1541182071159429169.414,66850,7.6416,0.0003,0.0026
17521,58974,41453,3697,2156992981.228,1531464988827211522.2694,41454,7.4528,0.0005,0.0044
26835,63100,36265,7467,2135624591.5525,1539115806623725139.1677,36266,10.5829,0.0049,0.0006
4997,103670,98673,15636,2152618285.9227,1549008326799338636.4143,98674,13.1994,0.0014,0.0043
18289,77456,59167,26719,2144516248.8002,1537848225631242837.7992,59168,5.0387,0.003,0.0008
25994,86138,60144,27960,2147265599.0712,1547999329221266453.5905,60145,8.2622,0.0031,0.0034
19217,58704,39487,1138,2164587623.8339,1536948119073870016.8095,39488,8.2416,0.0002,0.0082
3201,6206,3005,17868,2142541928.5712,1537748127532390813.3208,3006,8.113,0.0171,0.009
4004,82712,78708,4373,2151513491.456,1533816844276840466.6184,78709,7.8313,0.0009,0.0029
8920,50026,41106,27724,2146470890.8851,1539515748685829508.7335,41107,12.006,0.0032,0.003
12911,91506,78595,27476,2130991959.222,1540062952779817363.8961,78596,19.5905,0.0059,0.0001
4691,67652,62961,19097,2156088314.1831,1529832523861077376.4487,62962,12.518,0.0009,0.0042
10836,53374,42538,8517,2154940844.9248,1531860914820882764.0079,42539,11.3959,0.0009,0.004
24801,92564,67763,32291,2156094716.0053,1531789374703766734.1234,67764,16.5223,0.0006,0.0049
25194,25955,761,18126,2212823535.7625,1474268990639326140.0499,762,11.6406,0.0118,0.0467
13089,24610,11521,26988,2129953692.7626,1538544320107366046.1132,11522,5.8086,0.0079,0.0008
25560,55726,30166,8314,2163245198.6792,1549242194907829569.4545,30167,13.8229,0.0007,0.0075
26218,43818,17600,26343,2141080904.6874,1531632948734662790.1185,17601,6.1472,0.0052,0.0028
30289,115154,84865,1777,2132170459.8531,1535851635003465243.1643,84866,21.6009,0.0067,0.000
32306,112136,79830,11497,2148041680.4691,1531230605425912962.6517,79831,10.4611,0.0022,0.0026
19661,66080,46419,31715,2142481397.373,1544328813954070928.182,46420,6.3159,0.0045,0.0009
14410,79242,64832,16106,2149667261.4641,1540223449401143885.6203,64833,11.9088,0.0012,0.0032
10332,83683,73351,20852,2144897557.3,1532957224775511168.9715,73352,14.3394,0.0035,0.0016
22461,52338,29877,560,2134886455.2758,1552409213865439865.9261,29878,14.214,0.0082,0.0027
29598,100744,71146,24413,2149373295.4449,1544926659880387368.8675,71147,7.2906,0.0018,0.0028
799,78315,77516,12355,2145993900.9957,1529986033540198622.9703,77517,7.1485,0.0022,0.0017
23021,118021,95000,31100,2147543852.7493,1543804682797927047.4374,95001,13.6352,0.0019,0.0023
29986,79275,49289,24394,2155250416.7009,1538955729049015348.3566,49290,5.2972,0.0002,0.0046
15647,41696,26049,23468,2133194840.7583,1545765273909983355.8208,26050,14.7497,0.0087,0.001
12226,111902,99676,17961,2142188643.6142,1539538729570946854.3815,99677,6.3119,0.0029,0.0002
23807,80255,56448,7454,2136284267.2882,1542634525506503003.0838,56449,15.8542,0.0054,0.000
23396,89384,65988,13650,2139513954.8795,1536660852048100911.1047,65989,10.640,0.0036,0.0002
15837,92712,76875,18678,2142308836.2163,1525922074639726259.3905,76876,12.4263,0.0047,0.0019
23030,82172,59142,30095,2140878521.0537,1533224460376978048.533,59143,6.580,0.0033,0.0009
14388,86863,72475,2522,2132895025.735,1536602485038267481.2421,72476,17.8803,0.0061,0.000
92,64912,64820,22127,2146499049.6462,1534418132161672707.7289,64821,7.1522,0.002,0.0015
27905,121261,93356,12650,2144197040.1243,1534431815558434121.7785,93357,10.9688,0.0027,0.001
27588,43642,16054,14499,2126030068.059,1545802992888079300.8207,16055,10.7631,0.0104,0.0007
5380,79261,73881,29824,2135675495.0823,1528403864799693157.7633,73882,22.4673,0.0062,0.0006
11486,38921,27435,17158,2143826666.3401,1550927147468729861.2361,27436,6.8764,0.0051,0.0025
5266,39673,34407,7314,2155664018.8295,1534885344021735841.5125,34408,18.4659,0.0009,0.0053
32366,124431,92065,11958,2150687451.5971,1541645200791605607.0807,92066,9.5231,0.0016,0.0025
30902,102121,71219,9584,2144514578.9995,1533982933274133332.3316,71220,8.0229,0.0026,0.0012
4253,24142,19889,27954,2148320340.1425,1540554258645301690.1563,19890,5.6346,0.0023,0.0041
3778,89108,85330,12941,2139216130.1512,1537603573155473591.4654,85331,10.145,0.0033,0.0001
826,96824,95998,1271,2147037720.3944,1532298371339185699.7607,95999,7.8331,0.0018,0.0015
6457,99851,93394,11637,2146988851.9525,1538309156745921302.3405,93395,5.6636,0.0017,0.001
1443,70230,68787,25128,2154747635.5129,1541349537990155344.3752,68788,9.0768,0.0003,0.0042
27922,95054,67132,27699,2159703579.6103,1535183572285060548.7673,67133,11.567,0.0004,0.0052
9888,50728,40840,1096,2134204746.8837,1528562270437481574.2029,40841,11.5248,0.006,0.000
19018,55016,35998,27441,2158977535.6386,1532748261938820404.673,35999,6.3661,0.0012,0.0055
14827,31713,16886,11655,2137918203.3295,1543245494206183340.9427,16887,5.9631,0.0053,0.0009
19465,20075,610,8310,2153409746.0295,1450297950921635126.2479,611,10.8295,0.0242,0.0293
29164,96938,67774,31274,2142597854.4478,1533356289274853298.463,67775,4.0064,0.0034,0.0005
13128,103136,90008,26881,2160231879.9481,1538968809035060477.1904,90009,19.379,0.0002,0.0052
28818,85943,57125,19981,2145064396.8263,1536746085957548294.0743,57126,1.9741,0.0021,0.0008
32279,121775,89496,19753,2146239690.2379,1537292984865866668.479,89497,3.7391,0.0015,0.0013
23512,98261,74749,6970,2140931314.2035,1532078135213138241.4363,74750,5.1281,0.0035,0.0007
18523,65896,47373,29996,2158538847.3221,1531874285327027304.9755,47374,8.3477,0.0003,0.0047
30966,65578,34612,13663,2149293969.2629,1525719007120249890.8597,34613,9.3698,0.0024,0.003
5359,26023,20664,5742,2156755607.273,1521976405458984679.5364,20665,8.8176,0.0026,0.0079
21234,31120,9886,18780,2170002765.8069,1531242899314724655.3711,9887,9.0031,0.0013,0.0101
1496,47129,45633,18556,2149062769.5437,1538690708389960622.4273,45634,6.7913,0.0017,0.0025
4036,57980,53944,12118,2156292310.1666,1531583442309354234.9617,53945,10.8821,0.0004,0.0042
524,68136,67612,8066,2158020109.5203,1533065252945413517.8108,67613,14.3543,0.0004,0.0059
18814,69060,50246,11945,2145966448.0435,1539232985019878449.1944,50247,12.7284,0.0034,0.002
31432,44038,12606,2404,2147475071.1847,1535551112697557732.3673,12607,10.6105,0.0043,0.0076
24345,78081,53736,7945,2142881662.5965,1550083854351958976.3448,53737,12.8091,0.004,0.0019
13175,82738,69563,1338,2150196393.6327,1532516153244165206.177,69564,5.750,0.0014,0.0021
31133,54761,23628,27005,2177582098.5332,1528991523873103355.1789,23629,22.2089,0.0002,0.0113
25116,100816,75700,29105,2149041484.8799,1536342060048254619.226,75701,2.2376,0.001,0.0017
16358,26375,10017,21132,2178889376.733,1529530360464125916.9538,10018,13.8934,0.0007,0.0176
8171,51032,42861,18375,2145851020.0736,1530024402990240618.946,42862,5.7113,0.0027,0.0023
838,41090,40252,6053,2139168808.8636,1540544142567754887.4996,40253,10.445,0.006,0.0016
3673,15483,11810,12838,2154015013.1904,1537786361448014285.9474,11811,7.5752,0.0025,0.0051
989,46668,45679,31209,2141088516.8268,1541582610063287303.2574,45680,2.9981,0.0044,0.002
21452,98233,76781,12151,2131484263.2608,1537540008737072529.6477,76782,18.6495,0.0068,0.0003
30758,91088,60330,21958,2136842271.8519,1536828495410047352.6925,60331,8.123,0.0051,0.0004
24922,88509,63587,1094,2138818439.4361,1531250092007210697.8143,63588,9.5529,0.0045,0.0008
12355,69033,56678,20953,2149037890.8314,1532365375610550441.0441,56679,10.7633,0.0022,0.0033
20414,63904,43490,32133,2131924484.3917,1550885667296627736.8926,43491,28.1278,0.010,0.0008
18538,64098,45560,27551,2160199259.7741,1537150093737193226.1344,45561,9.0763,0.0004,0.0066
22485,107811,85326,4800,2157855512.0592,1541961302585747746.8989,85327,11.8335,0.0005,0.0057
7197,24104,16907,30088,2124268064.2736,1541007111973591174.5993,16908,15.7088,0.012,0.0008
21890,117358,95468,9953,2137120063.9512,1549713065003767793.7992,95469,23.0654,0.0059,0.001
13146,23213,10067,2348,2113977192.4869,1531046506085091001.8895,10068,8.3128,0.013,0.0005
28974,128286,99312,24530,2151359726.5268,1543853225345649538.1799,99313,4.4513,0.0007,0.0025
169,28540,28371,9958,2157896148.1488,1545545709960932625.8939,28372,5.1945,0.0005,0.0055
717,17073,16356,9478,2153484724.6037,1535157134535110598.5186,16357,4.0739,0.002,0.0053
28180,118826,90646,16291,2159827553.6731,1534873882310062274.8307,90647,15.6394,0.0007,0.0044
10198,46155,35957,3316,2153570858.985,1526927598491485782.1975,35958,5.0891,0.0018,0.0042
6353,53484,47131,6976,2143196715.8308,1530127851040379365.4031,47132,5.6904,0.0031,0.0009
11052,42677,31625,705,2161761072.8939,1519003972532055761.021,31626,18.5734,0.0013,0.0089
9269,44500,35231,25883,2152370442.3738,1531660589384002963.9134,35232,7.5574,0.0019,0.0044
30338,34011,3673,29213,2205896833.2126,1523503072864401772.3568,3674,13.2565,0.0018,0.0211
9389,55633,46244,10141,2163340596.5591,1533214978674033952.5975,46245,12.9946,0.0004,0.0072
22316,78310,55994,18800,2140711785.2547,1547757967696981413.3104,55995,12.916,0.0048,0.0008
31358,86560,55202,13625,2147539025.6453,1542871438273919741.3102,55203,3.5089,0.0018,0.0016
31785,43088,11303,8940,2143837520.7413,1543873957014667469.3559,11304,6.8586,0.0068,0.0074
1434,26303,24869,26758,2162314770.8329,1547820700846944201.4733,24870,7.2488,0.000,0.0068
566,76092,75526,22235,2144562974.4754,1542182732729042196.056,75527,14.3048,0.0034,0.001
31636,103818,72182,31486,2147832165.5072,1541132477004668638.1195,72183,7.447,0.0022,0.0028
30290,80365,50075,22750,2153762521.3794,1528722511208701654.7753,50076,8.7641,0.0008,0.0037
13411,74612,61201,8694,2157939673.2496,1546856502933737418.5222,61202,6.1626,0.0001,0.0052
30314,54574,24260,24185,2157476354.0554,1544005629061115948.449,24261,18.8255,0.0024,0.0078
11794,74187,62393,29305,2152346110.1481,1531672789694305648.6429,62394,9.0499,0.0015,0.0034
7523,37285,29762,28017,2151884372.0765,1548537955820780668.988,29763,17.9308,0.0033,0.0045
24244,52002,27758,19137,2141893504.6396,1532360467906289564.2509,27759,7.2619,0.0036,0.0012
26641,105668,79027,24673,2138668683.433,1546318351455480084.5043,79028,18.4954,0.0043,0.0002
13131,69270,56139,18891,2147254494.1192,1541535685596611595.6678,56140,8.2797,0.0021,0.0017
21094,111308,90214,29099,2151442260.9606,1530471832821956019.1798,90215,13.6249,0.0014,0.0035
15997,46155,30158,7969,2130636067.999,1532631870946241101.3219,30159,13.7703,0.0072,0.001
31764,105387,73623,18158,2146066660.3106,1535965495363936408.001,73624,7.3177,0.0018,0.0013
625,82361,81736,7731,2154871675.4958,1541320381294422307.0815,81737,12.0981,0.0001,0.0039
22411,51965,29554,14684,2146814302.4814,1528851936051612829.7183,29555,8.9707,0.0032,0.0034
107,18631,18524,16032,2152648516.8404,1547570135903317749.992,18525,8.3353,0.0037,0.005
9303,33135,23832,27178,2150114010.4734,1522641559405144285.4757,23833,3.6155,0.0035,0.0045
15467,39299,23832,25447,2153864739.5126,1560874101855270460.8749,23833,14.0657,0.0048,0.0069
17012,72196,55184,252,2136130517.083,1531025032629099264.0675,55185,13.3314,0.0063,0.0004
24434,59094,34660,30276,2164106448.8772,1535797813976682573.4734,34661,18.7079,0.0012,0.0085
16485,111509,95024,27309,2146296561.5197,1540324330600086986.4936,95025,11.3919,0.0019,0.001
19801,83886,64085,15137,2144294458.015,1532627854027714110.2161,64086,2.5791,0.0022,0.001
9547,102062,92515,8005,2150360579.6271,1540394876636391657.6566,92516,2.7796,0.0011,0.0022
9110,47181,38071,4474,2145302933.6425,1533582570790358743.3085,38072,27.3144,0.0048,0.0032
3525,50121,46596,23439,2144417210.1471,1538707275810527310.2146,46597,2.8573,0.0023,0.0007
12603,37686,25083,23444,2167156877.5785,1536979304704793083.3827,25084,9.558,0.0004,0.0094
2013,83265,81252,1933,2149875327.0298,1536108747328934544.5755,81253,3.0356,0.001,0.0021
23834,90547,66713,10781,2156242792.8709,1532635407969206504.9191,66714,12.8505,0.0003,0.0053
31933,130818,98885,2086,2145573781.2349,1534967143098288803.2482,98886,7.8761,0.0023,0.001
14956,74362,59406,14658,2161727810.7089,1539162175372201830.6798,59407,12.7512,0.0002,0.0055
16021,23875,7854,23584,2155286936.6569,1524589843859444810.0617,7855,10.706,0.0045,0.0076
5586,87168,81582,20441,2146406677.1754,1529511544273911052.9045,81583,11.7465,0.0021,0.0018
30276,112696,82420,6045,2153535788.7984,1530203584362099327.2328,82421,7.517,0.0013,0.0032
6329,43535,37206,13855,2159840064.2027,1534219398341761179.0625,37207,9.5574,0.0009,0.0061
23998,118818,94820,13194,2145040902.0935,1536778067173543899.5024,94821,8.5414,0.0025,0.0004
27975,93365,65390,6088,2158996184.6901,1540220701357144722.5886,65391,16.2251,0.0008,0.0059
29872,64496,34624,10142,2150947696.8479,1554851294185203790.1726,34625,9.0469,0.003,0.0054
7762,107272,99510,25626,2147545058.6611,1540830832146860941.1171,99511,7.2537,0.0017,0.0022
10282,38002,27720,4067,2158822541.5569,1544391796854040770.1408,27721,9.7434,0.0002,0.0057
22856,44408,21552,13472,2142619529.2598,1546016179610823208.8546,21553,6.9775,0.0038,0.0024
9618,60413,50795,27046,2148909328.164,1542073019594846927.7735,50796,2.573,0.001,0.0026
22476,36079,13603,12193,2186987159.4288,1548911971913412941.4381,13604,27.1724,0.0007,0.018
14205,77658,63453,15397,2146316322.5242,1527958037090345394.9062,63454,5.8994,0.003,0.002
18880,30965,12085,3581,2145434086.753,1525529925132764099.4087,12086,8.5419,0.0056,0.0042
13598,107263,93665,5314,2150809831.1598,1534142529746683576.9127,93666,8.4047,0.0005,0.002
31713,61075,29362,15937,2143513551.5198,1541480734116161452.0186,29363,6.9354,0.0027,0.0011
22600,70014,47414,7555,2161317349.0889,1542423672170884809.096,47415,9.8598,0.0001,0.0061
11008,39133,28125,16822,2139655202.9368,1531953905324513903.6227,28126,6.6908,0.0055,0.001
20578,99620,79042,31954,2150241017.5845,1543691561057150436.2889,79043,5.7627,0.0013,0.0024
4066,36287,32221,26723,2157841123.4959,1540594662818565170.0141,32222,8.6898,0.0012,0.0052
759,32335,31576,28277,2143945465.1679,1542489695386682958.174,31577,8.5649,0.0046,0.0026
5442,38905,33463,17944,2140948726.2138,1540663826571960950.4194,33464,12.1547,0.0042,0.0025
6702,91812,85110,27347,2156750046.2713,1540143858722078475.8114,85111,7.0518,0.0001,0.004
5516,95012,89496,20523,2138713511.9362,1545029649580030941.4536,89497,35.0332,0.0057,0.0007
24995,77915,52920,13611,2135899891.4823,1530136749312515843.821,52921,17.7708,0.0076,0.0007
18774,39017,20243,32442,2124939405.9746,1521993035381570171.2423,20244,13.3201,0.0108,0.000
14795,50972,36177,30725,2138494363.3846,1537457513851251544.0139,36178,8.4086,0.0055,0.0003
23811,103543,79732,16331,2144354266.391,1541559119535088756.7043,79733,7.1398,0.0028,0.0014
32167,54382,22215,12060,2137465326.9908,1538493726077874444.0743,22216,6.5152,0.0064,0.0014
10581,90477,79896,12359,2147830946.9328,1545076095360012562.934,79897,4.9479,0.0019,0.0019
11084,98236,87152,15675,2153816423.3118,1535303038843839686.5718,87153,4.3504,0.0007,0.0029
5998,74299,68301,2644,2142339642.4019,1546101986872643812.6601,68302,13.6991,0.0037,0.0016
11891,77741,65850,13274,2152176193.348,1531523413863083740.3286,65851,8.0374,0.0013,0.0039
24411,45490,21079,31222,2147029260.1368,1557223341616078103.7815,21080,7.1132,0.0043,0.0043
11621,93993,82372,32028,2141520343.8048,1530592697154779263.7358,82373,8.0444,0.0033,0.0011
1038,51558,50520,31383,2139662666.9811,1534971702031959386.5796,50521,5.6866,0.0041,0.000
2347,48407,46060,5757,2134956663.0381,1536395093240396260.482,46061,12.4875,0.0069,0.0003
7799,75276,67477,25839,2146705875.194,1551043314173295728.8472,67478,13.2859,0.0037,0.0035
10863,71212,60349,183,2149454171.7801,1531512525285066584.5078,60350,4.0962,0.0013,0.0027
8429,46475,38046,25223,2147960622.7435,1524453976282136417.8077,38047,10.6183,0.0024,0.0046
27451,104655,77204,18668,2140477607.2208,1534477724559660017.9424,77205,8.0165,0.0042,0.0003
17998,79264,61266,19671,2151388858.6593,1537906932007072985.4549,61267,3.1752,0.0008,0.0027
29179,63185,34006,18075,2148783203.4178,1537832786197925907.6297,34007,5.5176,0.0022,0.003
3429,10603,7174,7886,2133773056.6854,1536336661813335374.6761,7175,5.6569,0.009,0.0011
14492,108476,93984,24859,2149892184.883,1543922253814200245.0214,93985,10.5421,0.0015,0.0022
31183,122733,91550,16955,2152375985.4526,1537949875627053981.8463,91551,7.7564,0.0003,0.0028
28874,82709,53835,13871,2155431407.4749,1529365904040262169.5591,53836,12.6552,0.0003,0.0041
32104,119360,87256,4410,2138960830.3301,1537221063195119761.5358,87257,12.4042,0.0035,0.000
6836,78006,71170,30897,2134744864.295,1539103260338705720.5351,71171,16.7287,0.0064,0.0002
27191,122899,95708,6105,2143200364.0352,1529355094163783469.4295,95709,11.1109,0.0037,0.0013
18717,20607,1890,11387,2172393484.1856,1500572092231458238.7604,1891,6.2009,0.0077,0.0189
25902,70559,44657,29154,2154423669.0144,1542097645638233942.7012,44658,5.807,0.0009,0.0053
29024,87246,58222,8766,2135570327.4819,1552054457111749110.666,58223,22.1207,0.0064,0.0007
19316,119304,99988,23201,2159171563.2038,1530565168246603667.8747,99989,15.4395,0.0003,0.005
7738,13796,6058,8442,2101761186.116,1535200905512829903.6652,6059,10.7316,0.017,0.0004
20564,118130,97566,25307,2154576532.4069,1530715340638634021.9393,97567,9.3795,0.0009,0.0032
22559,111789,89230,1905,2145344005.4504,1539469971754550234.7679,89231,3.6575,0.0023,0.0008
20642,70131,49489,4123,2137840284.9814,1529928138193314878.3524,49490,4.2755,0.0056,0.0006
662,77039,76377,28898,2161401464.7725,1537572236913441383.1361,76378,15.0965,0.000,0.0055
9238,108304,99066,20146,2141778761.8698,1532728599068311375.0088,99067,9.1398,0.0032,0.0005
12649,54339,41690,12856,2130517396.7084,1541125618177274108.625,41691,13.7047,0.0066,0.0003
8331,39215,30884,13646,2153444820.223,1521485678218093755.0781,30885,14.6085,0.003,0.0065
24685,113684,88999,17582,2144479222.2241,1535319592561181357.7285,89000,5.3754,0.0026,0.0008
13539,69196,55657,22371,2140732961.7098,1545858183081756593.6528,55658,9.3394,0.0036,0.0008
27510,72683,45173,26401,2156886320.8278,1536889672031786711.8941,45174,9.9271,0.0002,0.0043
30524,88792,58268,21830,2139959389.2345,1538453231543714306.4093,58269,4.7328,0.0033,0.0001
13729,95479,81750,10665,2154573620.6484,1529371670087027925.0127,81751,19.6469,0.0007,0.0055
28121,57803,29682,383,2142154248.8142,1530632735367570781.4538,29683,15.2614,0.005,0.0029
25144,71678,46534,27815,2145137339.8381,1550194527968413352.5854,46535,14.0081,0.0033,0.0028
26754,32908,6154,29000,2164140885.284,1537942799901418647.0917,6155,12.9216,0.0052,0.0145
19752,28210,8458,18424,2135998132.3654,1558858098682107351.9692,8459,5.2771,0.0099,0.0053
3552,25633,22081,2912,2142946042.3468,1527899925749862288.1984,22082,7.6657,0.0048,0.0026
30174,43899,13725,8019,2149639111.6239,1524450389983932607.4254,13726,12.6535,0.0057,0.0055
19982,108406,88424,21536,2155377067.1212,1534248378152367765.1191,88425,19.8789,0.0012,0.0057
15160,22818,7658,12105,2094044536.0339,1552293396933405068.665,7659,21.929,0.020,0.0004
15139,16166,1027,7010,2091618904.4883,1501108398337239824.3549,1028,4.9088,0.0307,0.0036
25796,101764,75968,9103,2145916272.0026,1533764271112043531.8712,75969,3.9051,0.0019,0.0011
11647,39051,27404,5792,2144920333.7326,1535540983626581156.6441,27405,3.3577,0.0044,0.002
13278,22427,9149,31357,2137126995.0755,1543854859405418589.1234,9150,10.7162,0.0076,0.002
19969,57725,37756,27606,2144876335.9039,1540954471375511093.4734,37757,7.8125,0.0042,0.0022
23687,31541,7854,18637,2149569293.7511,1517146639327187658.1633,7855,7.0368,0.006,0.0056
20038,94798,74760,11093,2142553170.3783,1527470071909431618.564,74761,11.2515,0.0037,0.0015
12762,83382,70620,15089,2151468991.0895,1535458051887209443.5352,70621,6.8548,0.001,0.0031
31995,35063,3068,29726,2156137317.1558,1585247553429983528.6111,3069,18.5972,0.0171,0.0137
5709,35316,29607,27000,2148384503.3817,1541938878741378588.6013,29608,5.4665,0.0021,0.0028
30144,57027,26883,24678,2154745482.7162,1532081467743428749.3134,26884,3.3236,0.0012,0.0045
8685,97361,88676,5597,2165227106.8624,1533936407021807936.2118,88677,26.745,0.0004,0.007
11350,53882,42532,1286,2162895650.6697,1534563053638128205.0561,42533,12.7032,0.0003,0.0079
7865,49300,41435,19107,2156902201.801,1539966064954742302.9255,41436,17.4033,0.0011,0.0059
16356,57689,41333,16378,2150152138.4618,1537701037849911636.7092,41334,2.4746,0.0009,0.0018
31313,37217,5904,31001,2134564406.0833,1559908001439775941.6059,5905,8.0626,0.0088,0.0034
30303,48278,17975,335,2142879843.1796,1529283377238801793.7432,17976,16.0319,0.0069,0.0027
6342,42135,35793,9633,2166175421.6196,1529082654998403509.8632,35794,14.3594,0.0004,0.0072
10927,95160,84233,3122,2149664180.6592,1535571751448161597.8261,84234,8.896,0.0009,0.0022
24152,90144,65992,5959,2147633926.9106,1534594588133732350.0964,65993,2.693,0.0014,0.0019
4236,39480,35244,4270,2154376770.8366,1545368432790719772.0819,35245,7.4547,0.0016,0.0047
16877,60764,43887,2017,2128671738.749,1526588179443349336.4589,43888,21.3138,0.010,0.0007
30860,39125,8265,25332,2160418858.0241,1541743818225441698.4607,8266,5.1806,0.0029,0.0117
9875,12665,2790,14311,2136945373.2028,1532784572112690344.7242,2791,12.8341,0.0102,0.0096
28769,54033,25264,15331,2158801440.3477,1527729444833357490.9066,25265,9.4809,0.0006,0.0054
31806,75007,43201,31911,2158565988.6734,1533096042159793783.974,43202,14.6076,0.0006,0.0058
1838,8679,6841,7879,2163024783.158,1526080666697231388.8901,6842,4.6352,0.002,0.0101
23547,86935,63388,30165,2145630935.1226,1534010104106207861.5391,63389,4.2634,0.002,0.0011
16967,39412,22445,6742,2150940337.0438,1535106169318742914.6971,22446,6.9142,0.0014,0.0032
22556,65152,42596,23196,2145080015.708,1536897050648554305.5181,42597,1.4054,0.0023,0.0012
26541,107349,80808,26424,2156401416.3683,1537486203098063710.9835,80809,12.6225,0.0006,0.0048
16020,91509,75489,4873,2146288261.9484,1531109674298254771.739,75490,15.3337,0.0023,0.002
29831,101824,71993,4859,2149095361.7293,1540020527018914084.1215,71994,7.6387,0.002,0.0021
29262,35310,6048,13806,2179974394.3372,1525928105386946862.6008,6049,8.6942,0.0008,0.0184
16154,86200,70046,31245,2140445875.658,1540634751700647538.3728,70047,4.5932,0.0033,0.0003
13268,99928,86660,18949,2153474185.3161,1530392805255552204.8461,86661,16.2127,0.0005,0.0041
25908,54107,28199,3513,2144879918.7982,1542885619863955912.2618,28200,3.3065,0.0035,0.0024
8333,81314,72981,13629,2143674809.0878,1555182604225067969.8697,72982,21.6733,0.0044,0.0027
25774,116749,90975,3743,2149077768.8837,1525295293927854158.4281,90976,10.6279,0.0023,0.003
10757,103771,93014,23684,2146367053.5248,1537872749861881478.9896,93015,13.5792,0.0022,0.0027
735,4318,3583,20920,2182816959.2143,1548359319365639298.4541,3584,7.6571,0.0013,0.0196
11475,59413,47938,7003,2151179640.6191,1541914026931801572.909,47939,9.2883,0.0011,0.0031
12296,16556,4260,15017,2153510399.859,1541609617578279881.2819,4261,2.3053,0.0034,0.0073
30343,116417,86074,14457,2146907021.9347,1539185267004617628.9557,86075,22.7421,0.0025,0.0034
26172,42132,15960,5470,2144735873.9614,1545707947082101336.0439,15961,2.9779,0.0038,0.0035
5887,13550,7663,560,2131201049.4165,1514456345182464129.2368,7664,8.374,0.0121,0.0036
22926,112122,89196,21559,2147807274.8968,1537000111381370373.6381,89197,9.5032,0.0018,0.0016
6433,72731,66298,4431,2145095612.6046,1544120765555735364.9246,66299,8.7946,0.0026,0.0021
7539,7734,195,16610,2316057981.9898,1455858022689392473.5203,196,5.8685,0.0076,0.0679
78,87782,87704,13106,2152259955.2034,1536656895814830536.5294,87705,7.7419,0.0003,0.0034
29563,77923,48360,24438,2146175257.9892,1543234145661260345.2512,48361,4.2977,0.0028,0.0019
5999,53988,47989,13493,2146550794.8432,1526629948218238478.5198,47990,14.1253,0.0035,0.0024
10882,34567,23685,26196,2160049321.0415,1551609792665160537.6056,23686,8.816,0.0009,0.0086
28052,72735,44683,24128,2147943344.7092,1539976430187565049.4896,44684,3.6768,0.0019,0.0016
28211,35579,7368,9634,2195757947.7537,1555760518318851833.4317,7369,13.4187,0.0002,0.0177
24945,96588,71643,31155,2148819431.3899,1541742960859500820.2125,71644,5.7347,0.0017,0.0027
4062,88670,84608,32705,2149645699.1977,1534487509348854941.7197,84609,6.506,0.0019,0.0023
6110,26481,20371,14399,2153360587.6363,1530464329297499003.8764,20372,5.0615,0.0015,0.0045
31909,34539,2630,26443,2116735513.9403,1551759614116564312.9128,2631,9.0199,0.0146,0.0032
9284,62932,53648,2843,2152582050.5134,1527768769041601714.6357,53649,16.2753,0.0019,0.0046
17200,25938,8738,24106,2146842735.1684,1515662311377672131.3512,8739,8.052,0.0054,0.0062
14542,75504,60962,5880,2156040817.6153,1523481259815950744.3068,60963,15.9098,0.0009,0.0054
6016,47195,41179,12662,2139196039.9942,1532104311404594241.7231,41180,7.4289,0.0048,0.0005
2668,37535,34867,764,2140982500.3333,1530234409592606900.6378,34868,5.126,0.0039,0.0012
7146,51111,43965,16950,2144369143.7116,1539102160731502847.3632,43966,4.4122,0.0027,0.001
9869,75481,65612,6626,2146229526.6671,1540577618306323213.5471,65613,6.5837,0.0021,0.0015
4969,74288,69319,12015,2148800893.0012,1526271581406530717.4999,69320,17.6114,0.0024,0.0031
9575,17463,7888,24031,2116063341.4476,1559562279605768878.3963,7889,12.3295,0.0141,0.0028
9497,13270,3773,11770,2137901439.5753,1550398186358679876.5708,3774,6.8565,0.0107,0.0077
14261,80385,66124,7412,2147403698.8697,1543484430690831412.2699,66125,11.4165,0.003,0.0022
970,79554,78584,5445,2143916088.6451,1546174953751738995.2204,78585,8.7575,0.0035,0.0013
5689,9848,4159,11923,2182598955.1308,1538227654220876089.1906,4160,15.4759,0.0043,0.0204
20995,39224,18229,28216,2130629656.4622,1541936107088530709.326,18230,10.5428,0.0091,0.000
26699,126607,99908,16527,2143453786.3789,1531472221293017457.8977,99909,6.4576,0.0032,0.0008
11724,56080,44356,27121,2146319323.5872,1540764959434389238.8222,44357,6.3367,0.0026,0.0017
30541,86323,55782,10252,2141802242.2836,1551435899808427459.1254,55783,11.3602,0.0046,0.0019
30991,39159,8168,5004,2107253990.3414,1540736294260298215.3934,8169,19.7605,0.0162,0.0022
909,36655,35746,21259,2154552763.8191,1536723504034277710.1879,35747,8.142,0.0006,0.0048
16511,54077,37566,10006,2152173068.3399,1521868166646101190.1545,37567,11.9265,0.0026,0.004
23005,65672,42667,23125,2141434425.5714,1538987631264165412.4894,42668,4.3641,0.0038,0.001
17385,47027,29642,8503,2143187869.1245,1533984719828293746.3093,29643,9.6182,0.0051,0.0038
17998,18664,666,18836,2079631929.8456,1484240466034839846.2565,667,6.7954,0.0328,0.0018
19773,117596,97823,9852,2137751172.1798,1540153943793503435.9541,97824,11.2979,0.0038,0.0001
24242,85704,61462,18040,2150938310.7136,1531596462933172684.6158,61463,8.8437,0.0015,0.0031
16750,98614,81864,19050,2149382440.4996,1534330325474827997.2739,81865,4.1273,0.001,0.0024
18616,114823,96207,23866,2151254435.1681,1547892076429074249.4716,96208,15.4592,0.0018,0.0033
17076,101847,84771,24266,2148662929.2394,1526399750395107610.5297,84772,14.4499,0.0026,0.0027
24905,57252,32347,16758,2158330590.8622,1544818354062859794.5411,32348,4.4658,0.0001,0.0061
21032,77367,56335,28568,2137870017.2234,1537043416989367520.6603,56336,6.4721,0.0044,0.0002
4128,95103,90975,30274,2154745376.2907,1530935031428654329.3469,90976,10.7062,0.0003,0.0041
16577,50574,33997,31003,2154940190.018,1530456447721849013.6196,33998,4.4402,0.0021,0.006
4985,10339,5354,18199,2189683353.7246,1485978434533906617.5176,5355,14.4634,0.0052,0.0221
24700,121733,97033,18336,2141598740.1047,1533282967641047241.0849,97034,7.2137,0.0041,0.0002
2892,60664,57772,19288,2143912890.7984,1530281064407035641.6133,57773,5.9171,0.0032,0.0016
18220,110056,91836,26868,2148825958.8074,1541864050838353566.3573,91837,19.2354,0.0019,0.0027
15316,64706,49390,9123,2133787586.8223,1542695197300397572.0804,49391,14.9577,0.0059,0.000
20050,39025,18975,1754,2164140931.7631,1515279757183129164.1133,18976,19.6624,0.0023,0.0088
29922,54107,24185,18968,2126845149.954,1541983551026769315.2186,24186,11.4827,0.0083,0.0005
15589,79206,63617,6530,2142299549.7554,1534859081159985274.6904,63618,5.6246,0.0038,0.0007
18064,38133,20069,24367,2144341113.6503,1531270906098926220.7789,20070,3.1818,0.0033,0.0023
16826,67434,50608,18828,2140414807.2382,1539836706753528170.9015,50609,15.1108,0.0036,0.0013
23315,55966,32651,1895,2144055282.5601,1559492230406427071.3968,32652,15.0731,0.0059,0.0036
18664,32043,13379,18163,2155500811.1885,1543841249330702692.1482,13380,5.4653,0.0023,0.0058
15944,75340,59396,11083,2160040638.8688,1522542016081081314.3427,59397,17.685,0.002,0.0068
5712,7831,2119,6654,2126443460.8132,1573413983900053121.9821,2120,15.5932,0.0154,0.0077
10653,98722,88069,23677,2149200528.1078,1537696754327516243.9555,88070,9.2367,0.0007,0.0017
15186,94514,79328,20267,2147190329.0922,1531839435129354872.1661,79329,7.7354,0.0023,0.002
11913,25328,13415,26808,2149787482.559,1535859585193483463.7868,13416,13.9241,0.0037,0.0053
21976,23596,1620,2689,2123435485.971,1533696986028320532.8326,1621,4.0889,0.0153,0.0057
21923,71903,49980,25703,2146026314.6289,1532151648883355915.5992,49981,9.9508,0.0022,0.0016
27326,53426,26100,5920,2141002766.1537,1556022604587932056.9188,26101,24.440,0.0051,0.0024
29849,45109,15260,17642,2159267304.0917,1560768873251236806.4273,15261,8.8202,0.0029,0.008
6367,67019,60652,6491,2137815012.3424,1535976526867122763.0186,60653,16.3811,0.0039,0.0006
27478,119272,91794,4932,2151562410.0179,1530014712918400320.2862,91795,8.7243,0.0019,0.0034
2444,52432,49988,26310,2149739891.5103,1537778259143227571.4802,49989,4.2705,0.0008,0.0023
1169,45880,44711,9618,2137199992.6891,1541326072155697657.7657,44712,11.9573,0.0044,0.0007
21634,86370,64736,31965,2148717156.8598,1537911382027926761.5299,64737,8.756,0.0035,0.0021
19287,47644,28357,32716,2166103761.2334,1538549084595695868.1698,28358,11.1688,0.000,0.0084
512,45859,45347,3258,2144234536.5973,1542672357259798093.5164,45348,18.6522,0.0044,0.002
12249,28215,15966,384,2118242239.9118,1534571893980582195.8742,15967,12.8383,0.0108,0.0004
21280,52719,31439,2566,2160121834.0038,1533646732185815682.215,31440,8.054,0.0006,0.0059
27051,79134,52083,31635,2144107745.271,1541886622540315636.759,52084,4.8903,0.0032,0.0014
6548,66578,60030,26059,2149743741,1528717260533789784.0174,60031,11.7467,0.0025,0.0031
11991,16437,4446,29311,2119568751.6341,1585812379217451964.8706,4447,17.3535,0.0219,0.0053
12480,23660,11180,22182,2132401641.0947,1553822973354128349.31,11181,11.0488,0.0082,0.0018
32062,83440,51378,16983,2143376762.6352,1529529000128382088.2909,51379,9.3499,0.0038,0.0021
2422,43750,41328,29107,2129784911.3273,1534964285589069310.9039,41329,24.0498,0.0095,0.0006
31539,71456,39917,4378,2134825651.5165,1538978759312272765.5875,39918,12.8708,0.0075,0.0006
683,76077,75394,30057,2150182296.5881,1536697548457159881.3897,75395,4.0146,0.0007,0.002
32217,36043,3826,25062,2148746634.7154,1528245092271873956.9823,3827,4.9407,0.006,0.0067
32668,55754,23086,1606,2145483179.7248,1521625984894236797.7942,23087,7.1796,0.0067,0.0039
13104,36021,22917,17972,2144792147.8662,1527315505741187456.1746,22918,6.3444,0.0043,0.0035
21450,21691,241,4276,2038305550.5744,1578290488957892307.3602,242,11.2857,0.0518,0.0062
22887,119871,96984,19105,2145365079.177,1534660611492629965.8933,96985,9.3505,0.0034,0.0013
14057,66960,52903,17984,2146445611.4574,1538379053543798155.6445,52904,2.4188,0.0023,0.002
16589,106947,90358,31510,2149018875.5386,1537996467547313022.8237,90359,8.7134,0.0007,0.0019
15197,44390,29193,13334,2140579814.8995,1540524027143966665.416,29194,8.0497,0.0032,0.0005
16413,28362,11949,1575,2165973244.3348,1542099998212426634.2912,11950,8.1986,0.0015,0.0097
1970,86642,84672,30391,2152137245.4945,1536997699614795029.3021,84673,8.0086,0.0007,0.0031
6455,81105,74650,8678,2151785387.5375,1536090952321816097.4212,74651,5.8433,0.0003,0.0024
8248,91076,82828,28777,2146481508.8777,1535083503009226708.635,82829,4.0191,0.0019,0.0012
12613,14883,2270,31979,2149768096.2523,1525235719668766802.3701,2271,9.9098,0.0082,0.0158
21613,34026,12413,5042,2164920696.0114,1544201836494727975.5548,12414,4.9167,0.0004,0.0082
18971,35117,16146,22825,2141531572.691,1505267939883371117.0637,16147,12.5569,0.0075,0.0055
16901,55081,38180,29959,2135836349.5025,1524022518364882422.3984,38181,13.9581,0.007,0.0007
21640,84950,63310,26520,2141917928.8496,1546449219511904686.7358,63311,14.3673,0.005,0.0021
19010,107749,88739,3510,2143491567.7495,1529111510786835417.7796,88740,9.9089,0.003,0.0014
26453,37274,10821,21540,2160253509.1378,1524606554447125172.8998,10822,6.401,0.0014,0.0076
14082,35624,21542,6837,2142555012.7926,1540054137945757350.9155,21543,11.4749,0.0039,0.0036
1942,21007,19065,26107,2128665418.3329,1535315432964343926.2507,19066,6.3098,0.0089,0.0004
1227,7971,6744,22893,2113056499.125,1581808758908161803.3535,6745,33.9978,0.0249,0.0038
19540,39378,19838,23382,2134990933.1282,1537611791037616077.6681,19839,16.1597,0.0078,0.0013
14521,82484,67963,19795,2154102541.3334,1538510667062778099.7593,67964,7.9983,0.0001,0.0032
13273,59069,45796,15494,2153151073.6962,1537717131503673172.1276,45797,4.0916,0.0007,0.0036
12580,102585,90005,31378,2142256782.7922,1540473015362921238.311,90006,9.1817,0.0025,0.000
23342,120394,97052,23424,2147274450.3034,1538249361154636121.1496,97053,6.1078,0.0013,0.0013
24472,85285,60813,10824,2137525602.3396,1533821789383304116.6484,60814,10.898,0.0055,0.0005
1621,44085,42464,3342,2159469473.208,1530633107537463052.5243,42465,21.5902,0.0006,0.006
16926,67766,50840,31597,2138590227.2216,1531807560825140499.7815,50841,8.376,0.0058,0.0003
29436,124317,94881,19403,2153031579.7903,1538647297871839027.5598,94882,7.9086,0.000,0.0034
22855,105089,82234,32005,2139734646.4888,1536864496008426595.5593,82235,7.0654,0.0039,0.0003
29294,61262,31968,22451,2165759197.46,1537247894721788124.2096,31969,16.252,0.0003,0.0086
30618,130147,99529,17311,2142634111.834,1541588776386559950.5607,99530,9.2254,0.0027,0.0006
14647,61331,46684,3844,2150352609.4527,1533277262601341091.4451,46685,6.8008,0.0011,0.0024
5029,71356,66327,23737,2144051309.8105,1540587019461147206.9267,66328,7.3952,0.0021,0.0012
15785,44005,28220,23883,2141178946.1854,1543689548962171858.8821,28221,14.5331,0.0066,0.0021
6679,65304,58625,8583,2149283045.211,1528952510011292701.5518,58626,18.9376,0.0028,0.0031
21659,119876,98217,22351,2152251880.1899,1533210774671647906.8057,98218,4.7622,0.0003,0.0026
24170,122482,98312,11579,2144235372.7992,1540689445530711783.4278,98313,8.3297,0.0021,0.0006
10389,109811,99422,11116,2140951809.3851,1547622422015139391.6925,99423,22.0513,0.0034,0.0013
27694,93520,65826,133,2152344017.2363,1545820031744251445.7774,65827,6.9602,0.0009,0.0039
21085,51333,30248,31046,2116649769.711,1551642614640689090.4344,30249,45.6954,0.0116,0.0006
16290,28661,12371,16903,2158822742.7532,1526850856471028968.9247,12372,11.820,0.0027,0.0082
14481,48359,33878,1554,2144573713.2634,1525798145754533553.8691,33879,6.0475,0.0041,0.0025
14240,55330,41090,10945,2157190536.4248,1546962932104316775.4233,41091,25.7865,0.0016,0.008
2466,31596,29130,10706,2137907997.6003,1533772938398379149.915,29131,5.9849,0.0046,0.0013
15865,85361,69496,24553,2141649585.1205,1537748409494113732.951,69497,4.6029,0.0031,0.0002
25929,49501,23572,16528,2150203769.8128,1518649192358689813.9048,23573,5.2568,0.0034,0.0044
3317,84033,80716,32662,2144498657.1529,1530053909916042424.4911,80717,17.6758,0.0043,0.0022
4863,55146,50283,28340,2144121818.6792,1539597970643014903.871,50284,3.4851,0.0032,0.0013
3407,6781,3374,24337,2167368352.2545,1517586511324380523.1657,3375,8.7339,0.0042,0.0149
30702,111553,80851,1469,2138149456.7727,1534326764799966985.1025,80852,15.0963,0.0041,0.0001
29733,119733,90000,19255,2147436967.7203,1528351296335996841.4394,90001,12.8168,0.0022,0.002
23425,111965,88540,20485,2152536893.1608,1535329529764632918.5149,88541,3.7065,0.0012,0.0027
13817,98780,84963,12058,2145514576.3782,1541301797466380615.9225,84964,15.8181,0.0019,0.0008
994,29138,28144,12625,2156062433.9259,1534211357232318864.7717,28145,11.1654,0.0013,0.007
3174,25400,22226,18824,2157477874.1804,1540062864606016031.3146,22227,8.834,0.0009,0.0075
17784,25699,7915,3120,2170915016.0882,1519360015262863917.1178,7916,9.1753,0.0046,0.0116
24784,72493,47709,5952,2158350142.0777,1545904151212284326.5516,47710,14.6624,0.0012,0.0067
7417,94604,87187,22357,2146921077.8462,1534743957015026709.8419,87188,7.6344,0.0019,0.0012
14829,107298,92469,9369,2142878826.5272,1536421891656169391.2574,92470,6.8422,0.0023,0.000
25589,39843,14254,7713,2160197741.6754,1540852650646899424.1415,14255,7.1643,0.0002,0.0057
21913,73713,51800,2292,2142995479.2903,1528778841341236836.911,51801,11.2844,0.0036,0.0016
7623,54354,46731,13182,2142105846.4552,1543336924169742716.8561,46732,12.5675,0.0047,0.0016
23040,64108,41068,24336,2137652370.6235,1544777838505494322.1434,41069,16.5978,0.0075,0.0021
25513,27984,2471,16686,2206939101.6036,1554580242468987394.4076,2472,13.3781,0.0007,0.0297
32417,60747,28330,8548,2154254580.4335,1522847440528255495.4904,28331,26.7454,0.0044,0.007
23023,101096,78073,6717,2142615454.698,1534412411079301469.4466,78074,10.3123,0.0034,0.0008
17069,27616,10547,7186,2141802745.8716,1538518400247691710.7035,10548,2.4861,0.0042,0.0022
4812,35284,30472,26517,2141954740.9783,1530986474648365257.2475,30473,4.128,0.0034,0.0009
10349,56115,45766,23055,2156212099.8541,1539961233449512134.5765,45767,5.4605,0.0004,0.0043
25884,68622,42738,18453,2132570630.9814,1531480550200125762.0407,42739,12.9629,0.0061,0.0003
446,91790,91344,7469,2150255545.3516,1526637414517443661.4654,91345,6.3523,0.0023,0.003
6216,16373,10157,30054,2147329063.3527,1536143623372518278.6339,10158,8.1647,0.0053,0.0046
13771,40865,27094,26217,2147202514.2389,1551722139454788198.0572,27095,8.6194,0.0049,0.0049
12114,45629,33515,2501,2147161710.9026,1531114177791434750.0668,33516,3.739,0.0036,0.003
10333,51831,41498,20248,2151073987.4638,1536066450162684607.9891,41499,16.0915,0.002,0.0031
29222,66500,37278,17216,2139256853.2188,1539089716737897822.3309,37279,8.5858,0.0045,0.0009
29017,82022,53005,11351,2152014397.966,1543238442093104611.2471,53006,13.5091,0.0017,0.0034
14668,43394,28726,20275,2164477998.9412,1547422362131613453.2497,28727,13.1972,0.0011,0.0071
18271,27520,9249,30989,2169292365.1692,1546697190978316688.8389,9250,16.2809,0.0018,0.0101
7495,19402,11907,26477,2138821074.7086,1550569635559100076.7873,11908,3.5041,0.0061,0.0026
20973,53100,32127,23854,2152990124.1614,1530303025602765974.0517,32128,21.5431,0.0033,0.0064
11078,110246,99168,19643,2145669140.5597,1524787963613723691.5158,99169,10.4981,0.003,0.0024
21803,87537,65734,14448,2132194643.7248,1541697795450135096.0427,65735,15.6887,0.0063,0.0005
6721,79190,72469,20992,2146516110.2765,1540479159175797950.4425,72470,6.3422,0.0017,0.0024
23038,105121,82083,27065,2138203672.1038,1540001051819442733.1223,82084,11.3437,0.0039,0.0001
11890,87901,76011,6259,2150158217.6124,1542424627073792409.8243,76012,6.1145,0.0016,0.0026
30257,39469,9212,20842,2143730228.5587,1526562202863198217.5208,9213,11.8974,0.0055,0.0048
11673,42370,30697,23853,2137151213.8173,1531724843297858140.3301,30698,7.4264,0.005,0.0001
1967,30843,28876,6337,2134986885.8851,1544626554849112561.6672,28877,5.6593,0.0071,0.0007
25031,91922,66891,1979,2152491490.835,1539230735441378312.7236,66892,8.1023,0.0014,0.0039
16971,114670,97699,7855,2152528170.0589,1534915267726677850.4845,97700,3.4107,0.0002,0.0028
8352,11083,2731,14465,2168168733.2775,1513576272231373990.6046,2732,4.4406,0.0046,0.0135
21000,48629,27629,15962,2147795481.4199,1543550515433972921.0924,27630,8.5038,0.0033,0.0032
15665,87293,71628,9560,2146814301.6629,1545397350202713592.6447,71629,9.8897,0.0023,0.0024
32390,98887,66497,13613,2157242253.0757,1530717925227182771.5585,66498,15.5727,0.000,0.0046
20368,51931,31563,15572,2150788674.9343,1527834109251324383.7508,31564,6.1592,0.0016,0.0036
16299,67684,51385,18073,2142661359.1187,1537660823888407990.3519,51386,9.0499,0.0042,0.0014
4695,43719,39024,13168,2149205718.6641,1531538279038479259.4923,39025,4.7017,0.0017,0.0026
12966,111580,98614,3072,2152757969.4644,1540378126294333144.3874,98615,7.9529,0.0009,0.0027
29154,49816,20662,292,2142716560.4147,1555835652870729346.5608,20663,10.0512,0.0068,0.0038
479,97438,96959,1285,2148752420.997,1539136368789902656.9396,96960,7.0524,0.0012,0.0025
18607,19486,879,10768,2079478635.3909,1439566404820241145.1108,880,8.1829,0.042,0.0074
19020,63729,44709,28659,2135168159.4682,1527463766513419548.8773,44710,10.4186,0.0059,0.0008
23220,57571,34351,13677,2142979173.8577,1537083811571320029.4308,34352,14.3301,0.0044,0.0023
14774,110263,95489,1152,2155407878.88,1532335713007290970.1767,95490,9.7134,0.0005,0.0037
4667,77113,72446,8517,2160576149.3745,1534673091129030581.3267,72447,16.4448,0.0003,0.0052
28641,103121,74480,16408,2144356384.8788,1543558757549696879.558,74481,14.4959,0.0037,0.0021
14658,97429,82771,30198,2158772453.1854,1545377308715774169.9824,82772,14.1532,0.000,0.005
17147,80186,63039,9814,2147120009.3985,1542166345822620440.6478,63040,4.4095,0.0023,0.0016
5867,19099,13232,29332,2145828918.4825,1554551461832394430.9578,13233,4.1059,0.0051,0.0037
29661,56754,27093,31479,2143833447.7522,1532722409260583784.2526,27094,7.8275,0.0054,0.0017
3308,59576,56268,9030,2138461412.3002,1530143628283778776.3916,56269,5.3171,0.0048,0.0004
984,13199,12215,32738,2145058993.0979,1526217715332236015.8028,12216,7.1155,0.0062,0.0044
2657,91435,88778,5533,2153041066.0896,1543044871453085975.6342,88779,6.3386,0.0004,0.0036
18333,79103,60770,24787,2151513065.2899,1546077764957836672.8682,60771,7.5447,0.0012,0.0036
6483,20964,14481,15243,2140585452.0055,1535323350080284123.5647,14482,1.5528,0.0043,0.0009
23034,28620,5586,2127,2161318275.3639,1521050449092150271.8592,5587,6.8757,0.0055,0.0082
21317,43131,21814,5592,2143499343.4237,1533651950364148023.049,21815,8.2888,0.0043,0.0032
22323,121759,99436,2675,2144484125.4109,1535630313235661069.0231,99437,9.7277,0.0021,0.001
22703,81303,58600,2547,2134465130.5198,1543480604951729205.0983,58601,12.4546,0.0054,0.0006
22069,67388,45319,21995,2151456921.1628,1536984529185207056.9741,45320,3.4206,0.0008,0.0031
23307,34477,11170,3520,2116935770.9342,1525120906228584010.6526,11171,12.7027,0.0141,0.0018
2680,90921,88241,7677,2148959308.2673,1544045398258001753.0239,88242,9.3373,0.0022,0.0025
2641,99024,96383,28788,2147905919.0777,1535067014481045668.4382,96384,1.7745,0.0014,0.0014
6923,78281,71358,4940,2148223756.4371,1540452158120181117.7957,71359,8.1632,0.0014,0.002
9375,70264,60889,25753,2145248154.3727,1543535763266209055.8907,60890,7.6971,0.0025,0.0018
20187,81781,61594,21098,2141377979.0097,1534148019589629840.6595,61595,8.6729,0.0042,0.0011
27304,118350,91046,2421,2139308355.8933,1533646781286638106.8623,91047,5.447,0.0031,0.0002
6240,6543,303,33,2139524836.2368,1471672962273460541.0755,304,4.0967,0.0268,0.0239
10428,49579,39151,3470,2154973427.8482,1539988054465241423.9114,39152,5.1334,0.0009,0.0037
4202,36013,31811,27212,2160650820.6156,1530107226107310229.4295,31812,24.6898,0.001,0.0078
29180,33651,4471,32370,2147582354.6342,1548990906984071825.232,4472,3.1538,0.0061,0.0087
17928,29076,11148,23061,2123170345.1301,1539877723752856165.1995,11149,16.0265,0.0108,0.0007
14261,51310,37049,10994,2146034030.4369,1541679949529266105.4267,37050,3.2514,0.0021,0.0016
20071,58670,38599,31867,2141073419.9808,1536369057623923410.7235,38600,7.3909,0.0048,0.0009
16907,37472,20565,4003,2143335520.8537,1543477247536436043.7957,20566,3.9162,0.0037,0.0016
16402,89090,72688,2437,2146659086.3896,1525053848196996553.4987,72689,27.6975,0.0034,0.0032
18182,38739,20557,9016,2144101986.1119,1532917553047070981.1333,20558,4.162,0.0048,0.0021
575,57355,56780,11524,2143259732.5438,1532075353357807360.7755,56781,8.7235,0.0027,0.0014
5858,48293,42435,29451,2145595583.7852,1529105645800528161.3254,42436,14.0866,0.003,0.0028
30086,91284,61198,385,2143926056.3666,1534878652986293077.1136,61199,1.4453,0.0024,0.0007
30783,75894,45111,19847,2141133103.0027,1527183726111341105.253,45112,17.5597,0.005,0.0024
1558,51380,49822,20382,2126666868.3456,1542880080972020809.965,49823,19.6073,0.0076,0.0001
15994,91750,75756,32269,2143966651.556,1539547718850810066.9346,75757,2.7011,0.0022,0.0008
24423,46720,22297,8624,2162928861.9714,1533917955817933871.7004,22298,9.0592,0.0002,0.007
24480,116743,92263,17245,2141706549.5541,1529219815066635799.9552,92264,9.5366,0.0034,0.001
26164,56586,30422,1645,2158478010.8419,1542124349952125440.2231,30423,6.6362,0.000,0.0048
32366,120459,88093,2017,2134034447.4229,1529563820761870324.4095,88094,20.6955,0.0074,0.0003
4711,8117,3406,25014,2154934233.2838,1573383957968326123.5399,3407,10.3946,0.0098,0.0145
15556,31038,15482,6444,2162773242.2525,1543440426509770352.1608,15483,6.9904,0.0018,0.0067
19673,57017,37344,26361,2143018527.7938,1553961223312454103.0302,37345,9.3695,0.0048,0.0024
6297,8781,2484,15473,2142040561.7449,1571829860866922209.2878,2485,4.6087,0.0133,0.009
22817,44898,22081,21761,2150921231.8119,1532974017726807481.952,22082,7.0851,0.0023,0.0043
29728,36607,6879,1872,2169164767.0349,1524350393796011355.9127,6880,12.0493,0.0012,0.0093
24032,32981,8949,16775,2148966686.8247,1552841119969981092.7079,8950,14.4974,0.006,0.0099
17471,62693,45222,8843,2147275020.5721,1524747036375723946.6189,45223,19.4261,0.004,0.0037
5753,17054,11301,16272,2155993036.2103,1566375813614210908.4409,11302,21.1379,0.0059,0.0102
14642,65085,50443,11366,2137579693.8113,1534664753941014817.85,50444,10.658,0.0043,0.000
7320,104247,96927,24642,2138181930.4317,1536927280865894172.0106,96928,8.3866,0.0039,0.0002
12457,86797,74340,32350,2168914869.7492,1543916794170762731.8999,74341,34.2803,0.000,0.0075
1980,14944,12964,32286,2153261895.6153,1543116728098364729.0366,12965,7.049,0.0024,0.0052
614,33430,32816,7429,2143176408.4886,1537720019876889646.1473,32817,12.7742,0.0046,0.0016
24054,69961,45907,27409,2158596031.0725,1536301601074806246.7284,45908,11.2556,0.000,0.0054
20805,37704,16899,24488,2114318817.6856,1514658370530481819.8407,16900,23.4529,0.0167,0.000
22883,81971,59088,5680,2141920778.6171,1541441415600855794.1652,59089,4.4032,0.0036,0.0018
19717,28484,8767,14685,2171466043.1788,1511542819696857709.8987,8768,15.2651,0.0019,0.0129
13890,88192,74302,19433,2150578331.584,1534943234943099722.3417,74303,4.5948,0.0007,0.0023
823,82226,81403,19818,2140872694.4804,1530002304259326334.8158,81404,8.5047,0.0038,0.0007
14709,87223,72514,2660,2135686288.1161,1536846959323853529.981,72515,14.448,0.0058,0.0002
25917,66006,40089,18196,2137889721.499,1522898317377001416.5724,40090,9.8917,0.0054,0.0013
16158,42679,26521,6212,2147663738.7679,1542855904543092750.6656,26522,6.6753,0.0024,0.0027
22011,49334,27323,10095,2144987144.9633,1534581191661671381.1879,27324,1.5787,0.0036,0.0016
11269,20102,8833,14297,2143331219.7572,1542555481604559105.2565,8834,6.3484,0.0049,0.0035
13977,99242,85265,12848,2147589979.565,1544873499973844889.7916,85266,9.5034,0.002,0.0026
6168,91689,85521,27933,2153678517.9169,1542345742953964650.52,85522,8.3305,0.0008,0.003
20693,28536,7843,31156,2131695870.2486,1540534475919173595.7569,7844,6.0127,0.0082,0.0007
30011,48756,18745,8341,2135912702.099,1529094742596146980.0681,18746,9.0674,0.0067,0.0015
27662,96921,69259,18910,2151850781.201,1544289870925264184.8342,69260,9.9882,0.0012,0.0029
14038,77976,63938,17543,2149226127.3061,1530593011217982706.7863,63939,8.5495,0.0016,0.0026
11523,70650,59127,31999,2147205968.9737,1540471155162825996.3889,59128,10.6448,0.0016,0.0024
3075,49255,46180,27271,2138911613.1869,1536281165344510275.8516,46181,10.8266,0.0058,0.0007
31162,81100,49938,25126,2160873691.5949,1534848165639052813.6601,49939,19.5071,0.0007,0.0051
30122,36614,6492,15129,2138828515.085,1538369149890334403.167,6493,4.8397,0.006,0.0022
14306,102409,88103,4859,2149542193.6257,1539682367068616801.4473,88104,8.743,0.0012,0.0021
14911,97220,82309,14259,2147646871.8579,1528612017876966180.6354,82310,4.9948,0.0022,0.002
2082,86291,84209,14205,2151662957.7254,1544527356573229290.2981,84210,6.8639,0.0014,0.0028
7128,56629,49501,13214,2141636491.6658,1543237348296384779.4924,49502,6.9375,0.0037,0.0006
4158,86600,82442,5203,2135980708.9234,1540455674207791248.8831,82443,11.2519,0.0044,0.0002
4854,22536,17682,2188,2112340154.4075,1557147025986543840.1114,17683,36.389,0.0183,0.0007
20539,87137,66598,1790,2145794239.8057,1538776839471933151.7366,66599,7.3424,0.0019,0.0018
22169,95124,72955,1078,2136868151.93,1546131216511464974.7182,72956,14.3373,0.0044,0.000
8385,43206,34821,2815,2154984933.7958,1546490801857679520.0561,34822,11.7902,0.0022,0.0048
5227,53852,48625,13616,2139935816.2982,1537979074824727470.8736,48626,4.075,0.0033,0.0002
1705,71166,69461,29486,2141398221.1371,1531549023360662468.4894,69462,1.9124,0.0034,0.0006
32551,39440,6889,31243,2147587260.9897,1557928166317928067.0294,6890,6.1018,0.0072,0.0054
2516,100607,98091,336,2146206290.7454,1535990751207825107.117,98092,4.4872,0.0016,0.0009
27338,29808,2470,18211,2197235269.2788,1553713554685620361.3674,2471,14.3963,0.0009,0.0218
8271,82290,74019,22901,2143789897.7225,1536136185464095317.7263,74020,0.9291,0.0025,0.0008
14953,69270,54317,26489,2152069855.4813,1537663042226370558.3454,54318,7.7694,0.0009,0.0036
25103,26005,902,4666,2131492300.2769,1542088714007299313.1105,903,5.3017,0.017,0.0075
28521,91757,63236,7809,2153612356.395,1531529354383435337.3023,63237,6.896,0.0007,0.0038
782,99627,98845,14099,2151436249.2022,1538187041706028666.1885,98846,8.0022,0.001,0.0024
3152,84243,81091,30297,2152059327.0528,1540564208665487033.952,81092,10.8405,0.0008,0.003
29129,127654,98525,2690,2151832501.5706,1538923215591820108.8546,98526,6.5074,0.0003,0.0025
10257,25193,14936,7856,2136567933.0116,1540408755744309032.7866,14937,5.7309,0.0087,0.003
2040,41359,39319,24514,2146109632.7484,1537298126753124762.6548,39320,6.2794,0.0019,0.0012
4270,25458,21188,12323,2143317025.7502,1533810952795492244.1327,21189,6.275,0.0033,0.0024
6996,25942,18946,29572,2143845874.5194,1543743335486726262.6443,18947,3.4595,0.0041,0.0027
2098,5815,3717,13787,2167075308.0584,1490797679010336220.3051,3718,10.6968,0.0052,0.0157
5227,84027,78800,15063,2148432940.0856,1547755559097031175.7549,78801,8.8575,0.002,0.0026
6168,7935,1767,821,2245545998.1154,1512606397340732002.4505,1768,16.9671,0,0.0434
22853,111976,89123,27073,2142342613.9191,1536673042515302254.2522,89124,6.5159,0.0024,0.0002
14566,26251,11685,14286,2160334012.4529,1553165051957325177.6712,11686,7.4635,0.0025,0.0088
32409,51690,19281,4787,2121907522.7378,1510549490027600549.0818,19282,12.9189,0.0113,0.0007
25878,54724,28846,13684,2148348551.3637,1542128113964688706.8797,28847,6.5298,0.0027,0.0039
114,52215,52101,3764,2138909020.7402,1527922229622820320.6403,52102,12.1816,0.0053,0.0009
26933,88163,61230,25328,2141227134.5775,1517659754194341772.4703,61231,19.4708,0.0054,0.0027
14381,32630,18249,28284,2145904233.0068,1526116998690858176.8973,18250,14.6728,0.0048,0.0034
14976,41123,26147,21672,2141899748.9747,1530954135730069130.0738,26148,7.6903,0.0057,0.0017
7212,19625,12413,12466,2121160469.9012,1535649299250703779.106,12414,12.1856,0.0098,0.0001
21646,64768,43122,2894,2140749967.6909,1542034756421026191.2769,43123,7.6031,0.0045,0.0014
27385,38333,10948,10268,2138781183.1832,1558983735511100336.7901,10949,5.2319,0.0064,0.0038
32585,76346,43761,20121,2137403764.1976,1539324621647640736.83,43762,15.6978,0.0051,0.0004
17730,67423,49693,14564,2156220831.8049,1542555648792407269.433,49694,7.3107,0.0007,0.0049
10841,81826,70985,30559,2135859700.2331,1538564052788049474.4898,70986,7.8009,0.0049,0.0008
12627,94241,81614,5916,2146374517.845,1536093293187795294.4783,81615,2.2538,0.0018,0.0008
31271,59217,27946,14210,2161837722.5029,1539707674255658445.4352,27947,11.7358,0.000,0.0065
2809,69584,66775,12185,2145056559.8939,1539896482011917276.6148,66776,6.0263,0.0036,0.0014
11972,22324,10352,8491,2155518115.112,1570356913886822782.0549,10353,14.5631,0.0075,0.0105
22456,26208,3752,7516,2107722035.0333,1522726606553904999.2691,3753,9.9815,0.0161,0.0002
17621,68985,51364,12978,2141734706.8196,1533466995634039402.7104,51365,6.387,0.0037,0.0009
7319,82403,75084,9352,2151683608.0209,1538695196016111739.8333,75085,10.0547,0.0011,0.0032
3186,10074,6888,26147,2162553495.9505,1536794584739990322.1234,6889,9.5345,0.0024,0.0074
11127,20492,9365,13192,2138952362.9444,1548162660891924199.4873,9366,4.8457,0.0093,0.0027
22021,48543,26522,13982,2137340824.5859,1526635052596764119.8305,26523,6.0713,0.0073,0.0013
26858,104116,77258,6053,2150192088.6688,1535888584658647439.0017,77259,6.9335,0.0008,0.0018
8011,69163,61152,11582,2148967965.0476,1530331914265791508.8082,61153,13.595,0.0026,0.0027
3087,33863,30776,635,2147512935.9574,1544604230627648629.9542,30777,5.7971,0.0028,0.0026
13516,43101,29585,2145,2134227903.9522,1537520995635242550.9998,29586,10.0369,0.0062,0.000
22884,71871,48987,21849,2145631545.8792,1540233447054518710.8316,48988,3.8374,0.0023,0.0015
1942,31721,29779,11918,2147302408.9324,1528359162647099412.3635,29780,7.3267,0.0029,0.0035
10312,98450,88138,18592,2141129256.2723,1532302720561310614.6466,88139,9.3029,0.0039,0.0004
13167,57593,44426,25161,2136978322.8721,1541302155351470265.0456,44427,10.5078,0.0048,0.000
28485,93996,65511,23579,2159099149.2379,1531451877722040404.0287,65512,15.1885,0.0006,0.0063
5833,71282,65449,11839,2147035118.7292,1541865324466486658.2735,65450,8.0244,0.0023,0.0017
22786,121218,98432,18175,2148749463.2044,1541835361998868561.6799,98433,10.7238,0.0014,0.0016
14526,61532,47006,2103,2133346270.5841,1544387764707575494.1412,47007,19.8614,0.0057,0.0002
30838,37775,6937,13270,2125394736.0915,1496823116828744699.8534,6938,12.5456,0.0146,0.0044
26122,66970,40848,24539,2164452813.7276,1535250682138978894.4239,40849,10.1089,0.0003,0.0065
19375,103861,84486,11244,2155056389.8178,1534036816843080498.624,84487,13.5583,0.0012,0.0042
21332,44347,23015,30414,2126979796.394,1534269126011092524.2294,23016,16.7447,0.0096,0.000
30699,59977,29278,2523,2153526017.2902,1510301952597266731.2324,29279,21.1665,0.0041,0.007
23056,92724,69668,31570,2155919893.511,1544068189933709511.7538,69669,5.7808,0.0006,0.0041
622,22202,21580,9660,2147878236.9033,1552036661287965349.9329,21581,8.3922,0.0043,0.0052
13718,89154,75436,23098,2135210910.6195,1530874262951889024.5391,75437,19.5297,0.006,0.0011
22291,66122,43831,16171,2163086222.7415,1540608572799384958.3222,43832,14.3572,0.0001,0.0063
19287,35557,16270,23908,2155717460.3356,1539353625959881023.9636,16271,3.5253,0.0011,0.0046
2858,45238,42380,10598,2142441827.8539,1536100635904824318.2589,42381,7.0678,0.0035,0.0013
3858,30125,26267,1816,2144085446.1289,1533981349229674542.1755,26268,2.3046,0.003,0.0017
1908,33332,31424,7762,2140171980.8736,1528302551498979997.1127,31425,10.0113,0.0048,0.0014
28151,32806,4655,5628,2168394815.6031,1524717610508011767.6208,4656,11.9682,0.0044,0.014
9926,40947,31021,21280,2146126546.2109,1547908901734485592.6852,31022,12.786,0.0031,0.0035
31844,91187,59343,23847,2140857342.7844,1542544333154014902.5355,59344,13.6267,0.0052,0.0012
30559,114825,84266,14096,2144776560.3975,1539194285376647811.2119,84267,15.7997,0.002,0.0011
11991,77741,65750,18035,2146480092.814,1529722820672729160.5526,65751,22.9302,0.0031,0.0032
21768,80324,58556,23296,2136276162.8965,1530780542317443903.7212,58557,9.951,0.0047,0.0009
4331,91260,86929,24341,2146021308.0719,1533627885639254842.9191,86930,3.1176,0.0024,0.0013
14369,22589,8220,11027,2159981131.6815,1522794468666211942.6975,8221,12.3806,0.0024,0.010
9204,17533,8329,15422,2137275541.2767,1527934531677905929.282,8330,3.0437,0.0058,0.0024
18816,68018,49202,10844,2148627230.1637,1541842001351577486.7728,49203,7.4981,0.0022,0.003
8038,48487,40449,7162,2137459689.9502,1536382983431752915.7525,40450,8.5139,0.004,0.0006
28221,112064,83843,11172,2157518068.3262,1545134774207588375.9244,83844,14.5497,0.0005,0.0053
15807,97720,81913,3606,2139888674.0088,1535857199157169285.585,81914,9.3237,0.0039,0.0002
5418,78653,73235,11283,2143848997.0742,1536016777300932353.3264,73236,4.1316,0.0028,0.0004
21145,53014,31869,23748,2144718231.9746,1535917764658869802.1993,31870,3.0567,0.0035,0.0014
1076,19848,18772,8055,2155656847.338,1524543948703489428.6211,18773,8.9631,0.0022,0.0059
6998,72414,65416,113,2156014219.2185,1539343370160484667.8835,65417,9.9259,0.0005,0.0037
13285,71900,58615,23287,2142910683.8297,1525677147471255596.2933,58616,6.6793,0.0034,0.0016
22417,45553,23136,18230,2159926676.5199,1552395747930090761.2297,23137,14.9529,0.0031,0.0065
23255,40919,17664,3950,2169124438.7789,1529268163166317412.3877,17665,11.5178,0.000,0.0087
11442,21550,10108,6773,2165664406.0314,1553430632930699890.3351,10109,5.4973,0.0013,0.0093
7767,104978,97211,11722,2148498167.2137,1531568444771324086.7602,97212,10.0853,0.0013,0.0016
30343,63881,33538,28118,2139518168.9693,1533875825248654061.6169,33539,4.417,0.0043,0.0001
9520,58352,48832,7865,2153415605.2661,1542768548493337590.7809,48833,21.5592,0.0021,0.0057
20892,120744,99852,13001,2154102304.8107,1542975535412936879.9106,99853,3.7815,0.000,0.0032
25549,69254,43705,17578,2156259554.7194,1535314118842138602.0594,43706,7.7828,0.0007,0.0043
19803,35161,15358,17615,2129825095.7889,1516609224959877318.0979,15359,6.6168,0.0109,0.0008
19067,88765,69698,4213,2130576088.2384,1531532327101108121.0381,69699,21.8775,0.0076,0.0006
7696,12764,5068,19664,2166038231.4149,1525622725775917200.2759,5069,8.7993,0.0041,0.0138
13770,82509,68739,14197,2151364876.7407,1534404989671931839.0815,68740,12.9902,0.001,0.0028
6343,77933,71590,28013,2148266216.0073,1541482038912387580.1052,71591,8.4257,0.0013,0.0017
12572,77110,64538,26788,2145559123.5096,1526298466801972113.9039,64539,13.6638,0.004,0.0026
9002,89649,80647,17834,2151257725.4827,1533151456488619208.4965,80648,5.5721,0.0013,0.0027
16261,95698,79437,23719,2134081603.5976,1533891476498731824.2864,79438,13.5238,0.0053,0.000
12832,69287,56455,28717,2143588905.2954,1526230080068225222.9637,56456,11.0956,0.0037,0.0016
16785,29939,13154,19659,2159969020.4737,1575345812585709968.7554,13155,26.0962,0.0062,0.0094
27326,33450,6124,2004,2198198081.3783,1533246380763444542.6381,6125,18.6462,0.0003,0.0215
19398,40597,21199,31337,2154589226.9581,1538962119199521068.1813,21200,4.6285,0.0004,0.0045
17173,20048,2875,29750,2164771154.4068,1596387576967149081.4054,2876,11.572,0.0099,0.0194
25222,83794,58572,28617,2139369638.3923,1530244035500418420.7087,58573,8.5681,0.0043,0.0012
5507,71292,65785,10007,2150427505.7288,1529431090963404208.1129,65786,4.0422,0.0013,0.0025
4737,25865,21128,32237,2136356838.6768,1542033752486575526.0765,21129,27.5045,0.0083,0.0025
6916,78498,71582,26103,2134068189.023,1532143603951686304.2343,71583,10.5537,0.0057,0.0003
24301,123205,98904,24451,2151732196.2765,1540325469891339325.9494,98905,8.7935,0.0008,0.0029
18123,48245,30122,32461,2140192651.8379,1554628514768941798.654,30123,45.7141,0.0054,0.0026
27456,74465,47009,707,2140045059.7329,1527737202512691119.105,47010,15.1094,0.0056,0.0011
3346,80191,76845,29572,2145216607.8379,1544483545971734721.2286,76846,9.3618,0.0029,0.0019
5890,38536,32646,15402,2117411075.0028,1532679524829672962.2083,32647,25.8029,0.0105,0.000
9680,78358,68678,17012,2147632752.6629,1534180375632222222.9575,68679,4.8831,0.0014,0.0017
7123,77958,70835,25380,2151183610.2766,1541991218305796818.7801,70836,4.2499,0.0009,0.0027
11343,66404,55061,6513,2157432722.4475,1537727903461873555.7569,55062,8.8471,0.0005,0.0049
6569,35018,28449,24243,2146259578.1427,1520126446223753883.1913,28450,12.432,0.0042,0.0045
27337,36788,9451,24772,2132587104.244,1544630388758244431.5933,9452,14.2128,0.0088,0.0022
8988,21200,12212,20821,2147450385.664,1542233251065058197.1873,12213,2.9188,0.0029,0.0029
17717,86545,68828,25940,2145493435.8734,1540262449532199081.4845,68829,5.7381,0.0029,0.0014
3535,52417,48882,19858,2144675385.2279,1533045062267602232.2515,48883,6.3496,0.0028,0.0014
200,45093,44893,8497,2146185239.403,1553034187371271020.9945,44894,12.4898,0.0034,0.003
26939,96143,69204,31768,2147396895.7385,1543083829888546788.4561,69205,5.5725,0.0021,0.002
13687,82951,69264,24409,2145080704.9657,1548874927530273858.1667,69265,11.6797,0.0042,0.0019
30487,65037,34550,25695,2146996622.4647,1536666320696481801.4594,34551,3.8664,0.0021,0.0022
23611,75213,51602,26642,2146555671.729,1534021301603834909.5057,51603,3.286,0.0018,0.0016
12350,17313,4963,3911,2127252256.4363,1507870342058016816.8592,4964,10.507,0.015,0.0059
14916,47150,32234,2191,2159799930.0066,1541855668238470726.3156,32235,4.4391,0.0002,0.0056
7316,90261,82945,25898,2143328323.6466,1539927235925057037.5492,82946,5.6652,0.0026,0.0008
27138,65847,38709,25561,2145494160.8941,1548406101179038761.382,38710,8.6528,0.0028,0.0028
25585,33571,7986,15582,2108300390.6638,1550072559882664709.7216,7987,13.4429,0.0162,0.0004
18204,63340,45136,20801,2158485318.9417,1541568642325901148.0154,45137,14.9315,0.0001,0.0056
10793,64056,53263,7544,2147467257.5481,1534141165152552779.9076,53264,2.7082,0.0021,0.0016
21779,40913,19134,3346,2151190199.8107,1533965203478196183.0688,19135,4.5864,0.0019,0.0037
17790,88685,70895,6626,2145912625.9879,1538747846324513157.9645,70896,11.6579,0.0024,0.0016
6748,58990,52242,14736,2147477709.0537,1538808231058933554.4681,52243,9.0342,0.0032,0.0018
21611,81031,59420,439,2155718926.2209,1533245987328121011.6407,59421,6.9081,0.0008,0.0043
16313,111038,94725,20388,2144230224.2914,1539841003378154909.5077,94726,7.2602,0.0026,0.0007
21056,95626,74570,15536,2158643068.5219,1530206745333236933.5841,74571,10.7037,0.0009,0.0051
8877,33348,24471,10705,2152249584.533,1556727290458955785.0083,24472,8.6848,0.0038,0.0053
12354,110816,98462,32669,2142599712.477,1536951278404900736.5704,98463,15.8512,0.0033,0.0005
18167,92683,74516,19140,2150518093.6183,1534997736646110523.4141,74517,10.5389,0.0008,0.0027
16966,40847,23881,14598,2144345342.5584,1536316304380163245.4776,23882,3.9496,0.0029,0.002
3526,79690,76164,6779,2146597519.1104,1543407261929344177.0877,76165,4.9307,0.0019,0.0018
17569,72538,54969,26114,2152479156.7707,1539223643351189848.4454,54970,5.2091,0.0009,0.003
26002,87955,61953,7690,2137645753.9768,1530896544969570227.628,61954,12.9201,0.0049,0.0002
32499,113079,80580,9681,2145619825.8899,1538699458666073337.1048,80581,14.7799,0.0034,0.0017
27037,96364,69327,967,2144884125.1026,1530980857875833175.8257,69328,11.7141,0.003,0.0009
12668,109725,97057,32106,2147440351.9749,1534355255278118652.7994,97058,3.8364,0.0014,0.0012
2296,85498,83202,10324,2146587205.8615,1530786160188254310.8679,83203,11.5073,0.0022,0.0029
23392,84612,61220,21497,2141557210.5317,1541016867589335807.4899,61221,3.0324,0.003,0.001
14827,97961,83134,13750,2143435462.5969,1529478939554523851.9428,83135,9.4635,0.003,0.0014
23973,91407,67434,17258,2146146298.4277,1541752301356104322.0419,67435,3.8156,0.0021,0.0015
7438,95167,87729,17422,2149663457.8192,1543743471350665892.7208,87730,20.6907,0.0022,0.003
13807,83460,69653,32331,2157311591.0215,1545723234907309385.7583,69654,7.8428,0.0003,0.005
16015,103828,87813,24387,2141493190.4,1526682434271728015.2564,87814,13.8429,0.004,0.0006
22520,29692,7172,9200,2135287290.808,1535785946860665526.5393,7173,5.7634,0.0074,0.003
8901,14766,5865,28696,2149544327.1829,1543282465273373137.7226,5866,2.9957,0.0057,0.0068
28873,61795,32922,15831,2142805764.5897,1534961973844919222.3057,32923,6.2084,0.0035,0.0024
15624,107594,91970,748,2147187591.2295,1529954613572898626.5319,91971,15.2332,0.0035,0.0026
883,60179,59296,4831,2143984932.2542,1535344342471063751.095,59297,1.5805,0.0022,0.0012
15785,82257,66472,25021,2144441588.4628,1542148724435884292.0523,66473,4.1881,0.0031,0.0011
7589,78946,71357,4901,2158930630.8656,1534113076847740256.2979,71358,10.1313,0.0005,0.0048
2214,22290,20076,5526,2136450157.6855,1518022827167323504.0126,20077,18.5926,0.0085,0.0028
30028,110152,80124,7584,2141894204.192,1533358744906004507.6396,80125,14.196,0.0039,0.0016
15611,30267,14656,13607,2127131274.4665,1538815786198496141.0568,14657,7.9304,0.0102,0.0013
28889,71485,42596,24683,2148098027.886,1537885120681520430.7128,42597,4.199,0.0019,0.0023
27923,73724,45801,14208,2137673362.6229,1536965730697012521.8591,45802,6.8035,0.0059,0.0004
32679,56762,24083,29017,2121210546.7566,1544970895105380009.7209,24084,19.7258,0.0106,0.0004
10184,53713,43529,31152,2141466016.3094,1534734749151339969.9139,43530,6.7621,0.0044,0.0008
20137,30836,10699,22921,2119543517.5441,1520163762098434807.1624,10700,10.9944,0.0142,0.0003
28010,71406,43396,31603,2156152311.6124,1537310465477741044.1265,43397,6.6263,0.0004,0.0044
24740,46842,22102,26397,2145202991.253,1527894499987680532.9519,22103,12.6556,0.0042,0.0037
30452,100310,69858,15906,2151717107.7943,1536708754411914606.2912,69859,4.1396,0.0012,0.0024
21791,78955,57164,10515,2143718560.3955,1538003748729982520.6249,57165,7.899,0.0031,0.0007
17977,93334,75357,29557,2155463402.3817,1542298926436753635.5074,75358,11.6646,0.0008,0.0046
12786,54332,41546,18585,2141630963.8472,1533824793179600235.3366,41547,5.8156,0.0037,0.0012
3154,6708,3554,11014,2164354102.4194,1523297740930432827.1256,3555,9.2574,0.0063,0.0167
21293,33994,12701,25926,2142161561.1196,1516677823080927724.2401,12702,14.8503,0.0084,0.0046
2453,12868,10415,17708,2111870081.2542,1554931479385153049.1051,10416,20.1253,0.0162,0.0002
28974,122653,93679,18808,2153986562.6925,1528665543298545198.801,93680,9.8987,0.001,0.0038
4392,41221,36829,7797,2140743345.2211,1538605568012544949.8902,36830,11.2628,0.0047,0.0015
20321,46824,26503,6116,2143303332.2769,1538569481443603882.247,26504,5.9956,0.0055,0.0017
14504,96170,81666,27449,2149629152.0645,1545009217044360537.4365,81667,6.8204,0.0014,0.003
15783,100762,84979,20964,2145000897.3057,1533150873041049441.6501,84980,8.5594,0.0021,0.0012
10682,79100,68418,16860,2137960842.2512,1546438914603286210.9047,68419,11.9251,0.0044,0.0014
3905,44459,40554,17129,2144444945.69,1545136465050631519.5507,40555,5.6249,0.0032,0.0027
29817,115597,85780,31257,2155473736.8528,1535757249880403480.8124,85781,16.0973,0.000,0.0044
8360,81498,73138,6765,2145739757.4437,1537508711657269259.1572,73139,8.5505,0.0025,0.0012
17190,84162,66972,17677,2138886514.7277,1545240486643593832.4745,66973,14.8861,0.0053,0.0014
9733,89449,79716,20534,2140970777.8164,1542193375371157014.5144,79717,20.8164,0.0041,0.0011
22421,43844,21423,5536,2138250476.4993,1533626800813736689.9371,21424,5.4554,0.0049,0.0006
2324,39514,37190,19568,2146003476.2787,1526194038610440157.4612,37191,5.5802,0.0028,0.0026
6844,33805,26961,29359,2160930209.2659,1522966254074056317.0899,26962,14.434,0.0017,0.0084
25473,77389,51916,29521,2150283632.6497,1539131562002432635.4468,51917,8.2546,0.0021,0.004
30,55096,55066,28918,2153540122.9781,1535355414231569737.7687,55067,4.0795,0.0011,0.0035
24960,39865,14905,27627,2142152211.0505,1528595130898965806.7451,14906,8.0205,0.0077,0.004
12486,86406,73920,26422,2140779093.6369,1538828007474240187.1416,73921,7.7447,0.0036,0.0003
11896,50486,38590,10039,2150733389.0462,1546551751126383745.9757,38591,3.5483,0.0021,0.0032
10786,43764,32978,28448,2143572690.7202,1536192190824742684.5631,32979,7.3075,0.0049,0.0019
25990,27387,1397,30258,2141653978.985,1552971213964685356.7201,1398,2.8204,0.0097,0.0072
2552,66805,64253,19174,2155358486.1276,1545846511199721242.3411,64254,12.1828,0.0008,0.0041
30724,54283,23559,2311,2154550495.7913,1543485035902432883.1763,23560,4.5606,0.0016,0.0045
20752,26510,5758,17782,2178190987.9637,1582315564152526185.2668,5759,17.0614,0.0037,0.0179
1910,7425,5515,6005,2154186617.236,1564242177332420967.0418,5516,14.2027,0.0083,0.0109
9073,80175,71102,6938,2158414060.7626,1543299334453265191.1997,71103,11.0719,0.0004,0.0057
26811,29015,2204,10846,2087240739.2503,1547853190164925284.9305,2205,6.922,0.0255,0.0023
9754,13200,3446,10345,2131578163.0943,1537480830270086324.4828,3447,9.844,0.0143,0.0051
18851,113403,94552,8922,2159077335.3507,1532354631432449462.3767,94553,17.3178,0.000,0.0046
16260,96395,80135,7802,2151521429.2303,1543051560803085153.2718,80136,5.3955,0.0009,0.0029
31871,105118,73247,6869,2147080225.0902,1528364906617872208.1362,73248,11.0226,0.0028,0.0021
18258,105345,87087,8857,2142942261.5235,1543257312901646813.2757,87088,16.685,0.0035,0.001
8394,99586,91192,1602,2152389487.7846,1544428168657094531.5581,91193,15.1319,0.0012,0.004
4518,61126,56608,23190,2152429381.0713,1519818429354664620.1198,56609,23.8095,0.0019,0.0052
2318,64001,61683,10403,2144465894.3194,1544348022666228925.4462,61684,4.3377,0.0025,0.0016
3765,46249,42484,22454,2145445813.1353,1540308278794042448.344,42485,6.0798,0.0029,0.0025
10215,92818,82603,32610,2134504753.4154,1538026408025560735.1499,82604,11.9653,0.005,0.0001
6005,34796,28791,13523,2157211573.8473,1546537795847286467.3964,28792,9.0679,0.0012,0.0063
12856,77481,64625,18696,2138264867.0825,1537433041112720376.4574,64626,25.8048,0.0062,0.0014
29844,89647,59803,26517,2147680115.9916,1538648246596916355.2626,59804,8.1066,0.0017,0.002
8441,73497,65056,26194,2161266893.7089,1535315265924959719.5472,65057,15.7745,0.0003,0.006
18845,108799,89954,9465,2146039874.6049,1539313468745577403.306,89955,4.4729,0.0018,0.0013
5237,62368,57131,24041,2133565568.9227,1529744040457494727.0631,57132,13.547,0.0061,0.0007
2742,10710,7968,26409,2172323299.1408,1544599229667909155.5365,7969,8.462,0.0003,0.012
3159,74872,71713,26724,2143243473.5534,1536963541262855527.2526,71714,7.5085,0.003,0.0009
11378,52094,40716,18995,2145043572.6393,1549586771152053881.4555,40717,7.2734,0.0033,0.0028
8888,86970,78082,10888,2148098965.2252,1535978901984411581.843,78083,7.6292,0.0016,0.0015
992,69769,68777,16271,2133678439.8182,1532051099114880023.3531,68778,11.5049,0.0062,0.000
6285,64045,57760,1851,2155712189.1032,1543864910212646879.6992,57761,13.1742,0.0019,0.0055
2240,63659,61419,5859,2144445647.2831,1547278889661006560.2543,61420,11.7282,0.0034,0.0023
20545,117269,96724,32217,2152960426.8232,1540159896359573286.0044,96725,5.1626,0.0007,0.003
2115,47894,45779,16371,2150846979.4021,1538918759754978397.1619,45780,6.5398,0.0009,0.0021
15271,91990,76719,10617,2145720102.0435,1549187792792845379.6518,76720,22.9016,0.0045,0.0032
30650,65605,34955,4409,2125673117.6337,1544079042859664394.4367,34956,25.1483,0.0098,0.000
26154,68489,42335,5916,2148330427.7479,1545745815754458973.6322,42336,4.0292,0.0022,0.0034
19578,52244,32666,11889,2159519720.371,1528495492196623961.6781,32667,10.0869,0.0011,0.0057
17298,54287,36989,19499,2142808060.7582,1529746824790351174.8879,36990,12.5896,0.0039,0.0016
14466,91714,77248,15463,2138375381.5407,1542135676910329803.8045,77249,7.9098,0.004,0.0002
27104,120293,93189,14064,2145742046.6163,1536577928070312966.9805,93190,14.1054,0.003,0.0016
1835,46393,44558,28756,2139925922.4128,1540847486713638946.5278,44559,20.8037,0.0048,0.0003
19550,34885,15335,1775,2139692349.1849,1536313559120274568.6286,15336,8.3865,0.0049,0.0018
23763,82488,58725,19211,2151516932.2129,1539435820825206159.237,58726,5.8019,0.0006,0.0027
30038,113105,83067,10203,2157646821.0233,1532581058800818684.1761,83068,13.1349,0.000,0.0051
20622,90358,69736,14778,2143594982.8767,1539135123000118299.3751,69737,3.7743,0.0024,0.0006
4368,5822,1454,23378,2150708787.3258,1548318870189507127.5062,1455,8.1045,0.0123,0.0136
7338,43992,36654,392,2146732534.8291,1545308940719169629.9112,36655,2.9574,0.0025,0.0022
15438,67486,52048,18308,2161175859.1942,1531802702958057342.8102,52049,15.6182,0.0003,0.0063
31838,121732,89894,10769,2141127711.8058,1534168381941995434.3113,89895,9.3478,0.0033,0.0001
27363,76181,48818,6339,2162850672.7087,1530638240280225800.662,48819,22.2744,0.000,0.0058
26758,71264,44506,22352,2140271560.3047,1534949986913342186.8851,44507,5.3586,0.004,0.0009
31699,75138,43439,14233,2136665977.3593,1535958032587455700.8357,43440,11.9498,0.0049,0.0005
21133,65523,44390,25092,2131703060.2153,1529585241284609565.0133,44391,21.0354,0.0078,0.000
13894,96056,82162,28335,2130242264.6392,1527213706921614401.8891,82163,29.067,0.008,0.000
30161,43481,13320,3094,2144713593.718,1535048659875651988.5151,13321,6.4621,0.0065,0.0059
10449,29697,19248,1113,2132485262.2363,1560817710039521334.625,19249,13.6471,0.0087,0.0019
14629,107242,92613,20694,2154333038.661,1533367622900566135.3884,92614,9.3759,0.0002,0.0037
13373,89859,76486,13295,2138623160.5623,1541850370407956256.2368,76487,14.6389,0.0042,0.0001
24980,49046,24066,27987,2162775481.0724,1547641516574531988.9254,24067,12.6644,0.0009,0.0076
3317,37446,34129,25419,2150034976.1666,1535619270150592924.5742,34130,2.7688,0.0021,0.0026
8461,71119,62658,1945,2155830977.832,1534726321195513722.7681,62659,13.8924,0.0009,0.0035
29718,122081,92363,10826,2151232583.9275,1541191015505833710.1884,92364,5.0541,0.0008,0.0025
3002,79042,76040,13460,2141561745.5309,1542470957190656589.2608,76041,6.8744,0.0033,0.0003
13436,25268,11832,29443,2172670960.2068,1569483083330383205.7638,11833,15.3352,0.001,0.0156
3871,27214,23343,24887,2171542724.3883,1523397639028342223.3033,23344,15.9738,0.0002,0.0104
2113,47509,45396,8017,2139215303.6699,1538583457966451445.6221,45397,6.1802,0.0043,0.0011
21129,99304,78175,17098,2141199436.999,1538990386302529507.6101,78176,8.9062,0.0041,0.0001
9962,84393,74431,31902,2149309976.3667,1537129641038934702.467,74432,2.6961,0.0011,0.0023
4278,52856,48578,21968,2145760854.634,1540729510881303949.484,48579,4.3684,0.0022,0.0015
32698,112787,80089,17785,2142582803.297,1531939904917569197.4809,80090,4.0922,0.0027,0.0004
12826,110663,97837,26343,2144287071.3516,1530535141947722390.6919,97838,11.2991,0.0029,0.0019
2132,86994,84862,27544,2154844221.6588,1534557918794619775.2726,84863,7.7199,0.0003,0.0036
8466,39639,31173,31554,2145129884.5845,1535693655713242709.0141,31174,5.9472,0.0032,0.0021
22591,53653,31062,13635,2164778325.7258,1544844314846542850.9132,31063,13.8514,0.0001,0.0087
6811,105679,98868,3978,2146496154.6168,1528895824804514614.353,98869,11.976,0.0021,0.0019
23137,77363,54226,17866,2144950366.2859,1539568762012848876.9028,54227,4.5905,0.0025,0.0011
9365,16696,7331,2773,2129707466.3369,1536669456157827164.6146,7332,10.1138,0.0114,0.0013
32711,107446,74735,9254,2145144253.4332,1537939952983226457.9903,74736,2.8409,0.002,0.0009
5166,67227,62061,10720,2140199690.976,1526943528812315098.3844,62062,4.6988,0.0042,0.0009
20518,52432,31914,11373,2148202872.8574,1541327489552385560.1134,31915,2.7579,0.0022,0.002
31512,98948,67436,14228,2138499239.878,1540141542853372979.7392,67437,5.7074,0.0046,0.0003
1322,9556,8234,16908,2168302545.5931,1553730985800761426.4813,8235,6.6687,0.0011,0.0136
32611,105598,72987,30652,2151717429.4143,1548432773760869356.6609,72988,19.8991,0.0022,0.0036
3765,92176,88411,11568,2151556977.5623,1542005139726631542.0497,88412,7.3123,0.001,0.0028
1926,16358,14432,18732,2131293841.9311,1520564769709755691.7519,14433,17.7732,0.0119,0.0019
10478,19095,8617,18826,2153226196.9537,1516309303485527107.0618,8618,6.955,0.0038,0.0065
14769,37647,22878,23422,2146899795.1387,1535198980102735271.7723,22879,7.6377,0.0025,0.0017
26837,47936,21099,12910,2131898204.1427,1533199753860700108.9559,21100,14.4228,0.0109,0.001
9271,50668,41397,21961,2151862501.138,1531648543974645466.8438,41398,10.4824,0.0019,0.0044
14017,68834,54817,4383,2133942100.0827,1525093762076265038.0221,54818,23.9881,0.0077,0.001
23332,55649,32317,16420,2151663097.963,1535008007345262807.1002,32318,6.3954,0.0023,0.004
14066,77441,63375,6527,2147780565.0627,1518521658746816711.2923,63376,17.242,0.0042,0.0044
11115,58050,46935,11627,2145138578.416,1543037547528422204.6024,46936,9.6886,0.0031,0.0025
5296,74721,69425,31785,2163045519.5226,1541696740075725854.5698,69426,14.9437,0.000,0.0062
16931,82850,65919,20634,2132501635.6515,1533248211612381511.9591,65920,22.4049,0.0076,0.0006
23686,84114,60428,3170,2139816117.3261,1537036802161567824.7248,60429,5.9033,0.0039,0.0001
5666,105473,99807,16867,2145618950.5709,1537537054689087443.6021,99808,1.3805,0.0016,0.0008
27003,42605,15602,21958,2153343762.9299,1532716270893539942.6211,15603,4.3641,0.0011,0.0045
29196,88420,59224,16555,2148013357.1516,1533004075390539664.1888,59225,3.3579,0.0015,0.002
26430,33813,7383,13757,2156631760.8109,1531095306706731001.5022,7384,2.6381,0.0029,0.0066
25798,122702,96904,19409,2150230527.5627,1545805984479481757.9359,96905,13.3487,0.0016,0.0028
23115,109629,86514,5174,2147023100.5274,1540130862455018331.2021,86515,8.8072,0.0021,0.0018
6510,78690,72180,19912,2142309961.9558,1531044475439759734.6109,72181,12.4023,0.0036,0.001
14164,54660,40496,18032,2157405422.9317,1538202487794591921.34,40497,10.5418,0.0002,0.0039
6502,96630,90128,18077,2141198440.7413,1534761873263641155.6679,90129,7.8574,0.0041,0.0007
16375,96712,80337,3751,2165528496.1357,1531444808335270428.1457,80338,27.4597,0.000,0.0071
19732,87098,67366,2030,2167957508.2283,1538203880666956957.6318,67367,24.4736,0.000,0.0068
25468,122122,96654,14100,2157975508.1084,1530690428193618641.1079,96655,22.6052,0.000,0.005
22220,25112,2892,13658,2124133192.5627,1524512776072837859.2319,2893,3.8941,0.0142,0.0043
30234,46558,16324,415,2157302248.275,1533779949540167549.8419,16325,4.2454,0.0006,0.0068
7240,78738,71498,31131,2142068916.7883,1541828523007509268.4042,71499,8.9879,0.0036,0.0008
2120,76927,74807,24056,2133076906.6385,1538467754988664462.6328,74808,16.0079,0.0056,0.0002
7030,106992,99962,15282,2151061842.6896,1538585009109214786.0335,99963,6.0746,0.0005,0.0021
16727,85706,68979,3500,2154460579.5106,1548937150794489813.7508,68980,12.1018,0.0013,0.004
16133,79768,63635,984,2143901913.1254,1531689507037472781.4171,63636,11.9012,0.0029,0.0013
9810,14949,5139,10405,2179264664.7125,1534869890786220154.4329,5140,7.9906,0.0019,0.015
16406,56908,40502,13884,2152888411.0927,1540457450672549345.7061,40503,10.7234,0.0013,0.006
18616,85281,66665,28861,2141043160.9859,1543971146633252415.0225,66666,8.7827,0.0035,0.0005
20124,106140,86016,13796,2162640612.8011,1542366117359756865.0488,86017,30.7783,0.000,0.0083
11381,105506,94125,24630,2150874324.0057,1543210942770259030.4355,94126,9.3462,0.0012,0.0029
17330,84582,67252,6778,2142730364.3848,1536654411188423590.3465,67253,14.9197,0.0026,0.0007
1735,6358,4623,8497,2188269668.5934,1563238888741380596.2171,4624,11.4389,0.0016,0.0205
14880,25199,10319,26201,2142345658.6473,1520503653747804882.9616,10320,14.4807,0.0078,0.0065
11280,61501,50221,3224,2150366976.3605,1545292525036291473.6229,50222,4.7871,0.0017,0.0033
4894,91838,86944,29009,2144435364.1891,1535314351269849876.9316,86945,3.7959,0.0031,0.0008
19288,85359,66071,7744,2149185796.5403,1535366422968229861.7208,66072,8.645,0.0014,0.0027
16427,69536,53109,32440,2145509314.5624,1545639173104837856.5369,53110,9.5277,0.0027,0.0017
13779,50399,36620,2301,2139620514.092,1530630392871578127.8635,36621,8.9762,0.0061,0.0015
18702,37866,19164,4606,2126863053.9911,1537224589410155866.7473,19165,10.3155,0.0109,0.0011
31299,126896,95597,7129,2145477963.0145,1540255130262484200.5287,95598,3.3989,0.0014,0.0008
32587,93084,60497,16102,2147923437.9918,1531984462395893549.2504,60498,6.5916,0.0019,0.0017
19163,23682,4519,18976,2147902449.7549,1527942405600776995.7319,4520,3.941,0.0073,0.0072
9958,43668,33710,26337,2146030144.5358,1525419685403246116.5338,33711,8.635,0.0039,0.0029
26376,82587,56211,3842,2143973650.2826,1531773813769918973.0747,56212,18.8591,0.0047,0.0019
2732,20311,17579,31367,2172810323.7899,1564683635339446202.9692,17580,16.4275,0.0013,0.0113
27290,115174,87884,28582,2152471210.1624,1534591961111773192.8062,87885,5.6842,0.001,0.0025
17621,29622,12001,20619,2135000178.2515,1547028259084434509.9035,12002,10.6527,0.0101,0.0018
12837,83864,71027,17890,2155242787.292,1531624278285303496.9146,71028,8.0772,0.0005,0.0038
18937,97335,78398,19588,2150068548.9839,1546053991200857471.8161,78399,11.5894,0.002,0.0032
7488,79954,72466,3176,2147819781.4769,1535300319526731042.5244,72467,10.3766,0.0019,0.0017
14624,103323,88699,2068,2147757877.0917,1531608758477321299.1714,88700,8.2765,0.0023,0.002
32587,123148,90561,20615,2150085076.4211,1541081228244783510.7392,90562,3.2977,0.0008,0.0019
8365,48572,40207,31652,2143514656.3476,1535876998383930102.3314,40208,12.3902,0.0055,0.0014
5579,93944,88365,29780,2138524904.7646,1538062463172825145.1829,88366,14.3214,0.0043,0.0005
27189,113439,86250,31502,2145719733.1643,1542884616441508930.071,86251,6.7966,0.0028,0.0021
2156,93510,91354,17567,2141132614.153,1541993046454892592.1026,91355,8.113,0.0029,0.0008
20438,102864,82426,11741,2149511592.889,1537941671717657303.5388,82427,10.9733,0.0017,0.0028
23189,99051,75862,4144,2151082344.5178,1538118346465358573.272,75863,10.1283,0.0011,0.0024
24811,56600,31789,10170,2144355236.8666,1537079927942922345.749,31790,2.5677,0.0039,0.0014
23338,79755,56417,26656,2147196148.8625,1538990189477312978.9119,56418,5.9993,0.0026,0.0024
22724,52396,29672,2036,2155642327.7309,1532909930752965044.1508,29673,8.2286,0.0012,0.0052
21926,45079,23153,18474,2137877644.1731,1537464109189040715.8061,23154,5.2297,0.0047,0.0002
4387,76119,71732,27889,2143752393.7026,1527766370148706844.9486,71733,6.1594,0.0035,0.0017
4793,84868,80075,31612,2153805270.5452,1537588723266430705.5189,80076,3.7921,0.0002,0.0027
17562,89169,71607,7045,2157988123.0261,1537319621274828022.2859,71608,13.9293,0.0004,0.0054
27582,124942,97360,9897,2145042665.9601,1541265996589011722.4532,97361,8.613,0.0022,0.001
30038,66990,36952,14803,2141998496.7162,1545526888355635567.5246,36953,4.5551,0.0055,0.0013
741,81376,80635,24368,2147846944.1293,1529233622743288313.3235,80636,5.6055,0.0023,0.0024
30825,63777,32952,31437,2147080912.4116,1538497931900419359.8326,32953,21.2571,0.0035,0.0026
22769,112464,89695,27893,2155347888.4247,1537487099770490474.7727,89696,11.184,0.0003,0.0038
8767,98265,89498,3223,2144204654.2079,1548907736156717469.951,89499,10.3753,0.0033,0.0016
18287,85633,67346,6730,2141017545.4511,1539740603623000460.1152,67347,23.0078,0.0058,0.0013
19874,44690,24816,7172,2158305026.5766,1540962751285441504.7105,24817,11.4665,0.0017,0.0056
30688,41177,10489,20430,2120719124.9871,1529472479652650839.9843,10490,12.4769,0.0123,0.0004
6546,8032,1486,27553,2153041348.0605,1515351002368777237.7125,1487,7.914,0.0131,0.0124
23832,105617,81785,3024,2151611756.3534,1534985205089240517.739,81786,5.4124,0.0004,0.0027
12230,54361,42131,10179,2153231425.3861,1537204828674743814.0713,42132,3.6414,0.0004,0.0029
18434,52600,34166,18627,2155961893.2972,1544036868739994049.6871,34167,7.0228,0.0009,0.0047
18294,71493,53199,23904,2149983142.6495,1535034491690093286.098,53200,5.5602,0.0013,0.0024
31717,73005,41288,6742,2137890248.8928,1527424643682582132.4527,41289,7.3906,0.005,0.0013
24659,118622,93963,6102,2154470963.2316,1537111977636062294.2697,93964,9.5012,0.0001,0.0033
590,28550,27960,9136,2139589562.777,1543678568221337794.3936,27961,3.9143,0.0047,0.0019
21216,56546,35330,12946,2127297633.5833,1534205617915825340.6761,35331,18.0895,0.0093,0.0015
20617,110724,90107,5246,2141684520.7942,1536784284080875964.541,90108,4.7578,0.0027,0.0002
14557,41179,26622,31731,2152015806.5704,1528472220458840331.5221,26623,15.6686,0.0021,0.0048
27083,46868,19785,21246,2127269319.4654,1528478362930127339.5125,19786,16.8574,0.0099,0.0021
16049,78120,62071,1148,2151859770.431,1538018265441682437.7752,62072,10.0145,0.0011,0.004
4018,77093,73075,3902,2150054853.3959,1538771768287086366.3908,73076,0.923,0.0004,0.0018
265,83487,83222,17477,2145654445.2657,1546211595201780930.1749,83223,6.4786,0.0026,0.0014
13483,57424,43941,5038,2158356738.8691,1542907992064702551.9002,43942,12.5426,0.0018,0.0049
9692,81189,71497,18751,2139187827.4047,1531004418108161405.944,71498,10.6991,0.0039,0.0004
1374,62648,61274,9412,2138634253.6686,1537989486828503218.6359,61275,9.1489,0.0046,0.0008
2377,99775,97398,16474,2151692178.1652,1538296740492173495.729,97399,1.9368,0.0004,0.0022
12956,70166,57210,30797,2139091459.4695,1529414066457747262.9271,57211,6.3175,0.0041,0.0009
23092,40271,17179,16479,2158828577.7347,1524363240367957738.9209,17180,9.6124,0.0041,0.0094
17013,57497,40484,14046,2151000584.6048,1534246460536763694.5253,40485,4.5383,0.0016,0.0026
1041,16777,15736,5854,2166226315.4724,1537277900248664736.334,15737,13.0027,0.0017,0.0098
27362,94337,66975,27864,2150604587.1178,1539561051600371690.1918,66976,4.8577,0.0026,0.0034
6552,93622,87070,30959,2155745544.4339,1540752160389160234.7025,87071,15.4351,0.000,0.0037
24432,84053,59621,30103,2154743312.573,1550039678404496294.3591,59622,8.0175,0.0012,0.0042
15539,62204,46665,10806,2142593300.3818,1532405752824138381.2926,46666,23.3864,0.0042,0.002
32598,113114,80516,16721,2145961367.9094,1538052503214054173.0877,80517,4.4787,0.0019,0.0011
32239,33607,1368,11906,2160395392.6465,1580790698606520684.2607,1369,5.7279,0.0111,0.0167
3445,41162,37717,16816,2153911200.8737,1540324548683295685.5824,37718,13.682,0.0011,0.0054
26382,31817,5435,28621,2154288932.1107,1502674482633881089.8564,5436,13.8652,0.0104,0.0124
11522,29734,18212,7102,2158819969.3186,1552710942387930188.7233,18213,5.5208,0.0018,0.0075
8973,79188,70215,29883,2151770820.6849,1536507036310561694.4164,70216,6.0291,0.0007,0.0034
24167,85066,60899,6246,2138722526.7695,1538870533472550797.5795,60900,6.5268,0.0041,0.0003
4669,52420,47751,10595,2151470858.4184,1526952520430285827.1757,47752,8.746,0.0018,0.0037
18711,85434,66723,12252,2143984486.5558,1533850220154271061.6919,66724,2.8658,0.0022,0.0005
17499,91773,74274,21953,2153430086.3795,1533410958360876829.7833,74275,6.9185,0.0004,0.0035
19750,58554,38804,15949,2152184882.76,1533531848459275749.9115,38805,4.814,0.0018,0.003
30227,46327,16100,9643,2140509022.6755,1525424451935638405.1129,16101,10.9625,0.0062,0.0023
9910,33842,23932,10008,2134169170.1402,1547083260014891041.4886,23933,14.0575,0.0068,0.0001
26231,46096,19865,22675,2143974980.9324,1528750409613687153.3244,19866,5.7346,0.0036,0.0029
16893,107872,90979,3236,2141931047.9179,1535041884803734352.2542,90980,7.6231,0.0032,0.0008
3108,40094,36986,19380,2165323014.4891,1547352070311454536.2589,36987,13.9253,0.0007,0.0086
18040,107869,89829,11731,2156468732.1638,1532184351520152081.2986,89830,13.3395,0.0008,0.0048
12676,45810,33134,12188,2155486970.0761,1532146234058421573.0822,33135,2.3586,0.0016,0.0043
30974,45147,14173,8725,2150268057.6264,1543118485895606067.9484,14174,9.1912,0.0029,0.0051
23241,30938,7697,3175,2152573165.0703,1555966509072631761.4496,7698,3.5685,0.0049,0.0089
4224,75819,71595,26581,2136929737.1941,1535678090052109025.0459,71596,9.8572,0.0046,0.0002
30535,66280,35745,32451,2135096219.4729,1551625914700238820.8974,35746,15.102,0.008,0.0011
30982,81734,50752,16845,2155885887.6115,1541375093699639644.0468,50753,5.9484,0.0005,0.0051
12122,79911,67789,29752,2147974778.1305,1535910240237564322.2473,67790,8.3398,0.0017,0.0022
10571,78678,68107,11808,2152660477.5754,1541857175377770546.4267,68108,6.8684,0.0007,0.0028
29690,102754,73064,21101,2145149068.985,1537822771006279985.8559,73065,12.378,0.0035,0.0012
15927,74168,58241,11650,2140099140.1472,1543726267179269236.5498,58242,11.0975,0.0056,0.0009
22216,30748,8532,6374,2134531534.0223,1542233911147505328.131,8533,2.7911,0.0076,0.0008
20847,117349,96502,4123,2145890154.1463,1529515629744990678.07,96503,2.5124,0.0021,0.0015
1879,77148,75269,5250,2153906574.9103,1540999560384138818.2522,75270,23.0934,0.0017,0.0053
12608,110914,98306,12069,2154534353.2237,1529242819404602366.3904,98307,12.1539,0.0003,0.0044
29469,75947,46478,18764,2143935206.7245,1529272282467960643.8168,46479,8.498,0.0044,0.0019
17301,97529,80228,10106,2151351451.7203,1540495259748177860.1583,80229,6.1288,0.0005,0.003
22743,79135,56392,19302,2138676449.6239,1524961008238861270.467,56393,12.8432,0.0047,0.0007
16844,62018,45174,27290,2155237053.8669,1544908929494554577.1359,45175,5.7705,0.0007,0.0045
19696,101716,82020,28998,2149220910.8611,1543006509888112130.8883,82021,5.4533,0.0016,0.002
21642,29479,7837,20425,2118987939.5373,1568466011685099587.7281,7838,16.9698,0.017,0.006
22740,92190,69450,28216,2146024486.4108,1541055688457849559.4671,69451,6.1973,0.0026,0.0017
17985,97815,79830,8026,2138431418.2863,1541152314934737795.2074,79831,11.5647,0.0048,0.0005
5104,9721,4617,8917,2163731723.5165,1561231669257200796.8474,4618,11.6632,0.0058,0.012
3264,9889,6625,24137,2140952199.5127,1527016090554650479.1379,6626,13.747,0.0087,0.0059
16740,56277,39537,12000,2147775254.6093,1538702975349568706.3473,39538,6.6146,0.0026,0.0032
18801,46084,27283,19276,2162764371.4716,1547458467688763066.5474,27284,8.8849,0.0012,0.0083
8317,23734,15417,3122,2139349187.755,1539495592476073633.3462,15418,8.9851,0.0048,0.0019
32522,42693,10171,1610,2133329412.5303,1525474451708204608.9943,10172,8.9551,0.0115,0.0033
2116,73352,71236,20841,2132058381.4193,1531392891400431094.4672,71237,20.4305,0.0066,0.0003
29708,47991,18283,444,2168483358.9111,1544609601066630337.9145,18284,19.3889,0.0021,0.0121
9498,102051,92553,6618,2145630183.0686,1532907222069708941.6308,92554,8.9637,0.0027,0.0018
26832,122406,95574,2428,2150979850.594,1535476576706735257.9033,95575,4.2512,0.0007,0.0024
27911,34248,6337,4607,2131402060.3949,1549800772467064586.4456,6338,5.8966,0.0102,0.0026
11655,35935,24280,8823,2142986716.0092,1524025646977796671.9793,24281,6.4411,0.0067,0.0036
27198,55170,27972,17562,2156591665.5371,1542652495492012075.324,27973,7.6648,0.0024,0.007
11465,99354,87889,5196,2136183386.4178,1539278064283027898.663,87890,16.1789,0.0051,0.000
21987,66815,44828,21923,2139266415.6402,1537726972514300267.8304,44829,13.0876,0.0048,0.0009
24924,95108,70184,7278,2151674723.9747,1538192640848116367.2171,70185,3.2289,0.0006,0.0029
21355,65006,43651,17427,2154338489.1109,1531214894864632645.8116,43652,4.5553,0.0018,0.0042
32490,46578,14088,32647,2180219713.2247,1526600102180838103.6486,14089,21.4937,0.0002,0.016
9062,108042,98980,14665,2150189518.6692,1546793336331326533.6668,98981,7.3313,0.0019,0.0028
14681,28975,14294,15648,2122104263.3338,1538638115727465596.6256,14295,11.360,0.0096,0.0002
23711,96292,72581,1597,2141458764.3509,1542543388084981551.688,72582,9.697,0.0038,0.0012
26896,92057,65161,20649,2150572647.4225,1546011329781233080.7315,65162,14.4935,0.0027,0.0031
18319,70721,52402,11777,2137421502.0081,1533443806722237294.2071,52403,22.5105,0.0055,0.002
1527,9046,7519,20596,2158191065.3638,1535777344237972899.5676,7520,9.915,0.0029,0.0066
9263,74753,65490,10063,2147869044.6426,1533749882406839696.7196,65491,5.0813,0.0015,0.0023
22588,71775,49187,7665,2147111731.7487,1531412028949955401.0663,49188,8.4885,0.0021,0.0024
25142,78601,53459,5225,2149470119.5334,1531917458808907703.751,53460,6.5822,0.0012,0.0023
10171,43995,33824,12786,2137862394.5667,1555663374563328636.144,33825,12.7407,0.0064,0.0026
13301,71865,58564,24908,2154689122.309,1521163275547591419.0744,58565,18.2361,0.0012,0.0047
2899,80065,77166,5369,2153389878.0286,1538636059745040136.5837,77167,9.1459,0.0001,0.0038
4006,52883,48877,13789,2147797192.1893,1532472533118126311.3938,48878,7.7521,0.0024,0.0028
6097,58766,52669,28729,2149990507.5553,1539278528305114364.7484,52670,2.5058,0.0008,0.002
22004,66629,44625,25786,2147754574.7006,1534614753782465645.2928,44626,4.2327,0.0025,0.0023
5821,64631,58810,1501,2150687380.2028,1545405357036432114.6035,58811,5.985,0.0022,0.0037
4774,19818,15044,2762,2130190258.5111,1550164943537243133.8273,15045,9.0655,0.0098,0.0022
8543,70360,61817,300,2143729804.9761,1541004341927007193.2431,61818,6.7721,0.0028,0.0014
19881,37385,17504,23097,2165162149.5322,1532085697341899359.8562,17505,17.6071,0.0008,0.0084
7702,66838,59136,27357,2138382179.3102,1533041607513559597.4231,59137,9.4007,0.0042,0.0008
7347,81932,74585,31399,2146445637.9746,1536399326035124612.3768,74586,7.4902,0.0018,0.0014
2954,17485,14531,20026,2149832534.1435,1539609695651735783.7533,14532,6.0453,0.0031,0.0058
30726,37976,7250,5149,2121955123.9663,1549137318980129566.8545,7251,12.1036,0.013,0.003
19756,59638,39882,9726,2159213693.9233,1520812395829003756.219,39883,13.5735,0.0015,0.0064
31454,77009,45555,21365,2144978759.759,1522055310581184666.8534,45556,19.666,0.0036,0.0035
270,23279,23009,32123,2154256666.6393,1547126954467228631.9757,23010,13.8884,0.0017,0.0062
24682,103718,79036,6638,2140411714.8753,1527111415767858035.9317,79037,5.0809,0.004,0.0009
30432,64677,34245,16749,2142913284.0285,1552276517073074104.8016,34246,11.4685,0.0063,0.0029
12557,74333,61776,5336,2155399054.7885,1530255602252815404.5753,61777,9.6051,0.0003,0.004
18258,118042,99784,31405,2147047533.8542,1539746969049568627.8137,99785,6.5874,0.0016,0.0014
19886,67910,48024,30553,2136006813.7727,1527685973524243931.4083,48025,7.1266,0.0052,0.0006
12739,96930,84191,15272,2145238284.3978,1542772860285847252.2513,84192,13.5311,0.0026,0.0016
25104,74497,49393,20859,2143650246.0941,1540040952087880470.3178,49394,6.8806,0.0027,0.001
1140,9930,8790,13198,2189099706.5934,1555305939228026548.1109,8791,18.4087,0.0009,0.0173
24069,72893,48824,26899,2152268080.3471,1544457516557313589.9216,48825,6.2121,0.0013,0.0033
31465,86894,55429,8998,2132418501.3434,1537141188190962542.2891,55430,13.2253,0.006,0.0004
23865,27370,3505,5828,2131425282.6979,1503772304582165132.2764,3506,6.6399,0.012,0.0054
29090,54596,25506,5814,2154969747.2514,1526186539781518190.2205,25507,16.9809,0.0024,0.0066
16140,89240,73100,2265,2145737659.7181,1544412924115761796.2726,73101,21.8197,0.0044,0.0023
32073,51696,19623,29172,2137520669.3712,1535770876861329162.2962,19624,4.0462,0.0054,0.0004
31261,40770,9509,19773,2176565135.691,1549341320726360842.8529,9510,11.2598,0.0004,0.0141
3925,16455,12530,29541,2140983323.8287,1540946830316803199.0406,12531,10.9188,0.0083,0.0026
16762,93292,76530,3494,2150979281.0844,1535754443790599059.5357,76531,2.7658,0.0003,0.002
10830,11516,686,13806,2196212308.7846,1616354618746650976.6173,687,10.6363,0.0136,0.0379
17277,78441,61164,31375,2153738674.7797,1540529377634924119.8729,61165,6.3426,0.0006,0.0038
6573,98667,92094,236,2142319890.5191,1528761557795411141.685,92095,8.3829,0.0036,0.0007
25506,38316,12810,30457,2148447655.5373,1555173473360139211.9443,12811,7.1406,0.0039,0.0048
8607,89333,80726,5391,2141278051.9716,1535090396490693687.7685,80727,9.4329,0.0036,0.0002
13943,89870,75927,4405,2144810150.9909,1543757609342537402.1562,75928,13.6419,0.0027,0.0009
22409,83273,60864,8096,2143505715.7533,1531343475495980047.0808,60865,7.1757,0.0028,0.001
26860,39662,12802,973,2139141956.4037,1516780090082426289.1104,12803,6.8294,0.0079,0.0028
15031,44570,29539,25260,2130462460.3068,1525264721101763047.4789,29540,10.6121,0.0074,0.0003
11089,92928,81839,5526,2143943598.1788,1529101198038732560.7718,81840,4.3608,0.0038,0.0009
29593,119838,90245,4698,2140386261.171,1542394745746262837.713,90246,10.0496,0.0038,0.0007
31778,97326,65548,17847,2144185789.4769,1537933528478666280.1229,65549,3.4623,0.0024,0.0008
10105,39568,29463,13058,2155615747.5234,1522690578504876388.8245,29464,10.0537,0.0021,0.0061
2113,48062,45949,2590,2137023515.0453,1531304944071206757.8635,45950,13.4361,0.0053,0.0002
29838,78275,48437,21180,2146221731.8724,1550184769526158180.2322,48438,15.9089,0.0043,0.0032
29205,40083,10878,672,2154196498.07,1526720463311536464.3109,10879,3.8816,0.0016,0.0062
9742,62612,52870,2136,2148261445.4723,1537446317618297350.3366,52871,4.3788,0.0019,0.0021
6025,60469,54444,19428,2139316719.2207,1540961501301151326.3958,54445,15.652,0.0051,0.0008
15914,76175,60261,24558,2159041230.2029,1536251704396421449.5837,60262,12.3256,0.0003,0.0043
21508,105314,83806,3964,2140425327.1584,1541540791060986542.0242,83807,10.4699,0.0039,0.0003
19949,103735,83786,18165,2149290314.539,1540837508305689689.41,83787,5.4832,0.0012,0.0018
21110,43844,22734,28892,2140573237.1254,1531731732445387049.1882,22735,11.4108,0.0053,0.0022
9541,74583,65042,29359,2157832056.734,1531880908570585226.9839,65043,21.6838,0.0007,0.0067
4057,17616,13559,9488,2152289032.0369,1563392118940392407.5677,13560,9.8769,0.0045,0.007
3765,98448,94683,18742,2148947500.2526,1538564040811269384.2863,94684,2.1175,0.0007,0.0014
5594,15820,10226,27935,2146592783.674,1563408893230220845.6192,10227,11.8597,0.0064,0.0061
25033,78822,53789,2430,2151606717.7185,1538862168354351961.2417,53790,2.4204,0.0008,0.0025
24221,71650,47429,18111,2147155971.9718,1555225917746826539.6461,47430,12.7223,0.0034,0.0034
21795,97942,76147,10304,2133465132.2156,1540673932078283729.7125,76148,22.4371,0.0059,0.0002
21077,59700,38623,7317,2132287602.8803,1534601261193793204.2636,38624,8.9947,0.0074,0.0002
16505,68845,52340,7684,2148272493.837,1534544521004726725.1793,52341,8.232,0.0021,0.0025
22740,113986,91246,26969,2137703526.9787,1534446730766368901.7498,91247,8.4604,0.0039,0.0002
4708,55666,50958,8109,2145218551.9196,1538624222976689298.4172,50959,9.5083,0.0035,0.0013
21544,105724,84180,16075,2151273777.4276,1542342173454535084.6103,84181,6.377,0.001,0.0025
24216,87844,63628,1728,2146456228.7134,1546582430756048753.1995,63629,11.0497,0.0025,0.0024
18005,37103,19098,10040,2155630194.0811,1544753570808343350.0592,19099,7.5997,0.0018,0.0059
1035,24835,23800,12604,2146654492.8954,1549752878525009909.9673,23801,5.1636,0.0043,0.0033
12151,21134,8983,25321,2142194304.6113,1492213727615166486.3489,8984,12.7424,0.0101,0.0095
30718,85752,55034,5640,2136047339.3233,1521884911011682238.2161,55035,21.5171,0.0061,0.0017
6289,94574,88285,5861,2138228420.5816,1536654526588861211.984,88286,10.4213,0.0045,0.000
15917,53888,37971,7539,2152432266.5646,1539976824826437986.0433,37972,2.8952,0.0006,0.003
12116,59883,47767,26301,2148177052.3491,1541958186364235959.0457,47768,1.8949,0.0019,0.0022
13655,74462,60807,1921,2148750349.3782,1550065365745863636.864,60808,11.3599,0.0025,0.0031
32767,69719,36952,30256,2160264434.1406,1527429093498642506.2003,36953,13.6848,0.0004,0.0064
31290,123202,91912,7468,2148016634.4452,1536126054263364237.7789,91913,4.9993,0.0017,0.0013
4258,12615,8357,11898,2162375605.0353,1537393910253660645.2339,8358,10.2753,0.0018,0.0099
28260,60308,32048,2917,2134248833.2338,1519782378630142709.5875,32049,12.171,0.0083,0.0013
20523,109988,89465,29000,2147253477.9464,1540375792649641951.9756,89466,5.8402,0.0018,0.0016
1167,11965,10798,4197,2108683468.3099,1532327807235755062.8926,10799,13.172,0.0143,0.0001
3445,50047,46602,9036,2146047973.9809,1529178805480083612.2852,46603,5.2898,0.0028,0.002
2626,55129,52503,18467,2142594837.6554,1542830194819307684.9712,52504,13.3498,0.0045,0.001
11969,28325,16356,19383,2152176934.5808,1519102221346783953.0785,16357,8.1872,0.003,0.0068
8883,19173,10290,20491,2154207292.5934,1527164708258585723.1477,10291,16.0585,0.0075,0.0088
21656,23155,1499,556,2116304086.7,1579800228445133824.618,1500,15.8248,0.0209,0.0044
16211,108190,91979,8316,2149937879.495,1535951958582186127.0428,91980,3.9616,0.0008,0.0023
32692,97973,65281,23470,2137881645.4048,1539857045573876727.9128,65282,11.7258,0.005,0.001
21324,54433,33109,22853,2140185898.3916,1542442862139619207.733,33110,18.1929,0.0048,0.001
936,60069,59133,15911,2147084624.6302,1542597623498148323.5882,59134,9.5509,0.0017,0.0023
12032,59933,47901,27749,2147756354.7425,1538805111348517144.102,47902,5.2442,0.0017,0.0019
12314,40580,28266,6503,2148494893.2731,1530974012910587377.8269,28267,2.9462,0.0028,0.0029
26319,53536,27217,23908,2154594780.3513,1540327123369396827.5489,27218,2.790,0.001,0.0048
89,73540,73451,7912,2140456188.0865,1537062780530973452.4338,73452,11.4013,0.0044,0.0002
19748,70217,50469,15355,2148584357.8864,1530389158117624140.6362,50470,15.1317,0.0019,0.003
9933,60957,51024,11584,2140691622.0648,1534628061061746259.9429,51025,11.3839,0.0045,0.0012
31635,67391,35756,4859,2144222163.2834,1532930183493323751.7252,35757,12.0453,0.0047,0.0026
20281,99940,79659,23098,2133060642.3711,1536818294772429227.9896,79660,27.0692,0.0071,0.0007
22393,65056,42663,3559,2145342341.8866,1532150690448502453.754,42664,10.9241,0.0041,0.0029
27221,83740,56519,6215,2148344517.6526,1541132753943441438.1486,56520,2.2512,0.0017,0.0024
6361,72485,66124,29724,2150172198.7327,1535782099976977391.5334,66125,2.5464,0.0003,0.0014
30657,53182,22525,19704,2171174568.2048,1538997879111826585.1282,22526,11.4077,0.001,0.0107
25454,48723,23269,3737,2160038852.3397,1546213382854327512.217,23270,14.912,0.0009,0.0072
8517,92395,83878,30747,2153671156.2394,1540414110310941012.5255,83879,4.9085,0.0003,0.0029
22579,84762,62183,15671,2144041357.8394,1542799642369501613.2482,62184,10.9837,0.0032,0.0019
11681,28609,16928,19918,2133740360.655,1555892425603015516.7044,16929,13.029,0.0101,0.0028
12856,53146,40290,16694,2143836926.409,1544842086761990337.9861,40291,7.575,0.0029,0.0027
23992,96196,72204,9413,2152880243.8588,1535736945643448840.1744,72205,6.8952,0.0005,0.0032
21585,62936,41351,13763,2144035513.3719,1534111117714632313.0171,41352,6.0606,0.0028,0.0011
23685,58606,34921,30063,2159270117.2321,1541991266243728999.0172,34922,7.164,0.0014,0.0052
29663,129260,99597,3540,2141761984.5251,1532497385176783230.6164,99598,22.7691,0.0031,0.0007
2191,67023,64832,1253,2141283203.9521,1538690595445416852.3968,64833,6.2939,0.0033,0.0002
31915,56121,24206,26449,2144333899.7488,1529378350390348183.96,24207,14.0204,0.0035,0.0032
12243,88671,76428,3204,2157963843.7352,1536264694565342379.8852,76429,12.3375,0.000,0.0043
27605,46059,18454,10706,2138587967.9,1529008740879973465.7898,18455,16.1746,0.0078,0.0035
29988,125292,95304,13230,2146307788.2747,1536151537381831049.8478,95305,21.0045,0.0022,0.0033
7234,54094,46860,29771,2144067078.0955,1538935128585152896.7545,46861,13.2418,0.003,0.0009
1974,20437,18463,28187,2143039917.8536,1522577081271042697.8304,18464,8.8741,0.0052,0.0035
27800,105021,77221,8715,2133787357.3923,1536108295815008244.1396,77222,11.4094,0.0054,0.000
9101,34820,25719,11331,2146163618.1613,1550754706873298796.4877,25720,9.6689,0.0046,0.004
422,78617,78195,25724,2160625482.4843,1536186847808316592.3414,78196,13.8946,0.0001,0.0059
11076,25365,14289,14391,2151011818.4612,1543382474683750921.0607,14290,2.350,0.0018,0.0039
26007,61878,35871,22449,2145549469.3591,1541709666223194087.3738,35872,12.2697,0.0025,0.0026
31034,46319,15285,9810,2149215287.8752,1523481130119396482.6231,15286,9.581,0.0048,0.0053
11364,81240,69876,10501,2146011201.767,1537254984989998798.8553,69877,4.6819,0.0017,0.001
20709,106308,85599,15105,2148247108.928,1537354422547397209.5991,85600,11.8605,0.0015,0.0032
29408,64585,35177,9914,2146896413.3252,1544972654951173074.2424,35178,5.8644,0.0032,0.0033
10513,99251,88738,20398,2144341582.1084,1537957022957682463.1584,88739,3.685,0.0019,0.0006
21002,30207,9205,11325,2139715847.0807,1535253214865509503.4989,9206,11.9283,0.0114,0.0041
3969,92319,88350,4940,2149882375.4427,1541720849674996652.4759,88351,5.6714,0.0011,0.0022
7823,8061,238,23568,2193504461.6067,1535651018792602911.7951,239,2.9748,0.0218,0.0359
22697,117806,95109,29270,2140985849.2352,1534309987609313648.887,95110,12.4587,0.0044,0.0008
17234,78781,61547,30569,2149593673.6318,1530715409310454580.8418,61548,8.8449,0.0019,0.0027
15611,27855,12244,16769,2165675844.5717,1554100550366628175.3398,12245,10.1163,0.0016,0.0122
7091,68376,61285,11288,2137941115.8385,1539437841747102880.4111,61286,6.9442,0.0044,0.0001
5691,45383,39692,10570,2127819540.6411,1546331293806487054.7562,39693,25.8998,0.0075,0.0001
29105,115011,85906,24820,2143048163.6753,1532399878713335022.6502,85907,8.8115,0.0033,0.0006
32679,124101,91422,31398,2147466606.437,1536247367016901815.8383,91423,3.9402,0.0009,0.001
20944,44515,23571,24448,2133194434.2497,1534546710544715378.3905,23572,14.0169,0.007,0.0024
5931,58676,52745,14526,2161422117.0737,1518848341384797100.9203,52746,23.6367,0.0016,0.0068
29191,81586,52395,25353,2154820984.2011,1537947983689479921.8954,52396,3.1389,0.000,0.0031
455,75821,75366,2383,2143698272.8099,1536641627724872986.8376,75367,3.3326,0.0031,0.0007
18116,65809,47693,9902,2145809547.9156,1540882643914382880.4834,47694,2.8869,0.0028,0.0019
14615,87840,73225,27332,2148559221.4443,1538380290420744335.7402,73226,2.8597,0.0012,0.0019
18044,41153,23109,9610,2141837485.8692,1527339809477144698.1594,23110,3.7219,0.0049,0.0019
21512,42051,20539,6200,2157726337.1522,1550919604968387417.2153,20540,7.5895,0.0024,0.0064
18806,93928,75122,11483,2140279915.8489,1539589335527569323.6272,75123,9.1994,0.0031,0.000
9174,94576,85402,4865,2155995569.992,1539516712769155369.8204,85403,16.3259,0.0008,0.0038
24887,45707,20820,6178,2135968483.2248,1550107024379394567.3212,20821,11.8977,0.0058,0.0009
32344,122911,90567,7653,2152278224.299,1539271065398640842.226,90568,10.4884,0.0004,0.0029
21880,50720,28840,4324,2128791493.6181,1538430063517898302.8009,28841,10.7395,0.0069,0.0004
8444,23587,15143,24270,2126648434.7118,1527264936637769716.0894,15144,7.1015,0.0092,0.0005
32680,61474,28794,5459,2150911405.0536,1534809414768387409.3067,28795,3.2411,0.0011,0.0032
16071,61776,45705,16903,2152734336.4298,1534935867893602385.0525,45706,16.3631,0.0013,0.0041
1114,18911,17797,1141,2172730487.7056,1531751454449660191.7762,17798,13.5668,0.000,0.0094
25361,112612,87251,18738,2148145356.6359,1545604624080659790.9381,87252,9.2525,0.0024,0.0025
5941,36313,30372,24117,2144225058.3124,1527620001250171665.7601,30373,7.7454,0.0039,0.0017
13916,52013,38097,31540,2141934233.6973,1534615439387924172.0076,38098,6.6566,0.005,0.0013
16516,19332,2816,14460,2115831745.711,1552380762625585223.5061,2817,7.4377,0.016,0.0007
6749,62395,55646,32002,2140413093.2797,1536497423557431896.1331,55647,18.2501,0.0043,0.0005
18764,78772,60008,29403,2133585687.1309,1544921396311319269.8516,60009,13.4497,0.0061,0.0006
18895,25687,6792,23240,2170017593.7252,1513274157174759602.3983,6793,8.7914,0.0039,0.0131
9462,102045,92583,26213,2146298585.8736,1534834929352476851.4138,92584,4.4465,0.0018,0.0011
16935,105169,88234,20858,2159540612.2811,1537409957848866488.5701,88235,19.2744,0.0001,0.0055
16742,29484,12742,21556,2156175914.8917,1567193536556600187.319,12743,12.7681,0.0048,0.0088
25595,90925,65330,5144,2144702162.7533,1535438557344163110.5842,65331,4.741,0.0029,0.0012
3921,84065,80144,26331,2156118707.708,1538463030158126551.6197,80145,9.811,0.0003,0.0038
23030,110608,87578,338,2163965461.3874,1537035098576107900.7375,87579,28.1356,0.000,0.0061
27009,51124,24115,20940,2135146884.4657,1556729252558245207.1045,24116,12.9368,0.0071,0.0024
459,98759,98300,29341,2139270957.4428,1542322969345570790.9399,98301,11.1715,0.004,0.0001
21345,57671,36326,24146,2154360993.8629,1548401232944404757.2539,36327,9.4959,0.0018,0.0054
12863,41652,28789,2018,2150479834.0102,1547434316276589213.9432,28790,5.9378,0.0031,0.0046
12893,28053,15160,19924,2158759566.3394,1523571686469051091.8955,15161,6.1989,0.0027,0.0066
26809,31109,4300,29090,2155498789.6654,1549466995654000011.1373,4301,7.9093,0.0055,0.0096
2354,59504,57150,30024,2139159251.8723,1536616693912189359.3231,57151,14.9242,0.004,0.0002
6478,103252,96774,10809,2147427065.1821,1523031552592716464.3579,96775,16.1589,0.0031,0.0026
10730,26724,15994,31970,2134076979.0413,1537626552670220787.373,15995,7.0508,0.0088,0.0017
30294,128498,98204,18216,2144455457.933,1536547168816024743.4915,98205,5.4158,0.0026,0.0003
16834,85507,68673,18668,2139211889.1449,1533938709623120142.0712,68674,5.1298,0.0037,0.0004
9178,63561,54383,28975,2151823530.5709,1520098132151101302.5748,54384,13.5929,0.0021,0.0046
28437,39499,11062,3765,2155334907.8571,1551289885031021794.9382,11063,9.8326,0.0038,0.0061
23153,26612,3459,501,2152359297.9879,1553325183922435740.6316,3460,4.1611,0.0051,0.0088
17396,44374,26978,30217,2152711622.1289,1543091725888704384.0911,26979,3.7525,0.0013,0.0034
8813,40743,31930,16189,2145569134.1411,1534450935457065244.7708,31931,1.2911,0.0018,0.0014
28221,87964,59743,5730,2155914781.3843,1535479506860122105.144,59744,9.7548,0.0002,0.0037
8209,61410,53201,5411,2135448047.4904,1535186135049242356.5069,53202,11.5359,0.006,0.0003
19973,36796,16823,772,2150056982.4377,1541189870690029483.1082,16824,2.8584,0.002,0.004
10858,82143,71285,14352,2145926178.8708,1544171778824244544.6349,71286,11.9621,0.0025,0.0013
17155,67949,50794,18878,2151764888.4604,1543875380926063718.001,50795,6.9649,0.0015,0.0037
994,14526,13532,2928,2160121583.7947,1544695130876690636.2956,13533,7.6199,0.0015,0.0069
12780,68717,55937,20514,2137327340.879,1546015300076508564.2136,55938,9.7187,0.0047,0.0008
2095,8177,6082,3291,2103279995.6704,1553140725375764361.1159,6083,13.8165,0.0196,0.0026
15453,99942,84489,10833,2148979821.5215,1537421831985636049.6584,84490,3.7314,0.0013,0.0015
32561,83065,50504,4148,2117848336.8333,1542704733646630477.6246,50505,38.9928,0.0113,0.0002
27681,67369,39688,10006,2147144633.811,1528099679048214842.1375,39689,7.4611,0.0025,0.0028
19957,113354,93397,25353,2156351005.4982,1534424665604830212.5745,93398,8.5521,0.0001,0.0036
14028,78464,64436,18960,2143517644.2639,1540175104019221424.6917,64437,10.0915,0.0033,0.001
6846,7468,622,29549,2186133700.0995,1609918623892205621.3384,623,9.6125,0.0149,0.024
20293,52326,32033,986,2146657598.7414,1539789586422878174.5343,32034,14.4173,0.005,0.0028
11139,16586,5447,17352,2180345821.3414,1533036402851766455.4319,5448,7.9771,0.003,0.0164
24231,86588,62357,28706,2148642781.7064,1531824100883959862.8784,62358,17.6425,0.0014,0.0024
1241,55883,54642,30884,2146731103.9731,1533382730849133655.9936,54643,4.9506,0.0022,0.0017
9501,93954,84453,27618,2145269214.5483,1526779433397841565.1311,84454,18.6268,0.0037,0.0025
5343,71742,66399,1362,2157497277.9164,1533084686796895309.1629,66400,11.3523,0.000,0.0049
29395,93483,64088,21376,2142216678.6683,1536120176602880983.3541,64089,8.4232,0.003,0.0006
18273,112409,94136,22627,2158509423.2815,1539081351633215323.7545,94137,16.240,0.0001,0.0056
9353,18779,9426,16374,2146216944.3191,1539451617061661723.6184,9427,1.0978,0.0064,0.005
32675,52845,20170,19256,2144196505.6093,1529074011019128727.4616,20171,5.4952,0.0038,0.0033
884,38328,37444,22756,2162644249.7667,1542097020681337236.5285,37445,7.834,0.0001,0.0054
6026,70521,64495,1376,2144260830.8818,1540843062138194331.1975,64496,4.5694,0.0028,0.0008
4061,87803,83742,12545,2143145112.7938,1541083822398557756.4238,83743,14.0438,0.0029,0.0006
31,71768,71737,9996,2141025585.3781,1534057200513743251.2801,71738,4.4817,0.0031,0.0001
15955,109112,93157,31930,2159247776.2433,1529059239528061188.8135,93158,14.2382,0.0006,0.0055
29546,122967,93421,29802,2151373244.3394,1538610833914318992.4184,93422,5.3782,0.0007,0.0026
31769,86658,54889,8034,2143919341.0101,1537333057120634145.2441,54890,6.125,0.0033,0.0015
7708,64986,57278,2658,2146722681.3872,1539162930040972657.57,57279,2.2696,0.0015,0.0013
28266,94203,65937,6572,2146850689.3311,1538532611824770545.206,65938,4.7676,0.0019,0.0016
12053,12176,123,13244,2315843393.7581,1409691174937809512.4415,124,17.2635,0.0244,0.1058
15921,22740,6819,15211,2144696244.4056,1559405567982313299.9871,6820,9.5406,0.008,0.0057
4809,46662,41853,29423,2139034031.068,1527912139645927965.3675,41854,7.8045,0.0048,0.001
22392,53192,30800,26025,2149537170.7812,1527982761030259732.4028,30801,10.9132,0.0031,0.0039
2926,100263,97337,9158,2138567958.6149,1540558578404065208.9845,97338,8.6731,0.0043,0.0005
22183,109247,87064,5896,2152116398.5929,1541319860464265480.2967,87065,4.9443,0.0002,0.0031
18482,38574,20092,28381,2125754161.6111,1521239950762732248.9316,20093,16.2254,0.0115,0.0008
15073,66982,51909,14966,2153522761.2312,1543172253450334761.3085,51910,11.5288,0.0008,0.0041
19038,97870,78832,1421,2155223645.7599,1538609328236229096.6248,78833,11.5603,0.000,0.0033
8284,25822,17538,14131,2147717001.2818,1532484269472948964.0052,17539,4.618,0.0042,0.004
20623,106028,85405,3520,2144830427.3055,1535957669821751397.8781,85406,8.8753,0.0019,0.0008
28353,45356,17003,3599,2144055105.6858,1510006601810069380.246,17004,17.2256,0.0069,0.0062
16507,18879,2372,28311,2079214089.4758,1532314982256802117.1015,2373,18.8136,0.0368,0.0004
22049,22447,398,13956,2136462870.2657,1611766221889838354.2252,399,26.544,0.0436,0.0366
24567,78033,53466,10311,2160489409.7394,1538195037898564998.696,53467,14.1505,0.0004,0.0069
6609,76666,70057,14097,2155258123.4281,1530675395217255841.205,70058,9.0726,0.001,0.0043
28337,75389,47052,29509,2155903223.7237,1538230011351531241.2621,47053,6.0403,0.0003,0.0041
23041,32590,9549,17334,2156502533.7706,1519197875796690032.1977,9550,10.4552,0.0043,0.0097
8148,56340,48192,13774,2145438091.3797,1542505118976882170.8332,48193,6.5483,0.0023,0.0021
3584,103477,99893,27933,2152730884.7156,1536049299543470528.447,99894,8.5008,0.0009,0.0028
10260,33236,22976,23938,2138532221.0472,1541216871640692663.7799,22977,2.8362,0.0051,0.0009
12456,74739,62283,14742,2156361067.4294,1544737448791360934.7186,62284,8.8701,0.0007,0.0043
26458,28682,2224,28818,2180206593.3474,1593042067146301872.793,2225,7.4038,0.0063,0.0229
18328,102556,84228,31488,2142483036.3056,1532409999948556993.0144,84229,4.6939,0.0027,0.0012
7055,23169,16114,26219,2152681368.0208,1529432530885369257.0456,16115,10.6098,0.003,0.0048
15150,35773,20623,30651,2118835380.8825,1531311384038807580.8399,20624,22.8782,0.0137,0.000
20276,98341,78065,9968,2146975838.333,1541437540746246276.7533,78066,5.0921,0.0015,0.0012
32539,45631,13092,6503,2145219634.8722,1530403218119420232.1703,13093,5.821,0.0048,0.0032
24161,63732,39571,31807,2148122802.6202,1528814164929142761.8774,39572,10.2329,0.0023,0.0022
11126,106700,95574,5218,2157514241.1021,1540731336408490283.7966,95575,13.5865,0.0003,0.005
29463,56893,27430,4784,2152954508.731,1533881938635927446.5766,27431,8.1266,0.0008,0.0056
15392,90273,74881,12641,2130358709.1414,1546364544875572850.5367,74882,32.3617,0.007,0.0001
11975,25108,13133,21045,2151083161.5728,1560610843556213458.6711,13134,10.3352,0.0055,0.0069
27277,90422,63145,10995,2149077012.5301,1533884185790932558.5384,63146,3.9201,0.0017,0.0026
30833,76734,45901,7172,2148150314.8746,1536735721377482436.9313,45902,2.2722,0.0011,0.0019
148,2941,2793,9576,2257028200.4449,1504619080120222229.4903,2794,28.2742,0.0005,0.0398
4692,52760,48068,4409,2129762680.7244,1551392911329224404.2973,48069,46.1816,0.0098,0.0003
28714,60871,32157,6250,2148646152.0067,1527061725284634739.4455,32158,5.5515,0.003,0.0044
1632,80556,78924,19938,2144171155.4871,1531895639473919895.0783,78925,9.242,0.0034,0.0014
20003,94772,74769,8049,2149475595.8497,1545106916788426173.1671,74770,11.8437,0.0024,0.003
1338,80068,78730,29475,2152537696.438,1534803205724899984.1032,78731,13.4754,0.0012,0.0029
18477,67658,49181,17488,2155681547.1879,1536166574949295096.8331,49182,10.5944,0.0009,0.0036
5693,88593,82900,22668,2145600280.3263,1532003846949388436.3854,82901,5.5953,0.0027,0.0016
9592,23550,13958,5012,2154225869.238,1535429926156350395.95,13959,5.000,0.0019,0.0046
12426,110438,98012,1756,2145971547.667,1538835792119825148.4103,98013,3.2149,0.0019,0.0007
10808,44976,34168,5068,2159693746.4471,1524013606017341079.3592,34169,12.4812,0.0011,0.0061
28978,84681,55703,21961,2149708299.3687,1530192543371811969.3487,55704,7.2422,0.0023,0.003
15673,29248,13575,2577,2131007081.084,1550411772279548589.1659,13576,11.035,0.0077,0.0008
12739,76087,63348,20613,2145414199.4858,1533815844962047463.7155,63349,17.3064,0.0027,0.0015
29787,80029,50242,11855,2150131536.7688,1537684663781566266.8895,50243,7.3743,0.002,0.0024
31626,102298,70672,24501,2166228150.2555,1549139266457141444.068,70673,39.2306,0.0001,0.0098
11162,92780,81618,15662,2142237454.945,1538507179297130860.4783,81619,8.9097,0.0039,0.0007
20942,37149,16207,30899,2148191885.575,1529439692642160133.7014,16208,7.9178,0.0036,0.0038
25335,79330,53995,7377,2149023825.5796,1543863183864138623.5784,53996,3.579,0.0017,0.0029
7022,61311,54289,6547,2139030278.965,1543302425738160862.1816,54290,15.8328,0.0042,0.0006
13835,62571,48736,11606,2139778830.703,1526709441323805732.5379,48737,8.0391,0.0042,0.001
14929,42869,27940,29656,2151144127.8204,1529672893014637873.4827,27941,4.9559,0.0023,0.0034
8554,67782,59228,27883,2152136980.1904,1531529360535319094.8101,59229,6.2361,0.0009,0.003
1394,80762,79368,20626,2138829676.6269,1542589373723933175.3693,79369,8.1506,0.0038,0.0004
28394,57260,28866,31334,2177930246.6996,1535459681950898022.9206,28867,24.4746,0.0001,0.0122
24251,42459,18208,21,2143255104.2554,1530591486464167449.5742,18209,3.8583,0.0049,0.0023
9572,88478,78906,1127,2145883997.2878,1525450398873137400.7672,78907,10.5028,0.0038,0.0022
13405,67417,54012,25488,2124506667.5171,1545339829992926968.7522,54013,26.7514,0.0093,0.0001
12168,81053,68885,14760,2143004485.7459,1529693288393073236.5729,68886,10.289,0.0035,0.0013
9000,74214,65214,15914,2144214627.3591,1542736290899409720.8797,65215,3.4082,0.0029,0.0011
27084,60323,33239,9948,2142245366.3708,1529355230497269988.1883,33240,2.3114,0.0041,0.0019
27309,67838,40529,10243,2136280280.8947,1550236514083077542.9313,40530,18.7031,0.0053,0.002
10212,38532,28320,12852,2153946488.5696,1538446060539688479.8066,28321,7.1138,0.0018,0.006
8886,103451,94565,3559,2150092637.6215,1536465256256728740.8728,94566,11.7641,0.0014,0.0024
31640,65098,33458,27814,2131724970.1981,1534850877985717157.1385,33459,7.4166,0.0083,0.0009
25724,38110,12386,11998,2137169046.4953,1529008124348386237.504,12387,6.6198,0.0061,0.0003
19025,48430,29405,23135,2150818855.5071,1543752442083359873.9193,29406,5.8388,0.0019,0.0046
14733,79078,64345,10186,2146712166.3465,1545754201369817400.183,64346,6.1823,0.0025,0.0023
29347,88307,58960,18556,2141780395.8066,1531155265801626284.5366,58961,8.7713,0.0035,0.0012
6451,25774,19323,2004,2138360306.689,1538690138586690495.064,19324,3.9899,0.0061,0.0007
18065,24671,6606,11614,2152887149.0664,1564853349656177912.4749,6607,8.2058,0.006,0.0093
21077,64730,43653,9935,2150999838.4371,1546633289258435418.7821,43654,6.1427,0.0019,0.0039
32059,82801,50742,30881,2127885226.7585,1559076150825705322.7789,50743,53.0204,0.0095,0.0005
22191,38572,16381,8043,2132927151.082,1525832625664876027.6304,16382,15.6805,0.0109,0.0021
27562,63720,36158,12610,2141954579.9902,1522734902117061880.2696,36159,9.5165,0.0054,0.0028
4940,95196,90256,12770,2137424506.6872,1537960890316864854.5997,90257,17.1223,0.0054,0.0001
7036,67095,60059,2455,2137580907.523,1543573469203084571.2118,60060,8.969,0.0047,0.0012
23362,122056,98694,4545,2151362918.5523,1541743548209528532.2136,98695,6.2616,0.0009,0.003
28657,64828,36171,462,2144006315.0415,1537476509746686421.8779,36172,4.1787,0.0026,0.001
16089,78917,62828,17149,2159649766.7514,1538930984067132208.701,62829,12.169,0.0004,0.0051
16552,69915,53363,10232,2157685353.4996,1534378734101269535.4427,53364,7.5083,0.000,0.0048
12576,104539,91963,1334,2161874684.3221,1536938373764068578.0155,91964,18.3731,0.000,0.0061
22546,30022,7476,10672,2150924304.6305,1543010173457558595.4268,7477,13.8353,0.006,0.0068
13258,99937,86679,25622,2149975670.1193,1538171257615986547.7705,86680,4.8407,0.0009,0.0019
8251,18559,10308,21375,2148633822.0178,1512415692676863846.6275,10309,16.5765,0.0068,0.009
29389,38454,9065,20079,2131264404.7186,1560248588372231413.7934,9066,13.5159,0.0094,0.0012
10030,59360,49330,31533,2136565117.4019,1531380756560477207.8841,49331,8.5892,0.0058,0.0001
4035,15629,11594,31403,2116763687.1551,1515153245174804531.3027,11595,14.8467,0.0149,0.0018
9347,96793,87446,17719,2145516036.3063,1536417550590789904.0163,87447,4.2103,0.0018,0.0005
19163,48020,28857,19472,2132855045.3414,1529091339035591981.4309,28858,19.8452,0.0073,0.0014
31491,61254,29763,21484,2161806804.3921,1524939465683471846.2328,29764,14.1406,0.000,0.008
24628,118126,93498,18174,2152315717.9368,1531406419013069773.9556,93499,6.1186,0.0009,0.0025
32387,121920,89533,1167,2149332281.4636,1537779718705949727.6423,89534,3.5958,0.0013,0.0019
3766,44415,40649,32444,2133869449.914,1544916204966410746.3405,40650,15.0333,0.0068,0.0003
3382,87727,84345,2925,2145213708.1449,1535321807751585803.2584,84346,1.6467,0.0015,0.0005
32173,84244,52071,9663,2147481518.408,1539135250478215370.1096,52072,1.1156,0.0019,0.0016
16696,69148,52452,3260,2137300820.7815,1543344585032815080.6199,52453,11.8638,0.0053,0.0004
23858,99560,75702,14488,2159858729.4189,1537783804580963453.1821,75703,11.4903,0.0004,0.0054
11468,107190,95722,11659,2154075689.307,1535795106407537702.2574,95723,8.8342,0.0002,0.0033
13142,40689,27547,28901,2177514321.9501,1540472506428710411.1381,27548,23.6611,0.0002,0.0104
27763,114838,87075,7364,2137844839.807,1537834819720244916.4569,87076,11.6396,0.0041,0.0002
16230,70264,54034,2881,2135512266.5045,1534017195008461619.2223,54035,19.3946,0.0062,0.0006
31584,112923,81339,177,2151317025.0914,1535829274774080417.4025,81340,4.674,0.0008,0.0023
1734,74103,72369,29847,2146553373.6391,1531044766612403367.3193,72370,16.9037,0.0024,0.0023
4218,53439,49221,24230,2141965728.5449,1542151884718538110.4763,49222,4.6764,0.0033,0.0016
10586,93678,83092,7715,2143434103.2485,1534282329360531821.0261,83093,10.9577,0.0032,0.001
21249,119664,98415,11957,2142270557.0939,1540719590535794665.0514,98416,11.1917,0.0028,0.0005
5691,39881,34190,19718,2137388400.3212,1533061247629172527.5427,34191,6.3081,0.0066,0.0008
3414,60585,57171,23282,2136137818.1844,1522787632753523180.3771,57172,13.3464,0.0066,0.0007
31614,69254,37640,27233,2141228084.7049,1533981456090787204.7592,37641,8.9957,0.0043,0.001
11510,106431,94921,30201,2154351901.8664,1532347703070559731.8729,94922,8.5341,0.0009,0.0038
21076,51409,30333,9984,2153602656.0681,1537420235375350951.5172,30334,6.6329,0.0012,0.0052
8383,49498,41115,1960,2129592767.2017,1548579004649055605.4973,41116,25.4687,0.0084,0.0004
20799,47000,26201,8799,2125370444.2123,1525213651306472757.9681,26202,20.9245,0.0108,0.0009
26515,79960,53445,12637,2143813215.5738,1540330253836182585.84,53446,6.422,0.0031,0.0011
29862,36924,7062,2456,2168073062.5951,1500245622130246938.2446,7063,20.3356,0.0033,0.0149
5254,44385,39131,16265,2158555238.4919,1530001898735388627.6797,39132,23.0479,0.0011,0.0075
1730,37377,35647,24540,2156355014.4587,1545390232835991044.1172,35648,9.102,0.0018,0.0061
4264,78133,73869,10657,2143716479.5699,1542551655078954769.2726,73870,8.0582,0.0028,0.0011
26562,91137,64575,20113,2152345158.2611,1538444517696040179.7876,64576,4.3566,0.0006,0.0038
11890,66389,54499,24907,2141416580.087,1537331261871001849.0392,54500,11.0561,0.0044,0.0015
19146,37637,18491,24989,2153198194.5305,1542383441756131511.0371,18492,3.7333,0.0025,0.0052
17650,86574,68924,3166,2147189535.7974,1541158346597639917.0248,68925,3.3993,0.0017,0.0014
12654,20790,8136,31584,2134730203.3496,1525004969349474059.169,8137,7.3027,0.0092,0.0026
4962,79928,74966,22269,2139210381.6025,1534210526053082292.5363,74967,5.4543,0.0039,0.0002
8578,37302,28724,32729,2142940442.9581,1544950561629038619.8992,28725,5.777,0.004,0.002
23228,35103,11875,10500,2123931970.2659,1528613442588551546.4636,11876,10.4704,0.0125,0.0012
4425,75382,70957,30899,2145914562.087,1539560050149266020.1204,70958,12.2826,0.0023,0.0015
23433,108574,85141,15657,2143818314.4431,1537776022276374148.7686,85142,4.4061,0.0023,0.0006
4392,8111,3719,30576,2186059187.6376,1551256753296867655.3493,3720,9.1049,0.0005,0.019
11627,15145,3518,3767,2203307406.6874,1568260554045488605.7699,3519,12.8218,0.0016,0.0233
15684,29443,13759,2836,2147933605.4721,1540327156358867625.1888,13760,5.1033,0.0037,0.0034
7874,71054,63180,9799,2133570191.894,1538150798633066792.7115,63181,12.2035,0.0054,0.0002
7345,78509,71164,19622,2137958029.3794,1540243094565216002.4997,71165,15.8742,0.0053,0.0003
25086,122826,97740,16394,2143100622.4087,1535736721174170709.1968,97741,9.0965,0.0025,0.0009
5298,84393,79095,22433,2132599499.7838,1542537870847319699.7323,79096,20.5408,0.0055,0.0003
23134,43001,19867,30449,2157390322.6411,1525679756321125111.7229,19868,12.6399,0.0007,0.0062
7595,8617,1022,30871,2126127400.3881,1409766319198126155.5082,1023,15.4245,0.0293,0.0212
15086,41666,26580,31800,2148251874.0343,1531986161083959690.3033,26581,2.852,0.0026,0.0027
8058,64092,56034,16637,2150770878.1733,1542484279465202112.7397,56035,20.4415,0.0018,0.0035
31476,72407,40931,17888,2145860487.1752,1546802344343120331.9121,40932,8.5187,0.0028,0.0024
20901,91452,70551,17752,2155889199.6703,1534865913433218934.5233,70552,14.9837,0.000,0.0035
14039,78233,64194,31470,2150241148.0049,1529684644582680996.4923,64195,11.9942,0.0021,0.0035
16753,74459,57706,4049,2146968588.0881,1529161175524520679.564,57707,5.067,0.0029,0.0028
2925,70839,67914,24808,2144923617.2386,1538913201109469416.2476,67915,8.8338,0.0022,0.0009
17354,28107,10753,17192,2145478041.0027,1536685372230528885.6356,10754,5.4949,0.0044,0.0044
21879,28982,7103,21398,2166483578.1126,1532534889663692337.0098,7104,6.4925,0.0032,0.0096
30615,78427,47812,7490,2149584384.0137,1545106228410195567.3373,47813,7.7715,0.0022,0.0026
11834,68931,57097,271,2145441408.5765,1545512742967399065.9253,57098,5.1568,0.0031,0.002
16450,44987,28537,21875,2135357585.8675,1547620835654050202.0583,28538,24.521,0.0062,0.001
19219,54142,34923,5589,2134056726.2511,1538800060221667551.8013,34924,10.1364,0.0064,0.000
5796,95593,89797,17881,2144467443.2706,1537878466112131980.2887,89798,6.663,0.0031,0.0006
519,57848,57329,21057,2152032894.3015,1521960510522684672.858,57330,23.814,0.0025,0.0052
26835,51725,24890,14130,2155108638.9305,1528850973425160273.154,24891,11.1963,0.0021,0.0055
996,11775,10779,4125,2147778474.8699,1552473782451710957.902,10780,14.6977,0.0066,0.0047
4035,48880,44845,7841,2146526216.3308,1537674703689704717.1294,44846,8.1584,0.0026,0.0021
7496,46903,39407,8539,2137342981.4367,1535111234748568459.6386,39408,6.7273,0.0054,0.0005
6791,95583,88792,28591,2144176498.1171,1540357766658820783.7837,88793,2.5341,0.0022,0.0006
5174,28614,23440,15180,2147164364.6926,1548996220503737556.0788,23441,8.9487,0.0047,0.0034
20880,110877,89997,30704,2154164368.052,1528801461309957038.2365,89998,21.3939,0.0013,0.004
19463,116643,97180,32545,2151882261.5542,1531636482922191167.6479,97181,7.2154,0.0008,0.0034
4058,16286,12228,32247,2150084018.4173,1532236508947394083.4032,12229,13.6243,0.0036,0.0089
5663,24205,18542,8358,2154381052.0609,1548325018619460610.2253,18543,8.2899,0.0034,0.0063
5223,104074,98851,7060,2144303306.4281,1539334095540856080.6817,98852,7.2774,0.002,0.0009
28148,60865,32717,31278,2138824239.2259,1541832826349158190.6211,32718,11.0952,0.0064,0.0015
7561,49790,42229,11588,2152527693.0764,1528259156068515624.3599,42230,9.233,0.0018,0.0051
3827,85575,81748,14396,2143259399.8955,1534578541260290478.4844,81749,5.9221,0.0032,0.0007
6892,34687,27795,19039,2171846495.7271,1549319758606220593.8758,27796,17.2564,0.000,0.0126
17580,94560,76980,19018,2152332062.5195,1530192941782568119.7448,76981,8.7053,0.0011,0.0036
28777,108453,79676,20736,2138707630.6817,1540346870397791163.4871,79677,10.8332,0.0042,0.0004
9955,73743,63788,23022,2146017320.3574,1537629310401107386.3337,63789,6.130,0.0034,0.0013
14357,42244,27887,14694,2164013652.403,1535117733546657550.0197,27888,12.3331,0.0004,0.0075
322,36640,36318,19888,2164431077.7879,1539748825794549675.4055,36319,19.0798,0.0002,0.0075
9022,52254,43232,22766,2149272088.4565,1538060509342073381.6283,43233,4.5356,0.0018,0.0022
8916,44099,35183,20479,2147427353.3108,1548012734271750268.7872,35184,6.0832,0.0032,0.0031
3319,74539,71220,26335,2143604652.4597,1536948268094063666.6508,71221,9.1011,0.004,0.0009
22753,73277,50524,25348,2152578698.4879,1532604823218940505.1244,50525,2.845,0.001,0.0029
30558,41744,11186,1470,2130440446.8913,1546767355059639176.9563,11187,11.6915,0.0109,0.0028
20614,29681,9067,11297,2110848337.6782,1514339507204090923.1128,9068,16.4005,0.0139,0.0024
28170,61495,33325,1542,2153637523.6503,1536180305709480214.0387,33326,8.9134,0.0011,0.0035
18103,86284,68181,22588,2141977563.736,1535118379391988898.1786,68182,5.0822,0.0027,0.0006
8180,62196,54016,29333,2132197255.6651,1528651609579172289.0299,54017,12.9713,0.0061,0.0005
13597,109811,96214,9171,2150046076.8417,1533252497014382741.9754,96215,8.9888,0.0016,0.0033
6121,55935,49814,2489,2147297154.0799,1543260552204739025.9894,49815,24.1852,0.0042,0.0025
7397,52729,45332,8153,2135043357.5417,1530410622031254197.7463,45333,5.633,0.0055,0.000
6259,97204,90945,32296,2141852032.5181,1530439482400892749.5444,90946,11.6984,0.0045,0.0008
16154,81664,65510,5707,2147685111.7575,1546646360206709073.4763,65511,12.0742,0.0022,0.0028
14914,54491,39577,3025,2147092427.9167,1532158876445021210.1838,39578,12.3794,0.0047,0.0032
4518,82435,77917,26726,2141191231.0106,1541044305945842216.5637,77918,5.4054,0.0032,0.0003
23388,72188,48800,19780,2135781878.8926,1532036423095077171.7489,48801,6.098,0.0062,0.0002
32208,90795,58587,15726,2155588656.6683,1527214251910324049.0496,58588,10.5484,0.0015,0.0038
10519,33750,23231,21179,2147317871.7314,1533455919390106128.3893,23232,2.8859,0.0028,0.004
12123,47490,35367,18072,2144345765.5787,1543267173406969620.8826,35368,12.4434,0.0043,0.0025
30736,40920,10184,9739,2146473690.1945,1544175462195681089.0183,10185,2.6661,0.0039,0.0023
20438,53332,32894,5224,2152152706.9602,1539484109356387553.2207,32895,10.6369,0.0023,0.0059
30731,73166,42435,30422,2157689793.0969,1529136538613601022.267,42436,11.2347,0.0004,0.0059
2666,43446,40780,3164,2144910688.9415,1540075169885227586.8334,40781,2.5211,0.003,0.0014
9910,59665,49755,8803,2145190927.842,1543684399261249696.171,49756,20.324,0.0031,0.0015
23083,114676,91593,3361,2147410883.823,1536063997300300961.1275,91594,3.6684,0.0016,0.0022
10439,59885,49446,20496,2151036012.1175,1541224279078033546.7207,49447,6.991,0.0011,0.0036
6738,73057,66319,17327,2157324953.0194,1531618355003187279.0531,66320,11.0369,0.0002,0.004
18522,78594,60072,11278,2142137399.4159,1522331151038757651.4197,60073,12.146,0.0046,0.0024
8681,15946,7265,9689,2142793592.8025,1514491837690311082.2579,7266,12.1417,0.011,0.0091
6806,57340,50534,18354,2141626426.5182,1523720226942596570.0147,50535,12.0699,0.004,0.0019
8353,9975,1622,28858,2165232900.0382,1439331229369068541.2629,1623,24.7378,0.0238,0.0286
2218,14834,12616,2629,2150614544.67,1537472182200080474.9216,12617,2.9196,0.003,0.0055
24840,92855,68015,10492,2164733929.3207,1531741801992945302.4268,68016,22.4325,0.000,0.0077
27978,29069,1091,24493,2103204614.6722,1534455277474183337.8724,1092,4.407,0.0231,0.0039
7371,71478,64107,10050,2134148670.6436,1529185585033409332.7034,64108,13.284,0.0056,0.000
6603,54604,48001,7279,2157392215.397,1538980924823438630.6448,48002,5.720,0.0007,0.0052
28434,47052,18618,16415,2154633514.7652,1545530732041002707.4418,18619,15.7462,0.0038,0.0075
23620,72577,48957,18827,2141748495.9452,1538982605226052720.3947,48958,20.3315,0.0061,0.0011
25669,41213,15544,19560,2173632788.5032,1540259391585926881.5318,15545,25.5013,0.001,0.0112
2216,96257,94041,28154,2145700202.9833,1526319409616572297.6334,94042,13.1333,0.0027,0.0021
707,43725,43018,10206,2144932778.4828,1524165172038271718.4876,43019,19.2687,0.0055,0.0031
398,44148,43750,19651,2136133849.2695,1526656549712502121.6691,43751,5.6158,0.0057,0.0008
17251,44513,27262,22543,2160098056.7091,1557458283796298721.9998,27263,14.7023,0.0024,0.0072
26266,113350,87084,15489,2149186946.1577,1528516478982772278.899,87085,12.477,0.0019,0.003
22619,91414,68795,26471,2139999763.6307,1530944616566663275.0269,68796,6.3604,0.0037,0.0006
16219,96259,80040,11372,2142251284.5001,1538111461058073227.2793,80041,11.927,0.0033,0.0003
1642,72507,70865,27309,2143547566.9763,1541537482040145487.7934,70866,11.7451,0.0028,0.0006
13817,20449,6632,5216,2171108003.0434,1524446333633023456.9708,6633,21.1575,0.0002,0.0136
32662,105594,72932,3346,2152451692.2246,1534458619019164081.8852,72933,5.5495,0.0003,0.0033
22521,69677,47156,30896,2162835454.2409,1530992061782679082.883,47157,24.4891,0.0001,0.0065
12075,54433,42358,2818,2155533578.8695,1525282631570168606.1152,42359,20.7158,0.0016,0.0048
22357,46634,24277,19380,2175109916.0936,1539432173813212323.9989,24278,16.8915,0.0005,0.0115
13892,36238,22346,32681,2160003476.992,1538954151770250373.7513,22347,13.5072,0.000,0.0059
32178,127905,95727,20427,2146743503.1106,1536014003310235580.6626,95728,1.8654,0.0013,0.0009
16408,40280,23872,1289,2131467794.7643,1523082347341775574.2225,23873,8.6774,0.0067,0.001
28072,110850,82778,26799,2141182308.6327,1537578311601414107.8672,82779,5.3501,0.0041,0.0002
28447,84441,55994,753,2154980412.5568,1529096353952128305.7527,55995,7.9859,0.0013,0.0043
18112,33404,15292,15379,2141460917.2367,1548019997590026409.8655,15293,5.533,0.0055,0.0024
24345,111403,87058,12430,2144821900.1289,1531402679706567657.8569,87059,10.128,0.0029,0.0014
24081,65323,41242,2186,2122719650.1812,1535257178263208213.2779,41243,21.4068,0.0092,0.0001
26988,88083,61095,28101,2141107609.8514,1536252272981616640.7825,61096,4.9305,0.0031,0.0007
30302,88686,58384,19807,2136603180.8116,1544022693922667817.8626,58385,14.204,0.0055,0.0002
15905,114341,98436,5913,2141857983.6216,1545836138220603143.8872,98437,10.0818,0.0032,0.0008
5201,35725,30524,8031,2151898441.0823,1532642614043686253.9739,30525,1.696,0.0009,0.0026
18975,100870,81895,3496,2146959598.7695,1533807336948415729.216,81896,16.3243,0.0018,0.0016
23238,37023,13785,10776,2132832764.6414,1528521321433926896.8336,13786,8.4814,0.0087,0.0015
13998,36091,22093,421,2122562219.6624,1525064139153232327.1584,22094,19.3138,0.0089,0.000
9193,97735,88542,17817,2144341226.9868,1532290135656487831.0805,88543,10.5621,0.0028,0.001
28696,49902,21206,21785,2142619204.6191,1538105874756845541.4793,21207,5.8058,0.0036,0.0017
1368,80269,78901,1865,2145064432.4632,1538341485092202070.0316,78902,5.3994,0.0022,0.0009
27868,44156,16288,13305,2157765643.4532,1515951030354693573.3692,16289,11.9443,0.0039,0.0074
18135,86310,68175,8605,2150032889.171,1547160042943830862.0587,68176,10.0462,0.0015,0.0032
9848,65057,55209,27445,2137657910.7863,1541344098729008374.0334,55210,6.8625,0.0048,0.0005
3516,7078,3562,27432,2069148665.3469,1505801981185124804.3663,3563,18.9372,0.0321,0.0002
17660,51974,34314,22812,2148328510.2336,1526038886683908153.7885,34315,9.698,0.0032,0.0038
23837,75000,51163,29614,2144507442.4929,1533510441672131643.4051,51164,3.6294,0.0024,0.0009
18393,44738,26345,21461,2154211988.2354,1525265089342068833.6857,26346,10.2532,0.0029,0.0051
32467,46518,14051,340,2123007258.2447,1531230848577298066.5227,14052,12.2176,0.0108,0.0011
1568,87597,86029,17037,2153896211.3263,1530274556856822960.1928,86030,21.0357,0.0009,0.0046
28223,104243,76020,5713,2147074834.4488,1535368592486236444.6765,76021,3.0554,0.0014,0.0013
17919,45502,27583,8323,2141843922.3677,1527947246454407822.1652,27584,9.6143,0.0052,0.0032
14481,74364,59883,4232,2147672097.888,1533359050549905948.7033,59884,7.3189,0.0025,0.0018
31200,126365,95165,11953,2141441853.7698,1532894066616173561.5871,95166,4.3985,0.0034,0.0003
9828,13359,3531,15801,2119264257.1331,1536418992584323979.121,3532,8.0503,0.0171,0.0017
28049,62463,34414,32413,2151702188.473,1530142104874611172.6353,34415,3.7301,0.0017,0.0031
16274,85144,68870,23510,2146292596.1844,1548923337796515933.0879,68871,9.1253,0.0031,0.0024
5389,97920,92531,17218,2139076351.9319,1542078027705665890.03,92532,9.2713,0.004,0.0006
29300,57640,28340,26378,2149312542.1483,1537456320763734902.4868,28341,12.5443,0.0032,0.0031
3471,66875,63404,32410,2143912986.3594,1533566994806387372.2048,63405,5.2928,0.0025,0.0013
2175,89832,87657,6118,2152374559.1105,1538289351521345580.9061,87658,6.8717,0.0008,0.0026
9563,15516,5953,7007,2178831709.7963,1541563948409976253.6671,5954,13.0378,0.0017,0.0206
22332,57573,35241,449,2134777943.797,1535682108919004686.5058,35242,10.2511,0.0081,0.0009
23014,57163,34149,15141,2147982997.9758,1542572030586462094.5757,34150,7.010,0.0029,0.0034
21241,118485,97244,1965,2142924666.0954,1541438305057058262.0459,97245,7.7196,0.0038,0.0008
9410,16216,6806,28569,2144333337.185,1526812457281075100.4487,6807,4.6955,0.0062,0.004
25052,37800,12748,31474,2129387618.201,1513393488884156349.6503,12749,18.2026,0.0111,0.0024
19285,88412,69127,24633,2150636016.7582,1537157772350332753.9573,69128,14.9887,0.0019,0.0039
3220,29929,26709,7092,2152015331.2176,1530145889803288226.1093,26710,8.9838,0.0023,0.0037
2523,92352,89829,14842,2155948568.1424,1533115384694296354.1017,89830,13.7967,0.0002,0.0033
6642,42823,36181,8104,2146532389.6874,1523725163584135250.3328,36182,9.1913,0.0038,0.003
3507,93643,90136,15805,2145806548.1926,1547668513283418486.3738,90137,16.6246,0.0028,0.0026
3245,51810,48565,32189,2148440596.4607,1536679577682721933.4439,48566,5.6663,0.0018,0.0017
16161,116068,99907,24989,2136596911.6246,1534262437746679402.5835,99908,12.6365,0.004,0.000
10493,57302,46809,21829,2158367988.4478,1544930713448193378.1427,46810,24.1142,0.0009,0.0056
31958,73695,41737,25906,2143701391.3833,1539540608804258178.0717,41738,6.2917,0.0027,0.0007
26688,30454,3766,27605,2154029304.9965,1524854879893299148.5625,3767,3.8563,0.006,0.0084
17328,58725,41397,31384,2150180502.9319,1537613633120793029.8175,41398,3.8467,0.001,0.0026
20380,59327,38947,21295,2147927887.6448,1524129093444419796.305,38948,12.7092,0.0033,0.0043
29264,87476,58212,4866,2142122558.6825,1533996215574911162.1943,58213,5.2563,0.0034,0.0007
15011,79480,64469,25482,2136984936.9957,1538174256560341936.8493,64470,10.1165,0.0041,0.0007
11159,31137,19978,5863,2153859592.1805,1551387092576169760.6948,19979,8.095,0.002,0.0065
19740,87250,67510,9987,2150196507.4423,1544847551895465809.7712,67511,3.712,0.0012,0.0023
21244,31122,9878,30172,2196517442.651,1535507913234731202.785,9879,25.2918,0.0013,0.0219
23320,108525,85205,19440,2155649363.9111,1540679485890864475.4472,85206,7.2718,0.0004,0.0044
13759,41600,27841,22900,2150830355.4536,1561190603039444602.178,27842,7.9169,0.0035,0.0059
10639,20036,9397,2612,2153551682.7726,1542864841603628223.1161,9398,10.8396,0.0061,0.009
31895,116186,84291,23917,2150450924.3103,1537270663723010777.2575,84292,1.8948,0.0005,0.0017
21625,33278,11653,29717,2134888734.2582,1526705422364431891.4304,11654,11.5017,0.0105,0.0028
20949,115966,95017,18612,2158032993.919,1538300617710832185.2538,95018,14.6245,0.0002,0.0052
31852,37357,5505,17062,2169866636.8542,1531731139831446394.5768,5506,6.7995,0.0029,0.0111
20218,118722,98504,15070,2142644590.7674,1542316649309805352.7615,98505,6.7473,0.0032,0.0007
26672,52485,25813,21880,2147930414.6279,1532124875225531710.2501,25814,3.607,0.0036,0.0027
23941,97032,73091,4308,2140914235.8309,1534139778537567749.3357,73092,6.5951,0.0029,0.0007
1814,62964,61150,28744,2150526855.3254,1540572422529370788.4994,61151,2.3985,0.0008,0.0023
12957,105384,92427,15805,2140959359.2151,1549447416886194819.0372,92428,20.9895,0.0042,0.0014
3767,40885,37118,17373,2142395633.8321,1535806637956993186.0447,37119,3.5198,0.0033,0.0012
12925,60974,48049,21527,2150742655.1241,1539461263957744482.8373,48050,3.6676,0.0009,0.0027
31745,127167,95422,956,2145435810.381,1539789806759562684.9051,95423,8.0218,0.0026,0.001
21758,118841,97083,19707,2156348892.1623,1531937285783177579.0874,97084,14.9432,0.0005,0.004
16493,66153,49660,256,2145098544.9877,1529794443918071499.6672,49661,4.674,0.0033,0.0015
18744,39109,20365,14767,2139832529.6693,1516414213651442423.8971,20366,9.0408,0.0075,0.0028
26394,41281,14887,31770,2163898328.8713,1543762333602521281.3593,14888,4.2812,0.0009,0.0086
20776,63353,42577,18308,2163396734.4662,1535921853008702805.0553,42578,13.2992,0.0003,0.0073
18873,23304,4431,14279,2147902221.5794,1531521994455907869.4639,4432,14.9639,0.0136,0.0092
6815,59779,52964,4457,2149280580.8984,1535976063468278660.201,52965,12.1826,0.0016,0.0041
25195,74033,48838,6569,2162473999.3756,1533074537613787708.6301,48839,23.9457,0.000,0.0068
20540,110847,90307,14044,2145284231.7252,1542473096374609121.6261,90308,8.7274,0.002,0.0013
26710,76689,49979,12006,2144347633.0161,1548641640809110514.1249,49980,14.9335,0.0047,0.0028
15613,69253,53640,25233,2136694028.6048,1536185993056174416.9364,53641,18.3633,0.0049,0.000
15314,101704,86390,9875,2147776645.9474,1534552529286071860.2904,86391,2.3469,0.0019,0.0023
18544,117229,98685,1334,2157612635.9113,1537647221766041458.5651,98686,13.5341,0.000,0.0046
16034,37144,21110,14736,2154837735.4564,1532624493026384016.366,21111,6.6192,0.0012,0.0043
27193,33629,6436,6436,2155632396.6557,1542170115511028761.8423,6437,9.0365,0.003,0.0084
24867,57160,32293,1953,2139414209.6341,1537719637117089356.2284,32294,6.5141,0.0051,0.0008
12683,14093,1410,18309,2109342746.2374,1513777524130050094.8614,1411,6.2166,0.0215,0.006
9537,65865,56328,5734,2139724176.9447,1537893782404409836.9333,56329,5.8253,0.0041,0.0007
20378,62482,42104,14983,2137356470.2434,1539252852818191184.1491,42105,11.2878,0.0046,0.0013
8000,82344,74344,23602,2151238039.7042,1539590210599342844.5882,74345,6.828,0.0009,0.0031
4602,80759,76157,32002,2149435998.3385,1537963739091682129.4056,76158,12.0927,0.001,0.0028
26445,99334,72889,6258,2147833399.5407,1536743673584471016.9811,72890,2.3754,0.0015,0.0016
14575,52174,37599,11907,2136830583.8506,1532867359050289089.9977,37600,8.037,0.0052,0.0012
19726,63049,43323,6215,2147231502.0647,1534076671719342876.518,43324,2.0287,0.0024,0.0017
13402,82998,69596,9079,2148385241.8622,1537199139295222531.2129,69597,4.0223,0.0011,0.0018
2611,97356,94745,27548,2150356687.6342,1539275473802887526.205,94746,2.3175,0.0006,0.0022
29534,98010,68476,20923,2143972419.5515,1541842876852880450.4664,68477,11.5044,0.0029,0.0015
28503,42090,13587,5542,2149477452.0258,1532483969251209042.8708,13588,15.8733,0.007,0.0052
25293,28756,3463,15457,2126006419.1397,1584360874711430663.3812,3464,10.1859,0.0182,0.0056
13304,37393,24089,6040,2151039904.1907,1538816330963064876.3006,24090,1.3913,0.0011,0.0029
17889,28560,10671,22503,2156017997.467,1569504258846547024.7317,10672,17.0124,0.0078,0.0122
17084,91810,74726,6753,2148295039.7767,1536373936301687336.0168,74727,5.4732,0.0015,0.0019
2132,34902,32770,25353,2162732723.4804,1536104695275876608.4374,32771,10.2433,0.000,0.0077
13091,98422,85331,2329,2141918734.2554,1535607813973851522.7363,85332,4.5946,0.0027,0.0006
32201,128209,96008,14839,2149306837.0817,1535967824051974214.2141,96009,8.822,0.0007,0.0014
13782,69815,56033,5642,2152131436.5753,1535803762002563444.936,56034,7.1238,0.0007,0.0035
15923,74726,58803,20865,2150725550.2087,1522514863612690481.484,58804,12.6746,0.0024,0.0043
8838,95561,86723,14513,2140799646.4328,1535967421202034892.5545,86724,21.8782,0.0042,0.0004
3433,82090,78657,16859,2151806707.2399,1543868463421198817.3146,78658,7.4426,0.0011,0.0036
25348,114766,89418,18053,2154632624.6186,1537853715246273192.7278,89419,6.4788,0.0001,0.0031
28433,89137,60704,1532,2149111981.6187,1539040690478167333.0028,60705,3.0558,0.001,0.002
6173,20328,14155,17396,2142189071.8295,1550075131562677336.1041,14156,6.4131,0.0057,0.0034
30811,101512,70701,16903,2146673551.9193,1539003870849659963.7528,70702,14.114,0.0022,0.0014
6854,23205,16351,23560,2147690797.6605,1550051131070068328.5569,16352,9.5336,0.006,0.0046
15253,52584,37331,23040,2134008388.1847,1531082301998188041.0018,37332,23.267,0.0075,0.0006
32090,63699,31609,26989,2131783537.6053,1527363944134345615.4356,31610,11.3232,0.0068,0.0003
7738,8448,710,9044,2189677518.7637,1501906401119954838.9484,711,10.1312,0.008,0.0283
15672,89336,73664,30592,2151679379.2454,1529218951179972559.7803,73665,6.9811,0.0015,0.0027
19626,94479,74853,32624,2159264913.3135,1538711736662139947.9382,74854,23.6558,0.000,0.0053
24449,121443,96994,19221,2140940658.7043,1535357580905658715.978,96995,11.5017,0.0037,0.0004
32589,69961,37372,28503,2159872621.4893,1539408218433717898.1035,37373,8.1602,0.0006,0.005
30829,107338,76509,2545,2142596210.1857,1536068133498880797.4378,76510,2.3472,0.0028,0.0006
31971,44562,12591,16350,2148909702.5775,1535505011649375551.7878,12592,4.0638,0.003,0.0048
14076,67756,53680,30945,2142676089.7402,1529812558652564178.3583,53681,8.7204,0.0044,0.0015
16036,76015,59979,12954,2136801405.3083,1537314884363210251.1326,59980,17.1846,0.0054,0.0006
16008,75156,59148,30889,2143640119.1381,1536695840548976564.6002,59149,2.9469,0.0024,0.0005
25727,93790,68063,2057,2138332299.7238,1542906704328189648.2545,68064,16.6589,0.0048,0.0011
15527,110084,94557,19116,2145695423.262,1545083413730859028.9866,94558,6.6442,0.0021,0.0015
2748,53613,50865,4107,2159305908.8074,1536001981862297747.8288,50866,19.2641,0.0014,0.0065
2849,20274,17425,30974,2134161403.7431,1554907241418205906.0341,17426,23.874,0.0119,0.0042
5539,84151,78612,20163,2153217327.4808,1536564392807197215.8278,78613,10.8959,0.001,0.0043
6946,47391,40445,10430,2151542818.983,1533803308925377309.6706,40446,2.4572,0.0012,0.0032
7988,60514,52526,26276,2141155973.7371,1541129279357664633.3777,52527,8.2125,0.004,0.0009
18188,100873,82685,13406,2148318760.6189,1543842781418874200.4864,82686,10.7524,0.0022,0.0026
20146,70484,50338,22285,2157790433.6892,1536639719451684798.124,50339,11.5063,0.0003,0.0044
21681,51809,30128,20087,2161622793.4998,1527438951145746065.5738,30129,15.5417,0.0017,0.0085
9105,9429,324,13655,2218429054.7508,1683521521876621183.9963,325,11.464,0.0263,0.0587
16058,61500,45442,673,2158085399.4353,1539730294286085851.5522,45443,10.6438,0.0004,0.0051
21847,93605,71758,1422,2159372194.0072,1539714379081437717.059,71759,13.4578,0.000,0.0051
717,90173,89456,8359,2129111574.2423,1538791476029131922.6593,89457,33.116,0.0062,0.0001
22857,99655,76798,9173,2145739421.7566,1540741766311625950.1563,76799,3.0895,0.0019,0.001
9942,12703,2761,18750,2117018958.5644,1529376437868712857.8613,2762,5.5963,0.0157,0.0027
14321,25467,11146,28283,2130603294.96,1538415883280286903.343,11147,16.8193,0.0131,0.003
3040,64574,61534,29253,2135362696.147,1550745367783239009.6359,61535,27.9983,0.0066,0.0003
11416,11894,478,26323,2103576931.3486,1463353988318523497.63,479,6.9337,0.0324,0.0227
22065,55469,33404,23848,2147952027.997,1533553776796145056.4492,33405,8.7491,0.0026,0.0032
12428,66842,54414,31111,2153671460.9761,1543892846993611499.3142,54415,7.7993,0.001,0.0041
17684,105213,87529,218,2151226080.3307,1531744978282111544.2668,87530,6.7007,0.0008,0.003
11613,65269,53656,26427,2134815732.3478,1528012755829751749.3117,53657,16.0631,0.0057,0.0006
6673,30325,23652,31017,2137433295.5705,1529311622829436863.7454,23653,5.5493,0.0051,0.0002
9203,54797,45594,30591,2150196987.7285,1530286568397290622.6575,45595,7.9853,0.0015,0.0034
21691,35725,14034,5245,2154375514.5893,1532450575860964906.1602,14035,4.7663,0.0012,0.0041
30191,78177,47986,17502,2142356422.2915,1534530829580451859.1997,47987,8.7984,0.004,0.0012
18616,68690,50074,28085,2145359565.2809,1531418138161805394.2165,50075,3.0093,0.0019,0.0015
23342,68890,45548,23426,2150466987.7726,1533545636687695947.4667,45549,3.4016,0.001,0.0023
30496,82000,51504,4285,2143604792.6893,1531897966199180449.9396,51505,12.1316,0.0028,0.0017
5811,80832,75021,29389,2152343644.4926,1534305897145667148.6054,75022,10.7136,0.001,0.0038
15964,33520,17556,12703,2152469534.8151,1535515690572380397.1026,17557,6.9527,0.0025,0.0049
266,6905,6639,23128,2127523356.0012,1545747474787117709.9506,6640,16.4458,0.0136,0.0031
3595,98078,94483,14032,2139824292.7767,1529495007161051997.0473,94484,7.6333,0.0035,0.0005
18636,34484,15848,5369,2148857569.9926,1523561436263083249.5681,15849,8.3234,0.0039,0.0057
8045,32910,24865,309,2138252427.9993,1550161744155875499.5311,24866,10.2204,0.0063,0.0024
7022,75134,68112,5166,2152067823.4387,1531128657693220572.5426,68113,5.7519,0.0008,0.0026
7299,88937,81638,5739,2141303251.602,1536901337921180234.3312,81639,4.8323,0.0028,0.0005
2730,86785,84055,15932,2143836847.6641,1532706447092583137.6212,84056,18.2107,0.0029,0.0017
12609,76550,63941,18439,2165476109.1714,1535336799733009153.5492,63942,20.4421,0.0004,0.0081
1144,33281,32137,9752,2152631827.0039,1531322312424749791.3099,32138,5.1006,0.0019,0.0046
15727,67116,51389,5932,2153230463.2712,1534437091954613138.1149,51390,5.796,0.0007,0.0031
6630,77235,70605,2727,2159223722.6008,1540222144282195481.4084,70606,9.1802,0.0003,0.0055
5108,12790,7682,6453,2147986430.5282,1541775583519927932.4903,7683,11.3153,0.0101,0.0054
16490,69095,52605,10143,2149632708.0002,1544571613367605875.85,52606,3.6086,0.0021,0.0032
30287,31042,755,4607,2134435605.7434,1514829303397412417.6617,756,4.4791,0.0147,0.0126
12977,88602,75625,24287,2143085724.9453,1536798392519603055.3199,75626,7.1289,0.0025,0.0015
7939,99508,91569,8301,2144722517.0666,1540968685103296327.9535,91570,3.9065,0.0023,0.0006
11905,64487,52582,18024,2134680744.3988,1531589039878536947.9436,52583,10.6237,0.006,0.0004
10719,41479,30760,8298,2152134954.6921,1527190418517291177.0292,30761,6.5606,0.0024,0.0047
18726,113275,94549,12061,2140285715.3965,1528023058484996651.6662,94550,13.6957,0.0041,0.0006
24753,51033,26280,22331,2155549270.5628,1533844303341335947.8238,26281,5.7637,0.0008,0.006
3630,101304,97674,10461,2147614365.742,1534240981694156336.8542,97675,4.6835,0.0011,0.0016
1038,6410,5372,21009,2153507597.0875,1531568872417183164.3605,5373,4.3654,0.0036,0.007
7751,82484,74733,6055,2152196942.4028,1542795995319708066.7802,74734,22.059,0.0019,0.0045
12502,87682,75180,26903,2161592182.9941,1533833781278708554.8122,75181,12.1741,0.0002,0.0051
6994,43595,36601,125,2139382457.5398,1531455159662872690.6478,36602,9.4516,0.0056,0.0007
16403,49842,33439,18050,2163275984.6847,1533164103350405095.9049,33440,11.5253,0.000,0.0072
18855,86745,67890,17274,2153601625.8467,1535410245703197021.3931,67891,9.990,0.0007,0.0037
20892,102470,81578,7245,2144058687.1513,1529600733949998598.9185,81579,7.6194,0.0028,0.0017
13567,63019,49452,31949,2149436105.8908,1529652301048103654.2074,49453,9.3348,0.0014,0.0029
6623,47768,41145,18905,2144921055.5122,1543244267564836414.9786,41146,6.710,0.0028,0.0011
1407,17808,16401,6952,2152111737.7902,1529169994101448863.5676,16402,3.4694,0.0021,0.005
3810,51141,47331,25961,2136563295.5039,1543065061081743911.9932,47332,13.1178,0.0067,0.0008
7805,83387,75582,23892,2149870323.1045,1537502154350301177.8664,75583,5.9091,0.0009,0.0017
29265,94256,64991,27449,2150189295.9609,1546137031315349375.6674,64992,8.2626,0.0017,0.0036
13522,88252,74730,28544,2147581180.4948,1536479950601107839.0522,74731,4.5387,0.0012,0.0013
5042,72031,66989,19540,2150606186.0976,1534335417495066868.256,66990,4.3138,0.0009,0.0024
23280,53762,30482,31443,2146121770.6481,1531652226053313266.5767,30483,8.6406,0.0033,0.0034
3852,68828,64976,13227,2147360319.3306,1534385394076623439.0959,64977,5.5257,0.0023,0.0021
29449,118182,88733,629,2143040264.1896,1536240879552565960.5012,88734,9.9963,0.0035,0.0007
6121,92513,86392,27699,2157387838.3843,1539685171514870175.7283,86393,12.5794,0.0003,0.0037
22137,98442,76305,26357,2145973859.8126,1533908360920842753.4311,76306,2.5013,0.0021,0.0012
10256,56171,45915,26291,2137113110.1199,1553882758976461356.0584,45916,21.2546,0.0061,0.002
17918,55697,37779,23667,2146688778.5478,1539002004148084646.8308,37780,4.3085,0.0033,0.0026
20745,26762,6017,17955,2155245444.1527,1558747751743749090.2779,6018,13.4156,0.0059,0.0113
26330,89167,62837,20510,2151204854.2369,1533974940899318003.9405,62838,6.0575,0.0012,0.0031
32567,54658,22091,7338,2144162764.7366,1535327287944384908.3731,22092,2.8163,0.0041,0.0017
3547,50586,47039,29886,2132089695.9925,1537450248099893239.6401,47040,18.0839,0.0063,0.0004
17256,99248,81992,6646,2154988102.8273,1537563299997529732.0764,81993,16.1586,0.0003,0.0053
16277,87368,71091,29782,2147235255.4949,1541678825241572699.9179,71092,11.8477,0.0019,0.0026
996,63265,62269,18614,2155953267.9085,1536498967183434948.0205,62270,9.4043,0.0006,0.0042
24416,62924,38508,14050,2132752509.9297,1532129068781620867.9409,38509,12.1045,0.006,0.000
1439,97568,96129,17825,2153375915.2244,1538378773188546012.7896,96130,9.9507,0.0004,0.0033
31568,62138,30570,26190,2141891609.4949,1530328911216196953.8158,30571,6.2041,0.0042,0.0014
21518,31155,9637,11521,2126151858.2802,1518115362833196210.4534,9638,13.3469,0.012,0.0032
30030,121296,91266,1225,2143731985.2021,1547267049278654772.1807,91267,19.1137,0.0036,0.002
19010,103105,84095,28617,2140078065.6035,1534201345679690814.7568,84096,4.7908,0.0038,0.0003
12417,94941,82524,15059,2145905531.4888,1540240328841183175.7292,82525,9.5109,0.0022,0.0013
5713,99526,93813,27950,2144714925.8166,1537623781579725619.5199,93814,3.9196,0.0018,0.0006
2998,69124,66126,14185,2147512650.0646,1538338655693270649.3053,66127,8.2453,0.0014,0.0016
10215,45628,35413,2527,2155247540.6229,1543201959763332777.4768,35414,8.5096,0.0011,0.0046
16890,100729,83839,11666,2143530301.7656,1535729475758265233.4008,83840,14.7261,0.003,0.0008
30077,40563,10486,5777,2148004032.2299,1529268167955710139.5115,10487,9.2858,0.0047,0.0043
20723,91857,71134,13547,2148320317.9665,1529260660352350244.2951,71135,7.2641,0.0016,0.0024
21301,120004,98703,23332,2148496030.9401,1531490598466987613.0991,98704,6.8773,0.0015,0.0025
24393,100460,76067,30772,2141714707.1503,1539744782634655390.1167,76068,4.9964,0.0029,0.0003
31741,82564,50823,25290,2145710588.0531,1535975783270680179.7983,50824,12.612,0.002,0.0027
2892,27236,24344,19750,2153669351.4523,1540870874190076848.1298,24345,5.5063,0.0012,0.0041
19239,63886,44647,13787,2160934192.9442,1551583035261174835.5974,44648,16.237,0.0017,0.0063
31292,49969,18677,10648,2135758164.3339,1525187306450626630.8491,18678,11.6993,0.0067,0.003
5778,84819,79041,27129,2141677288.1741,1538974390535038221.5891,79042,3.9779,0.0032,0.0003
7450,14219,6769,21987,2162830135.2182,1526805304186841356.1144,6770,4.8399,0.0019,0.0099
25963,61867,35904,8848,2132766570.8336,1533544319388125190.6735,35905,8.0891,0.0065,0.0006
17681,101713,84032,4692,2155175290.7129,1540824263282148062.8597,84033,12.7548,0.0008,0.0048
26622,32958,6336,29900,2162098135.4988,1562966674609214140.0878,6337,5.7086,0.0048,0.0108
7578,23962,16384,15369,2155502381.8603,1525901403952664880.0069,16385,4.2945,0.0015,0.0049
14474,111646,97172,15378,2141783289.8985,1538939047030691109.2921,97173,6.0518,0.0027,0.0002
30680,82485,51805,21232,2150053860.5042,1547060637119506072.5386,51806,7.6131,0.0021,0.003
24207,68426,44219,17661,2145205477.6757,1537002496830471131.7064,44220,4.6269,0.0027,0.0013
31840,76651,44811,16885,2157974992.4464,1533890354778748604.7492,44812,8.265,0.000,0.0052
32411,52650,20239,11116,2136925448.6273,1544136873103117141.0789,20240,6.2071,0.007,0.0016
23774,47913,24139,14712,2144511086.0147,1523079951094919747.1689,24140,4.5458,0.0045,0.0031
7081,75916,68835,15735,2149293841.6247,1542531209661645588.6448,68836,14.0086,0.0025,0.0025
4912,15097,10185,23747,2142202522.8281,1551560686617148370.5085,10186,9.065,0.0057,0.0033
11959,40611,28652,19668,2156036699.2363,1534857109428289018.0032,28653,5.4953,0.0013,0.005
12747,45723,32976,18124,2139220335.0252,1547058474262472004.407,32977,13.8433,0.0052,0.0011
8061,29721,21660,1555,2143622741.8706,1551708934770300019.8701,21661,5.8777,0.005,0.0051
5860,93587,87727,10308,2140925836.7635,1543805078768428058.0804,87728,24.2048,0.0039,0.001
20650,48467,27817,1211,2141321446.7982,1540554345967303868.1481,27818,10.1796,0.0073,0.0017
19101,86165,67064,10813,2153696435.5925,1531424770292794655.1268,67065,8.7495,0.0006,0.0032
20978,82140,61162,5939,2147557547.1555,1537601765045626864.0698,61163,12.9539,0.0028,0.0019
27225,37160,9935,13821,2152295839.0362,1521596008631736282.5019,9936,10.2365,0.0056,0.0089
14057,60506,46449,10584,2139025428.83,1533857651524545738.0037,46450,7.3033,0.0055,0.0003
8076,52405,44329,15770,2143269088.7374,1527632061281386366.6625,44330,11.8916,0.0054,0.0032
1033,44577,43544,15526,2148591448.6282,1533467532129455999.797,43545,4.7821,0.0024,0.0024
28557,29869,1312,21946,2180099750.2795,1654868777273128570.7193,1313,18.9583,0.0182,0.0335
25443,64657,39214,6169,2145619804.8554,1542735702787455237.3874,39215,4.6171,0.0031,0.0023
16478,108422,91944,2601,2150448768.2302,1544506721600562153.4398,91945,6.940,0.0012,0.0031
17404,47317,29913,1149,2142376251.3335,1538509345501223542.1561,29914,4.6175,0.0039,0.0012
28699,103510,74811,14659,2149070814.4433,1539113514090542373.6402,74812,2.9739,0.0016,0.0019
7206,88093,80887,15751,2155601442.747,1529688214455792016.4702,80888,12.0572,0.0003,0.0041
15177,34634,19457,157,2140221645.4932,1529833055927530915.7301,19458,3.5882,0.0041,0.0013
30038,109740,79702,6273,2144784556.0924,1546657118937606611.2944,79703,14.1792,0.0037,0.0018
6794,79176,72382,2170,2148207692.5506,1538118634534800546.1199,72383,9.0877,0.0019,0.0024
22806,89412,66606,21425,2152535203.5537,1540432513663780625.4814,66607,6.6563,0.0008,0.003
10855,65572,54717,6368,2140369948.5532,1539862495711804141.3736,54718,11.7895,0.0057,0.0011
29685,108516,78831,12425,2141720337.6741,1540198339689845401.1022,78832,6.1019,0.0035,0.0008
19892,103842,83950,10152,2155522883.9005,1534573344693462103.9947,83951,6.454,0.0001,0.0035
11056,62197,51141,4667,2136481447.9769,1539081852271379503.5315,51142,12.5068,0.0046,0.000
3365,33374,30009,17792,2149200761.0513,1540919497570650133.2434,30010,9.2562,0.0028,0.0035
29525,128411,98886,2736,2150906301.4379,1527562216915302197.4521,98887,13.3538,0.0012,0.0033
22719,115473,92754,2331,2140661374.8383,1546809333459610805.3741,92755,11.6996,0.0041,0.0011
8757,56577,47820,4739,2154622116.9896,1532173782681802988.716,47821,7.1791,0.0007,0.0044
6191,88287,82096,26027,2145771908.3143,1534047306926819905.8968,82097,11.534,0.0022,0.0017
5601,88694,83093,2126,2153365670.941,1536852234088000288.3107,83094,10.1501,0.0007,0.0038
27646,63414,35768,17874,2154782751.1106,1527551529161448760.9438,35769,8.6529,0.0007,0.0043
2024,95589,93565,15191,2152023563.9618,1528331187232926656.3583,93566,9.2537,0.0015,0.003
3933,92714,88781,30092,2147888378.3141,1535405600234986051.0972,88782,3.1268,0.0008,0.0013
23031,108754,85723,15433,2146633185.9387,1543433890575779323.7656,85724,8.0303,0.0017,0.0012
227,94079,93852,26631,2150570888.9423,1541236754385481613.1851,93853,11.5252,0.0011,0.003
23007,61734,38727,1384,2140040478.2808,1533800669426402052.9194,38728,2.301,0.0038,0.0001
12129,70839,58710,24116,2163356099.6289,1532161939490854429.4313,58711,20.3025,0.000,0.0062
22640,54907,32267,25190,2164368675.3349,1520148086466776506.4749,32268,32.3907,0.0016,0.0097
15815,33975,18160,5139,2140844273.2971,1525263688193834255.7779,18161,12.1428,0.0057,0.0027
4797,13424,8627,22186,2150456608.5635,1564539311375759535.5019,8628,10.6123,0.0084,0.0089
31185,69295,38110,20141,2155814510.8611,1539147431969722161.1603,38111,22.8634,0.002,0.007
26915,73344,46429,16759,2148503661.9055,1548146864763913491.1911,46430,16.5969,0.004,0.0053
14254,17477,3223,14333,2188884148.5273,1565428852640924837.3435,3224,12.3395,0.0057,0.0219
6284,65059,58775,11891,2147561393.3171,1545203005825220170.5201,58776,13.838,0.003,0.0036
8808,90460,81652,4781,2140500086.5572,1540543571793420311.4364,81653,15.1923,0.0041,0.0008
27582,101056,73474,13803,2151120292.4594,1539573328988457345.2631,73475,12.3463,0.0011,0.0025
12083,90802,78719,2504,2150917510.3911,1527912447826195333.8755,78720,7.2623,0.0017,0.0027
23684,41863,18179,10533,2164977934.4259,1555333669433281930.1277,18180,8.2668,0.0023,0.0088
29756,65654,35898,16250,2143961259.8887,1529321898733702445.8814,35899,9.5472,0.0038,0.0021
15839,91493,75654,7038,2141616289.3126,1536337757654729303.246,75655,5.7837,0.0028,0.0001
18843,47779,28936,7160,2147460694.0476,1531660635309735192.0222,28937,9.8569,0.0026,0.0027
25849,107557,81708,20925,2143093940.9629,1537228137589108355.9175,81709,2.5477,0.0023,0.0003
5713,81271,75558,16156,2153965586.6423,1541169203323287805.4989,75559,11.6696,0.0002,0.0033
26220,81674,55454,29483,2149623014.6828,1536000754128723555.0401,55455,2.110,0.001,0.0023
14773,59184,44411,21123,2158201161.6497,1544083818427073100.4832,44412,8.343,0.0005,0.0058
26261,82257,55996,26908,2145139751.3995,1548435550119261785.8571,55997,16.0651,0.0043,0.0031
19936,66690,46754,455,2153886410.2322,1542056036938816548.7904,46755,4.772,0.0006,0.0045
1338,21946,20608,17576,2136650443.6728,1548113047564018204.2332,20609,10.6258,0.006,0.0014
6898,34935,28037,14639,2156029780.8021,1524098083741223961.7104,28038,16.6442,0.002,0.0054
26464,115014,88550,9567,2141158052.4533,1537486832030415396.1691,88551,5.7483,0.0034,0.0002
19217,56698,37481,9266,2146459683.0431,1531535492330020400.0823,37482,8.7487,0.0036,0.0038
1847,72518,70671,22950,2148300903.0975,1540255497656914140.1265,70672,3.8282,0.0014,0.0019
18988,58983,39995,21570,2149472661.379,1534199212804778112.8466,39996,7.6988,0.0033,0.0031
31611,79761,48150,28775,2145211791.4001,1526735546808053713.496,48151,12.9552,0.0051,0.0025
10891,42460,31569,15033,2157707154.1838,1540626681338169945.6096,31570,9.4732,0.0005,0.0045
9824,44435,34611,9753,2149745602.6247,1535870683874651734.3585,34612,5.120,0.002,0.0034
23369,71739,48370,28691,2136128412.0269,1541498312013724017.6595,48371,13.745,0.0067,0.001
15903,97398,81495,13058,2148725467.2556,1537838931824854327.2461,81496,4.7067,0.0009,0.0013
2844,49260,46416,31514,2151861392.5959,1545643692368394126.3536,46417,3.0396,0.0014,0.0033
12640,56557,43917,26189,2142891468.3952,1535215704351162926.307,43918,11.2112,0.0035,0.0015
9106,38482,29376,1776,2153126806.0596,1545021679286548159.9094,29377,9.7205,0.0024,0.0042
12270,102731,90461,27186,2138427271.6066,1533845405502186934.2088,90462,20.7964,0.0037,0.0001
5853,57071,51218,15324,2151823684.3109,1534551568635113990.5097,51219,11.127,0.0027,0.0052
15288,106031,90743,2822,2142315023.7708,1530686172647930017.0262,90744,5.4336,0.0033,0.0004
29741,61836,32095,21348,2109557701.9826,1538024122646723542.9922,32096,36.6819,0.0154,0.0002
31931,67879,35948,6551,2156353418.8158,1533553114482460558.0961,35949,5.231,0.0003,0.0053
13761,56911,43150,26920,2151662403.8714,1540451184769087908.3482,43151,3.9184,0.0005,0.0029
844,5880,5036,12988,2160773735.3071,1573049697538867280.8124,5037,13.5302,0.0073,0.0135
31419,33790,2371,19392,2174289755.011,1546784193022236949.6837,2372,6.9239,0.0027,0.0169
22883,30372,7489,10353,2135791899.2693,1521768053989144706.514,7490,10.5226,0.010,0.0044
24457,105102,80645,19646,2142129083.2959,1538498260440963266.0725,80646,12.1624,0.0028,0.0006
28308,46375,18067,24353,2151527942.8567,1530787068066203409.6138,18068,3.4616,0.0024,0.0063
11054,62324,51270,30995,2146141772.6137,1532701929248120377.0401,51271,0.8728,0.0019,0.0014
2605,12091,9486,18969,2132398901.8749,1535042029263733150.9099,9487,11.4193,0.0121,0.0023
20783,116246,95463,16291,2157166731.9049,1537572539954085945.5329,95464,10.7607,0.0006,0.0039
11045,106481,95436,23005,2152807347.3262,1538264172509850923.5422,95437,7.7632,0.0007,0.0034
23392,50783,27391,19429,2142465460.4533,1544081370515449073.6777,27392,8.9767,0.005,0.0022
19668,50879,31211,15161,2156157616.5747,1535186687485827205.9726,31212,14.1951,0.0003,0.0039
23537,98651,75114,24868,2149167469.332,1533467697434070482.2221,75115,5.9876,0.0013,0.0018
10524,41269,30745,3829,2143858246.7107,1536606095716330915.5877,30746,3.5207,0.0032,0.0012
12367,55725,43358,15111,2151535078.73,1534303003101009282.4681,43359,8.4098,0.0015,0.003
6243,10730,4487,26213,2178084472.8119,1529019187471561040.511,4488,8.0015,0.0004,0.014
19471,64761,45290,17867,2153758491.224,1528105138406673944.0906,45291,14.4917,0.0012,0.0044
14666,16208,1542,23188,2156272481.0998,1546099308079327904.2596,1543,9.067,0.0101,0.0116
27822,85238,57416,21737,2139641478.037,1546065481741867848.6086,57417,30.0134,0.0047,0.0004
12810,108393,95583,25415,2149803884.1381,1546394305711484284.1441,95584,8.3598,0.0016,0.0029
30942,63290,32348,4032,2132356670.1387,1533021084741018856.2496,32349,12.1437,0.0058,0.0006
21620,97436,75816,21855,2138737269.592,1532129301261612042.8984,75817,9.8053,0.0039,0.0001
8562,100742,92180,26660,2140808866.5081,1538254105204293649.117,92181,14.1322,0.0035,0.0003
12681,62646,49965,15460,2152332393.8265,1544234798717368738.0483,49966,4.0804,0.0011,0.0033
1965,26125,24160,6443,2160650647.3139,1526676875835652020.247,24161,23.7242,0.0009,0.0093
12264,110531,98267,22209,2145743339.7113,1538380031977682205.2503,98268,5.9622,0.0023,0.0009
24721,78437,53716,2290,2153059754.1702,1539719656740163620.5639,53717,6.6923,0.0009,0.0037
1666,86960,85294,30579,2154132975.9782,1536345817730976414.3933,85295,6.8493,0.0001,0.0037
25829,101109,75280,21478,2150393081.9336,1535448969512415410.2314,75281,7.9424,0.0008,0.0031
28188,94022,65834,7673,2146145582.8615,1533743939421327667.8609,65835,6.5321,0.0027,0.0023
5182,75170,69988,10842,2146488395.6647,1533086120329433032.8285,69989,4.5991,0.0022,0.0016
19226,59691,40465,23210,2138363607.0914,1535010902476602042.6795,40466,35.5113,0.0057,0.0026
30808,67628,36820,10102,2152641184.0883,1540668077791199845.4921,36821,4.5916,0.0015,0.0037
23517,68868,45351,11515,2160710642.1763,1543787720540375923.4141,45352,11.4693,0.0006,0.0071
16450,49417,32967,29983,2144736366.4056,1536506636153041966.1457,32968,2.3402,0.003,0.0016
29184,74691,45507,3985,2161505119.464,1550715873181921284.1905,45508,8.4773,0.0003,0.0069
15844,67389,51545,30028,2152245069.6789,1530536770294459103.1108,51546,5.6014,0.0015,0.0038
31870,95008,63138,28314,2149573120.2707,1536574243084167452.1161,63139,24.9971,0.0012,0.0025
25206,111862,86656,934,2143327034.8329,1533791619188098981.6212,86657,11.5874,0.0033,0.0005
15627,94411,78784,25463,2142178133.7546,1538096554601086847.5921,78785,16.0449,0.0047,0.0007
14186,88921,74735,17917,2148690147.33,1523647426760641521.9282,74736,13.0283,0.0025,0.0031
5141,85930,80789,11248,2146093351.6813,1534152687376828329.1329,80790,13.5511,0.0026,0.0017
20299,58313,38014,30081,2146828197.1923,1526925665350523718.7073,38015,3.7289,0.0027,0.0025
17061,27607,10546,12525,2152306976.5895,1552112151007796636.79,10547,7.8112,0.0036,0.0067
23621,54534,30913,30183,2132656148.4029,1522883038321539756.9487,30914,21.4004,0.0077,0.0024
17685,73951,56266,10217,2151769654.5602,1544435822561074722.6311,56267,3.9823,0.001,0.0036
418,70231,69813,28115,2144459707.8868,1548122008602346713.5992,69814,13.2187,0.0028,0.0014
31860,62047,30187,17732,2148986830.2105,1538327310599276377.9699,30188,3.6626,0.0019,0.0028
16369,17163,794,6656,2256077445.356,1661906126343884201.4997,795,14.4482,0.0104,0.0574
19572,110506,90934,30374,2146104097.15,1531258434862237145.568,90935,7.5431,0.0025,0.0019
19574,65271,45697,9179,2162750650.2557,1526173418357570973.8965,45698,20.9205,0.0008,0.0077
20069,63645,43576,6421,2142114341.261,1544734271307431750.6719,43577,9.2744,0.0035,0.001
22247,31855,9608,6031,2167842920.1869,1538306454610782224.3917,9609,7.7257,0.0001,0.0097
30841,33484,2643,8036,2136222716.1868,1508320158688477627.4394,2644,8.7694,0.017,0.010
10801,36174,25373,8949,2142196045.7227,1548206862829553556.3087,25374,11.9039,0.0047,0.0021
21824,115821,93997,5433,2147362854.7963,1542796203118232819.6798,93998,10.7211,0.002,0.0026
9049,103341,94292,29659,2161837380.1786,1540219326960398673.0475,94293,15.2871,0.000,0.0053
27153,78250,51097,15574,2142959785.3763,1530639107124256737.3679,51098,8.0521,0.0034,0.0021
17097,60245,43148,28670,2140494540.302,1550085800574669281.8388,43149,12.2325,0.0045,0.0022
17887,112156,94269,27013,2153452758.4011,1538687939568306336.312,94270,7.8746,0.0001,0.0029
20826,95674,74848,18574,2149449112.9175,1528992057939707777.9677,74849,5.174,0.0018,0.003
10627,66414,55787,7123,2156752423.4223,1539188483726724045.4065,55788,13.3531,0.0001,0.0057
23747,38341,14594,10450,2157120194.8064,1537777298869632048.3775,14595,15.3633,0.003,0.0086
7775,43070,35295,4603,2156764765.0811,1523998056716265230.3719,35296,8.8879,0.0015,0.0056
15721,87347,71626,27698,2156550338.0871,1541357586815799163.7844,71627,21.2025,0.000,0.0044
1138,87561,86423,7445,2144471040.2518,1540436082519008481.2027,86424,8.7135,0.0024,0.0014
27459,119650,92191,20062,2145176583.4826,1537669423227129206.4718,92192,3.6504,0.0021,0.0006
16380,57884,41504,29693,2147639249.8547,1539944282304020630.2781,41505,4.1593,0.0026,0.0036
17230,109350,92120,24484,2145884664.8798,1536853819910146317.3177,92121,3.6085,0.0022,0.0007
21471,116855,95384,3349,2145766088.0166,1531692750728606204.5414,95385,14.7106,0.0029,0.0028
2515,42815,40300,12208,2141383102.0625,1521177344598886916.9607,40301,5.2586,0.0057,0.0016
124,61198,61074,2573,2146186879.6357,1538550184568176183.1507,61075,9.7291,0.0023,0.0015
32146,100453,68307,9555,2147104794.7728,1541928540106153575.0935,68308,11.7338,0.0014,0.0014
14512,57978,43466,18547,2146452210.1283,1530550584003722247.6716,43467,3.0971,0.002,0.0017
6229,37020,30791,12844,2148700467.221,1543143813173756140.4725,30792,9.3608,0.0024,0.0032
5195,45539,40344,3459,2147622146.0866,1530582463321114400.1896,40345,3.3029,0.0033,0.003
15022,69031,54009,17790,2140737481.6517,1537497545731364758.466,54010,7.8034,0.0043,0.0004
4130,80854,76724,26775,2152875353.3452,1525387154206266328.8907,76725,26.3079,0.0019,0.0041
12698,85552,72854,5215,2148323052.5533,1542104393035909401.2868,72855,6.620,0.0017,0.0018
1871,83331,81460,4886,2143296000.3701,1532812729815312903.2541,81461,11.1749,0.0039,0.0013
22607,101163,78556,18790,2153307662.128,1528397483150556666.6466,78557,8.6548,0.0006,0.0038
6649,37367,30718,31793,2133281405.3926,1541614703041634505.9936,30719,7.1284,0.0063,0.001
10403,21765,11362,12388,2132531930.1281,1551108844836744246.6281,11363,6.8096,0.0089,0.0016
12461,14989,2528,966,2230385923.8059,1534816850406545924.4704,2529,16.6724,0.0012,0.0339
6178,30720,24542,13634,2157210794.1273,1527516751690846521.2569,24543,21.7282,0.0027,0.0059
15644,17481,1837,5684,2145907031.4217,1567616792355535327.8434,1838,11.3269,0.0154,0.0154
1276,91197,89921,29289,2146776138.193,1537922517456372720.8561,89922,12.5996,0.0021,0.0021
32390,111898,79508,24509,2153516995.0402,1540159014258626503.4406,79509,13.6488,0.0009,0.0038
4458,87526,83068,4028,2138522999.3002,1528357075782573539.2108,83069,16.0051,0.0049,0.0014
23164,58727,35563,22950,2162948916.8654,1528422143869625613.1106,35564,11.4245,0.0007,0.0082
27632,96041,68409,4568,2150397169.6316,1545750993542549834.3314,68410,9.5582,0.0013,0.003
21039,107592,86553,22310,2152161960.5291,1542292139324527047.6904,86554,6.6822,0.0014,0.0033
8261,81828,73567,15668,2150089546.9441,1542955691621294641.1589,73568,3.4969,0.0015,0.0024
30756,86516,55760,14186,2151187704.1728,1541637872500098152.5252,55761,2.4989,0.0012,0.0036
13059,57011,43952,22926,2158393387.136,1538456323817144692.3144,43953,11.0884,0.001,0.006
13856,78798,64942,10726,2154070922.7584,1536778062157411778.8373,64943,13.002,0.0012,0.0049
25355,76165,50810,7036,2160628828.401,1537756228375311962.8659,50811,7.7346,0.0015,0.0075
10163,70213,60050,11281,2150382930.6129,1540876484995043879.8703,60051,11.2801,0.0018,0.0031
12055,81486,69431,17091,2138324845.1813,1535353823639665363.7518,69432,6.2157,0.0046,0.0003
13073,79619,66546,24486,2155880300.8112,1537152403236628732.3627,66547,14.2195,0.000,0.0041
17806,28100,10294,4651,2137642185.5732,1549691477850262952.539,10295,11.3223,0.0093,0.0039
30288,117497,87209,14686,2146078548.7033,1537457686435992510.0939,87210,5.0286,0.0028,0.001
31544,39521,7977,25753,2181791850.6131,1554985408299517022.0444,7978,15.7285,0.0007,0.0145
21335,97827,76492,17647,2144740240.8677,1532917199467134526.8185,76493,9.5924,0.0026,0.0015
22226,55233,33007,14763,2132035409.9847,1551226689871484530.0199,33008,18.9873,0.008,0.0009
12758,81562,68804,9217,2141166248.5572,1538080953127076975.6371,68805,9.8085,0.0049,0.0015
30703,129637,98934,12558,2139593090.5666,1535999783442636735.7244,98935,11.0333,0.0051,0.0002
11084,88688,77604,14764,2149767391.3763,1535693608320775346.5847,77605,4.8421,0.0012,0.0018
27174,74976,47802,13598,2144651515.9302,1537184389107185214.2631,47803,15.0731,0.0044,0.0021
25525,83257,57732,15830,2138824296.4467,1536017751838945286.3384,57733,7.2564,0.0042,0.0003
25656,81509,55853,26322,2143539990.798,1529052743045276761.0427,55854,10.7678,0.003,0.002
11413,34052,22639,14329,2142976574.9855,1521689910987189416.9351,22640,7.5996,0.0059,0.003
2222,64056,61834,12283,2154287381.5399,1539040756594968226.2941,61835,7.6798,0.0002,0.0033
19177,61242,42065,24766,2163897628.7113,1545798760049229805.668,42066,13.4889,0.0005,0.008
13216,78679,65463,27504,2152616147.8168,1536680640032010209.3387,65464,7.5258,0.0004,0.0031
10050,43353,33303,13494,2138547782.5622,1533184401469147268.3016,33304,3.8693,0.0053,0.0009
29674,104611,74937,16186,2164450972.7546,1535403350836841715.0623,74938,21.6195,0.0001,0.0061
11380,103307,91927,7931,2149114334.0023,1543737255141287576.5828,91928,10.3685,0.0011,0.0025
14608,52353,37745,31664,2141833162.7652,1540457034916435725.8738,37746,8.7283,0.0061,0.0017
1625,85153,83528,3953,2145200717.8496,1535593245323723272.3934,83529,10.3558,0.0021,0.002
30366,118927,88561,16037,2146977714.468,1530445513323891628.1788,88562,14.0718,0.0025,0.002
2235,28725,26490,23361,2161542152.5411,1528149090733872495.5184,26491,10.7102,0.0012,0.0059
20364,66780,46416,4834,2136097470.5289,1536779364997614728.7313,46417,6.6595,0.0048,0.0005
25937,112095,86158,30403,2147304374.9621,1544866695906851403.9685,86159,6.1413,0.0019,0.0023
11086,24642,13556,27382,2179749913.0704,1553526426817424071.9663,13557,22.4083,0.0036,0.0151
32520,55006,22486,5835,2146572070.1461,1535411949474218927.3763,22487,5.0486,0.0034,0.004
9940,85208,75268,998,2151314977.5414,1533314262736744626.5543,75269,12.4676,0.0007,0.0031
17134,46252,29118,20262,2150995146.7363,1545230091183487838.2138,29119,5.7461,0.0016,0.0035
25864,94339,68475,9087,2151908274.8823,1533437854520122104.6517,68476,5.3317,0.0009,0.0035
6962,53077,46115,13829,2148802468.7992,1530173449451026892.7835,46116,5.8752,0.0021,0.0029
11027,91140,80113,16707,2139192460.2125,1539110699232157158.5945,80114,12.7257,0.0036,0.000
28564,47665,19101,10457,2154577196.9426,1541130416301626778.6159,19102,4.1735,0.0018,0.0052
1895,68615,66720,13643,2146053482.4335,1530880369120094278.0929,66721,5.7298,0.0018,0.0014
10075,71952,61877,8047,2144355609.6394,1531765080395568743.4835,61878,2.4494,0.003,0.0013
29031,78339,49308,21540,2141789741.3547,1526430071033154439.0366,49309,14.4499,0.004,0.0021
13766,38953,25187,9359,2158363112.1482,1526787977672300103.8685,25188,9.5539,0.0019,0.006
29790,37940,8150,6502,2187163845.7116,1539729520127682282.4248,8151,19.5942,0.000,0.0149
6585,62199,55614,5239,2165742366.9579,1535893682642479880.5087,55615,17.3466,0.0001,0.0086
22426,49792,27366,1019,2139509056.2659,1532469420408754322.2078,27367,11.519,0.0057,0.0018
7513,79560,72047,32674,2150078550.335,1550679686338666097.4799,72048,7.4851,0.0018,0.0034
10290,51284,40994,2336,2156842102.4127,1539382142724409035.5666,40995,14.0476,0.0007,0.0067
15256,76086,60830,13085,2138818021.7811,1532964296991631432.0732,60831,9.2187,0.0046,0.0003
29526,96230,66704,21427,2143023517.0556,1535442019384118591.0799,66705,11.9175,0.0041,0.0013
18413,58345,39932,27979,2140241511.1224,1542713991538607091.2523,39933,4.9984,0.0047,0.0006
2124,11005,8881,26843,2134219462.5664,1549802729434640101.4874,8882,4.806,0.010,0.0033
19376,94311,74935,17926,2144161653.0822,1540343751978830408.9149,74936,9.4461,0.0021,0.0008
28445,82478,54033,7367,2149912800.7481,1536569303715048334.6468,54034,2.1996,0.0012,0.0028
2164,91883,89719,10727,2145531535.1253,1535411074502205456.1107,89720,11.627,0.0032,0.0014
22453,89992,67539,23295,2142396566.9729,1535108532117409026.7077,67540,7.9171,0.0046,0.0008
27498,124434,96936,11884,2150818391.4252,1538587957414093729.0344,96937,1.4562,0.0006,0.0019
27592,102245,74653,27903,2137273254.4049,1539645024817516011.8225,74654,11.5552,0.0049,0.000
2419,54372,51953,9686,2151373482.6136,1537069091851600298.3321,51954,8.2819,0.001,0.0032
11958,29647,17689,22037,2131935776.7131,1546931317657233938.6852,17690,5.9405,0.0073,0.0012
13951,95742,81791,3952,2139174036.3795,1531923017891425026.3935,81792,9.5994,0.0038,0.0006
22740,108846,86106,31136,2149851134.1165,1539510172806948700.8488,86107,14.0995,0.0009,0.003
20733,28998,8265,27327,2134548196.1591,1510351000476548388.0169,8266,13.2149,0.0112,0.0039
23662,67404,43742,31398,2146579100.4931,1534597627579382233.4986,43743,8.3756,0.0032,0.0014
27059,50581,23522,17293,2145853627.6123,1524854017352482622.5224,23523,7.5521,0.0035,0.0031
3313,61870,58557,28606,2136867676.4023,1536792771444909120.1897,58558,13.0169,0.0049,0.0003
25924,117249,91325,9615,2145785144.4752,1529957831639301348.191,91326,8.3347,0.0025,0.0016
29061,74166,45105,31445,2140611694.3278,1538145382913010222.59,45106,5.7883,0.0044,0.0007
24060,64335,40275,30267,2140895593.5238,1543557643536384591.6138,40276,13.0688,0.0034,0.0006
26872,113386,86514,11677,2146167379.4694,1532996136694901651.2701,86515,8.2284,0.0022,0.0011
19047,25395,6348,24065,2110494030.7538,1527864876040371149.6397,6349,18.3957,0.0191,0.0012
18222,93893,75671,31121,2152498109.2759,1539492523165254113.1519,75672,10.6558,0.0008,0.0035
15508,49273,33765,30444,2153615195.0477,1540550775073009186.6336,33766,9.5119,0.0014,0.004
19432,31032,11600,4434,2147587579.1282,1542492759673748994.4186,11601,15.2936,0.0053,0.0065
17941,21899,3958,21542,2130286385.9535,1484653013725360070.8268,3959,13.4422,0.0154,0.0088
10259,107229,96970,11555,2148335838.5942,1541158841708237681.9854,96971,11.8487,0.0015,0.0025
6867,61587,54720,26297,2138997288.4365,1545879393067171494.8153,54721,11.7086,0.0043,0.0015
11287,97011,85724,24450,2147102773.3726,1547384488452284817.3809,85725,9.1464,0.0024,0.0027
10943,98444,87501,15031,2147467395.5361,1535347806049080746.6412,87502,11.434,0.0019,0.0022
29861,51026,21165,21381,2146950053.2069,1552478323084241645.8451,21166,8.7478,0.0044,0.0047
24594,99522,74928,30182,2150673947.7894,1536253826333158661.4289,74929,12.4961,0.0012,0.0023
3889,6437,2548,31897,2169161125.665,1514601967875492241.1753,2549,4.5712,0.0092,0.0155
23371,71991,48620,28078,2164789995.7212,1541049952281689333.0484,48621,12.4173,0.0005,0.0065
22715,89036,66321,6350,2157951972.3079,1530591708611538273.259,66322,15.2827,0.0008,0.0053
20982,84674,63692,10419,2137637314.5471,1531824166391819314.9191,63693,7.8623,0.0043,0.0003
16008,104139,88131,8297,2145835955.3737,1542117665764509238.2036,88132,8.4473,0.0019,0.0015
11013,28110,17097,7784,2161446805.9969,1528679585382719694.9852,17098,14.8546,0.0013,0.0088
5562,53073,47511,10489,2155777613.038,1552291801571426106.9148,47512,16.8639,0.002,0.0063
19770,117696,97926,29582,2138101337.1553,1539435117570506629.3914,97927,16.520,0.0051,0.0002
3860,4156,296,3471,2165397510.0438,1575304843405861148.621,297,2.5713,0.0159,0.0245
23522,78006,54484,11838,2137471778.6721,1526489689681595036.5873,54485,11.1328,0.0052,0.0013
5670,33276,27606,27991,2153929347.1885,1544849617840015144.5888,27607,11.5685,0.0024,0.0054
3267,95165,91898,6980,2141838382.1458,1539791433221542739.7461,91899,20.917,0.0041,0.0003
19282,60047,40765,9432,2136681374.7802,1537198264718188617.6095,40766,9.4348,0.0054,0.0002
2836,67324,64488,32654,2154027522.3476,1531494989794574680.3664,64489,15.5224,0.0012,0.0056
933,76905,75972,28638,2153246109.3422,1530705137603188034.3435,75973,18.0255,0.001,0.0032
3469,16603,13134,19625,2146372805.2104,1544351416033769003.0083,13135,5.0103,0.0038,0.0038
4608,86392,81784,25196,2153719102.0573,1538958175743966635.016,81785,17.8517,0.0012,0.0056
23840,81839,57999,9904,2139579454.7508,1523072283848708087.8779,58000,12.7395,0.0048,0.0016
5906,63103,57197,17222,2148083260.4382,1540167446574536652.6413,57198,11.8163,0.0019,0.0021
21022,47621,26599,23619,2160184179.995,1532935494410459610.8284,26600,6.6197,0.0004,0.0059
2746,99277,96531,31767,2153807088.724,1538733773411423527.5185,96532,9.5014,0.0005,0.0037
28718,54331,25613,10761,2139631795.6701,1557690871923433495.5543,25614,13.0417,0.0068,0.003
24743,76608,51865,20438,2138985398.2775,1533468125551990871.2948,51866,8.6813,0.0046,0.0006
15495,56760,41265,5171,2150567497.5681,1546057909120028129.0607,41266,7.3072,0.0026,0.0036
22189,39491,17302,15657,2157673157.909,1523302193713104029.3676,17303,4.6545,0.0038,0.0076
31365,82543,51178,27420,2136523890.2732,1545832928383251850.1092,51179,21.5737,0.0086,0.0019
14830,21337,6507,29990,2149027007.0771,1516923825191348693.8167,6508,6.2169,0.0058,0.0074
19756,37277,17521,23060,2163299197.0482,1548135211417772819.6537,17522,8.4338,0.0019,0.0088
8756,105839,97083,11493,2149101367.9315,1539214236346843519.7519,97084,10.0451,0.0015,0.0019
17100,85870,68770,6974,2134460951.3851,1538285499460235116.8872,68771,9.1593,0.0053,0.0003
17568,74545,56977,9417,2155976269.2845,1535887801176666660.9417,56978,11.9815,0.0003,0.0053
16373,63186,46813,17294,2136693714.473,1543660136941412549.8272,46814,13.140,0.0068,0.0005
24259,55654,31395,11579,2126870698.0007,1536254355856723585.5304,31396,15.9946,0.0104,0.0004
20036,108817,88781,52,2148867753.1344,1539721655202665344.3844,88782,4.4299,0.0013,0.002
6021,48849,42828,21958,2143090673.0902,1532299773283308851.555,42829,4.5016,0.0033,0.001
4926,78840,73914,28780,2148608291.1773,1534427173558630663.8815,73915,10.9777,0.0016,0.0021
1092,76832,75740,10922,2137185964.7385,1536675284673501192.8253,75741,14.5623,0.0051,0.000
16284,80875,64591,19202,2142593432.8039,1535975353508305438.1059,64592,7.0678,0.0038,0.0004
15785,52047,36262,21673,2147342280.8166,1538399027371570237.2882,36263,7.2665,0.0017,0.0016
190,62242,62052,23661,2140659620.8324,1535128415986605842.214,62053,13.0514,0.0047,0.0012
12783,35665,22882,29241,2155805463.9165,1543524123434238932.6935,22883,5.8473,0.0012,0.0049
13245,54031,40786,2097,2144648862.3565,1529962124234696324.1533,40787,3.6099,0.0027,0.0016
29410,92351,62941,6576,2148830562.6501,1535428638944134737.5109,62942,5.3934,0.0012,0.0022
15265,57354,42089,4380,2153180318.0105,1540464058440171933.664,42090,10.5715,0.0014,0.0036
28554,37817,9263,5931,2123451979.0475,1556894595892148403.534,9264,9.1384,0.0116,0.0028
21574,102502,80928,30929,2146234867.7144,1530287746263777203.405,80929,10.3485,0.0026,0.002
2450,72215,69765,3128,2156775786.4514,1545343805447841345.6556,69766,12.3699,0.001,0.0055
3758,41275,37517,6821,2148123946.1457,1548676023981786857.3758,37518,4.1279,0.0027,0.0027
7516,96185,88669,22447,2153479697.8373,1536960443606170065.1606,88670,10.3348,0.0008,0.0028
30712,102244,71532,23446,2156566394.0887,1542936283259270995.876,71533,18.3296,0.0011,0.006
2650,82164,79514,25449,2145487049.0168,1543667959660815344.3736,79515,9.2074,0.0026,0.002
19983,44441,24458,23568,2123153486.654,1543093488208467530.8154,24459,13.8412,0.0093,0.001
20859,29142,8283,996,2179252532.3353,1536732112208347058.0978,8284,11.579,0.0013,0.0138
11370,11915,545,10772,2224610687.9689,1502878423397347073.4368,546,8.9098,0.007,0.0393
19689,101098,81409,403,2148769921.5868,1527971605035330161.1696,81410,6.9381,0.0021,0.0027
19,90568,90549,7936,2139054733.0936,1535976665316656670.2697,90550,7.4427,0.004,0.0001
32015,95304,63289,14545,2163457834.6642,1542109345696147591.5663,63290,22.5311,0.0008,0.0072
30976,76538,45562,19035,2143151455.8995,1531926275531568406.1568,45563,4.5485,0.0034,0.001
20896,91159,70263,4761,2157576319.4201,1540840174368768805.7094,70264,15.4457,0.0003,0.0061
13964,99233,85269,28020,2143490157.108,1539078638416910634.119,85270,10.6777,0.0031,0.0007
12524,66911,54387,8608,2155563742.4571,1533982796470058516.7656,54388,5.5208,0.0006,0.0034
18594,57283,38689,21251,2124968031.4131,1526421350935990065.7154,38690,35.7681,0.0103,0.000
15546,17010,1464,9369,2190957086.4389,1527558658025730815.3794,1465,8.910,0.0061,0.0313
25175,99499,74324,30586,2132274578.8661,1531096404836862411.3408,74325,21.9598,0.0071,0.000
3990,38800,34810,26498,2145177101.8162,1530438224582657888.4637,34811,11.113,0.0044,0.0027
11348,60777,49429,71,2154222499.3507,1533166925676064663.1941,49430,20.5185,0.0024,0.0041
25333,85999,60666,1803,2142155964.609,1528986809501479236.4384,60667,6.7709,0.0034,0.0006
12917,73455,60538,29979,2144959797.841,1535190698641932233.6363,60539,3.7053,0.0018,0.0009
555,88664,88109,30239,2148713377.8224,1540909607206393039.9251,88110,7.6843,0.0017,0.0027
17188,77014,59826,13290,2144858451.9968,1529770332625565679.705,59827,7.001,0.0028,0.0013
7662,87029,79367,9279,2147595983.4744,1539416616371965505.2734,79368,3.3236,0.0014,0.0014
29876,53885,24009,12595,2149525004.5797,1546875452137619452.2842,24010,5.1745,0.0025,0.0039
15826,103963,88137,26877,2145028245.1975,1545793001092114824.3716,88138,14.3408,0.0031,0.0019
31705,60732,29027,3669,2141646147.9724,1540948411276723040.3995,29028,4.2841,0.0038,0.001
13281,75206,61925,16496,2144935793.1774,1533271116579056271.7745,61926,3.5062,0.0024,0.0012
15609,34074,18465,14881,2149651291.4939,1553091247832700732.1068,18466,11.9815,0.0044,0.0061
32405,112278,79873,12284,2136290421.3798,1535423948617033861.7354,79874,19.8273,0.005,0.0001
31023,107666,76643,11623,2163837765.2055,1536613560868293530.9923,76644,23.1594,0.000,0.0066
1885,41458,39573,14100,2147353447.2058,1546261390856550687.5025,39574,23.6614,0.0032,0.0033
9589,62862,53273,30070,2144439166.9916,1546261790006694017.6814,53274,6.4373,0.0038,0.0025
27832,68472,40640,18886,2138798293.6417,1535769961683809471.7024,40641,10.0259,0.0047,0.0003
12090,95865,83775,25304,2140861616.047,1538953492053320809.5291,83776,5.785,0.0029,0.000
762,35481,34719,9473,2151421872.6189,1533124215106852526.4137,34720,3.9175,0.003,0.0042
16645,109423,92778,31845,2155635069.2391,1531597034480903310.6168,92779,21.3963,0.0006,0.004
8721,48500,39779,26596,2138666444.8174,1534265673570730033.7912,39780,5.3184,0.0045,0.0009
25792,123889,98097,9321,2143257553.4393,1542039924904662398.2465,98098,5.9822,0.0028,0.0002
6781,30928,24147,17158,2142361209.9207,1540349186951932961.3309,24148,1.6955,0.0031,0.0005
1678,98308,96630,8934,2149726658.0914,1550226951468458334.7594,96631,6.7962,0.0021,0.003
19021,19517,496,25129,2104374133.4608,1602108412850341792.3692,497,5.9664,0.0333,0.0184
19495,59422,39927,16101,2145292785.9508,1537369434976712157.5455,39928,6.3302,0.0031,0.0017
2284,56799,54515,29275,2145097641.959,1534206799959881674.4817,54516,2.0245,0.0023,0.0009
3840,20263,16423,29842,2169967641.3003,1527300070325034864.5628,16424,10.4536,0.0021,0.0104
19600,70044,50444,14502,2147121045.3348,1522289268672592241.6137,50445,15.3012,0.0043,0.003
21423,76444,55021,24918,2156348097.6855,1530087520809895073.6041,55022,28.7661,0.0009,0.005
7297,37158,29861,10503,2141720555.8191,1539325470614109427.4562,29862,6.0223,0.0053,0.0027
26690,83497,56807,5343,2148301854.2464,1535529985978002560.8449,56808,1.388,0.0016,0.0022
2740,55063,52323,1449,2145981330.5755,1530814283101636437.8423,52324,9.958,0.0023,0.0022
25774,51544,25770,8544,2142149541.6018,1535066610893311283.8486,25771,3.7293,0.0039,0.0013
27761,101596,73835,13435,2150457086.1134,1534026430800625590.5586,73836,7.5214,0.0012,0.0024
13486,93962,80476,18805,2145901711.0467,1543826968458710865.6999,80477,11.376,0.003,0.0018
15896,54227,38331,30670,2146528777.1446,1535613974017827617.5216,38332,3.5659,0.0023,0.0025
13160,57472,44312,18557,2153523746.7925,1546226663639480515.0849,44313,6.1815,0.0011,0.0043
10213,58692,48479,32231,2143054004.403,1531402963827465861.9706,48480,8.3783,0.0034,0.0007
25972,62545,36573,21928,2149411312.0481,1533317525455302609.3759,36574,9.4793,0.0033,0.0026
13243,78202,64959,28585,2160103305.6517,1542536963465520950.8871,64960,11.2785,0.0004,0.0062
7110,87924,80814,8046,2149891298.3796,1531121907228005646.7595,80815,3.8436,0.0011,0.0023
10291,10683,392,1954,2048763895.4631,1438824724781153387.124,393,7.2241,0.0578,0.0115
19124,57730,38606,8580,2149292883.6854,1536457726551730710.1912,38607,4.2205,0.0018,0.0033
2435,59201,56766,20700,2148691202.2747,1539494941372286321.3087,56767,4.1817,0.0015,0.002
19786,69190,49404,27399,2151070586.35,1536083557118047988.473,49405,9.6373,0.0015,0.0039
26762,107616,80854,2835,2156792791.1123,1521369961187015375.9851,80855,36.0773,0.0008,0.0055
11435,56474,45039,23705,2144060700.8968,1524514587151627871.2013,45040,9.805,0.0043,0.0028
27696,48358,20662,27938,2150637900.7944,1526549882567039109.271,20663,6.6563,0.0027,0.0041
31799,69932,38133,22167,2153857227.4238,1539429921889503900.8903,38134,7.121,0.0013,0.006
11286,99751,88465,4579,2149276123.0461,1534240892914545091.6866,88466,7.9882,0.0015,0.0023
32667,83786,51119,20470,2150506504.2944,1539517002719786818.6268,51120,5.9498,0.0019,0.0024
31037,86666,55629,21310,2162218984.2063,1544050849372022624.4673,55630,11.6503,0.0003,0.0054
15697,74358,58661,20380,2153982679.1946,1542440574151982100.1277,58662,6.6937,0.0009,0.0035
19897,55881,35984,397,2141707578.5901,1529075572898166395.9735,35985,12.378,0.0046,0.0023
3260,59922,56662,26702,2140039037.0431,1536048138000139385.0828,56663,5.0991,0.0035,0.0004
6429,74422,67993,426,2143035633.6038,1536045118595902554.0461,67994,4.0839,0.0032,0.0004
25748,69469,43721,25877,2141336826.0862,1530661230812111062.6202,43722,11.9747,0.0043,0.0014
4566,93269,88703,18745,2151883562.6717,1537316149858991253.437,88704,3.7381,0.0002,0.0022
27343,58502,31159,29244,2153189142.5999,1528807379359322906.1191,31160,8.2507,0.0024,0.006
27267,53519,26252,62,2158623220.0995,1530337357998383090.0741,26253,15.8974,0.0019,0.0061
10910,106205,95295,15028,2145127184.7277,1539562910128911728.2136,95296,7.2976,0.0022,0.0012
10340,83965,73625,598,2154538475.9051,1533800114277825677.9512,73626,4.5318,0.0003,0.0034
3755,90863,87108,12115,2157267392.6389,1540102883569525497.2085,87109,9.6156,0.0002,0.0044
19934,77596,57662,23856,2138614106.8766,1544798261552077073.9676,57663,10.9582,0.0049,0.0004
21145,29334,8189,3052,2162489786.2336,1501275598582329149.8476,8190,8.998,0.0052,0.0118
29856,108651,78795,28022,2137780057.8043,1544273081520854411.9889,78796,11.3131,0.0043,0.0006
8232,90516,82284,31314,2148151323.0325,1534420506735822519.5233,82285,13.130,0.0015,0.0027
15441,19476,4035,7926,2131892814.4435,1558715024589265026.3984,4036,8.035,0.0148,0.0041
28932,49070,20138,2492,2156485020.9633,1539752514451999360.2713,20139,9.1273,0.0008,0.005
16658,70321,53663,23391,2136550484.0188,1540947348085073613.8628,53664,9.9574,0.0044,0.0005
27396,35959,8563,7813,2137762519.5514,1548947701560761157.5841,8564,4.4441,0.0084,0.0043
21299,118861,97562,31368,2144860712.866,1534077772467947995.4653,97563,11.3477,0.0029,0.0013
16489,61531,45042,28608,2137897203.7011,1542161997139760551.8857,45043,10.1058,0.0055,0.0009
21864,26514,4650,25066,2095145856.2978,1539527767553213663.3069,4651,12.8968,0.0192,0.0002
3350,83165,79815,23397,2143436436.6813,1535105830866374881.6114,79816,10.1281,0.0036,0.0012
7588,17128,9540,14220,2128871116.1189,1530475381854597156.9424,9541,6.9052,0.0094,0.0001
1358,65132,63774,4968,2145178822.5034,1542903415673234828.3479,63775,24.4375,0.003,0.0024
22945,39063,16118,6287,2137593047.9283,1529071983280041568.2407,16119,9.7032,0.0065,0.0023
5314,77521,72207,30731,2142016499.6396,1544435990177362656.0843,72208,7.4561,0.0031,0.0012
18517,102077,83560,31644,2146476525.6738,1531109983311360134.619,83561,7.4931,0.0021,0.0019
4650,36288,31638,9983,2138339986.4433,1543704758317281235.8377,31639,6.334,0.0045,0.0013
22306,48172,25866,13109,2150053989.1078,1542228331930104835.175,25867,9.197,0.0026,0.0049
8010,98688,90678,24233,2149555081.1265,1547668806055391745.1416,90679,11.3306,0.0021,0.0027
231,40021,39790,27090,2139870662.5507,1550983578425718980.3842,39791,11.1357,0.0053,0.0017
32074,128004,95930,24177,2149479427.3674,1532963118116669199.8688,95931,13.947,0.0012,0.0023
3338,84376,81038,12878,2148552452.2516,1534046604758052666.6235,81039,15.4786,0.0016,0.002
18125,111182,93057,32606,2143859998.1438,1524214995133697981.1334,93058,14.7872,0.0036,0.0023
4409,54986,50577,29407,2134994044.1895,1538695830995205551.4806,50578,9.7603,0.0051,0.000
11231,97883,86652,6035,2133295013.4894,1539367597269759117.9527,86653,25.9729,0.0068,0.0001
31582,75355,43773,2687,2146113315.5434,1543959611432454863.474,43774,9.0915,0.0036,0.0026
14269,54168,39899,2009,2143574313.8908,1527377481819254056.5641,39900,6.7528,0.004,0.002
27337,78901,51564,21764,2147646499.2833,1532331459225496147.9677,51565,3.5942,0.0018,0.002
6701,89563,82862,20623,2141616033.2288,1538099311901960824.393,82863,10.1462,0.0033,0.0004
3801,59825,56024,29463,2159462250.602,1532430381725523212.5676,56025,14.231,0.0001,0.0053
16307,46052,29745,23778,2161226220.5557,1541132176522895338.5771,29746,9.295,0.0004,0.0058
7999,46005,38006,14194,2149715376.8263,1536002228803727315.6299,38007,0.7122,0.0014,0.0022
30794,46900,16106,3493,2160580277.4155,1523976445392491521.9341,16107,8.3006,0.0026,0.0066
4726,12345,7619,22624,2138369391.4433,1513668081825084874.6814,7620,4.6069,0.0094,0.0044
11960,87884,75924,20503,2149343074.5581,1542106932613025890.6132,75925,5.1731,0.0011,0.0019
26463,87510,61047,18338,2158936301.1645,1536449144432238385.3475,61048,23.5411,0.0004,0.005
2277,47172,44895,8859,2158410348.2698,1545236693762042076.1293,44896,6.0697,0.0003,0.0063
10778,13260,2482,17659,2146223282.1933,1528087389518260514.9034,2483,3.911,0.0108,0.0102
22694,29213,6519,16559,2125317818.0595,1530688372211288118.1259,6520,5.8664,0.0125,0.0026
28759,49866,21107,12985,2149533074.955,1543187992372163609.2037,21108,6.3993,0.0017,0.0033
12429,107004,94575,20820,2151109304.6893,1544097713878406268.237,94576,7.7779,0.0009,0.0026
14162,61246,47084,17902,2141981088.65,1533260083429757361.7148,47085,9.2295,0.0034,0.0014
21709,72276,50567,8407,2131969840.0259,1550935765655750260.7047,50568,35.5252,0.0077,0.0001
10467,36796,26329,8717,2150222937.8951,1531047758031047466.528,26330,5.5296,0.0031,0.0037
24140,86353,62213,7394,2140665536.2243,1537408715392228405.3938,62214,6.0338,0.0036,0.0006
22617,92180,69563,31676,2142355763.8281,1534231963887976323.0508,69564,6.0264,0.0029,0.0006
6819,67055,60236,5040,2137748443.6505,1541347784558199319.2131,60237,7.1813,0.0055,0.0005
23262,50843,27581,19956,2150913956.9743,1524520760352883457.4128,27582,21.8236,0.0033,0.0053
11311,58028,46717,30965,2138317790.868,1533930227165481233.3424,46718,7.9743,0.0048,0.0009
21417,89641,68224,11872,2150798001.7711,1536602946193644635.4726,68225,2.6512,0.0004,0.002
22902,120082,97180,9506,2142329162.1732,1537863871085672053.7926,97181,8.2432,0.003,0.0005
1805,46450,44645,13877,2139031802.1206,1544092779275050529.4504,44646,14.1061,0.0041,0.0007
31967,72990,41023,22783,2137960764.5109,1531869672461809804.7163,41024,5.8153,0.0042,0.0005
27403,107490,80087,28672,2142936654.8389,1544556360136135631.5788,80088,13.681,0.0031,0.0014
19793,48695,28902,8503,2140521818.2441,1535373996690273872.6001,28903,12.4762,0.006,0.0032
16304,92610,76306,29467,2154540008.1702,1544596487152898890.8836,76307,7.271,0.001,0.0046
19198,59019,39821,12294,2142738301.4222,1529849441436027652.725,39822,6.5718,0.0035,0.0018
11304,90486,79182,17828,2141457025.6616,1544898502005799265.1154,79183,14.1504,0.0042,0.001
27149,99081,71932,11756,2151173068.4976,1538588982433259133.056,71933,3.6987,0.0004,0.0019
16209,54060,37851,539,2143248478.0751,1548787541509186052.8406,37852,14.836,0.004,0.0027
28619,84448,55829,16870,2149134494.2003,1531516319057920174.9644,55830,6.2372,0.0015,0.0025
2127,18127,16000,6461,2129403928.8391,1541252648285741102.7652,16001,7.0778,0.009,0.0006
19045,43324,24279,23978,2154842331.8051,1532137114428945016.0548,24280,6.2452,0.001,0.0053
28031,64557,36526,2788,2138889163.3923,1537986165180230513.8373,36527,14.2897,0.0041,0.0011
14055,63149,49094,17039,2149911693.313,1532526280293442198.743,49095,8.4007,0.0013,0.0031
2450,41086,38636,3552,2155305011.131,1543470072694472596.3115,38637,7.1534,0.001,0.0059
4982,27343,22361,31357,2132333487.2805,1551655536155324329.1817,22362,16.8202,0.0079,0.000
69,47128,47059,24608,2140162069.1406,1541475022035205172.0474,47060,8.8417,0.0038,0.0005
7206,28854,21648,11113,2138489396.4623,1547119512113692148.6179,21649,9.7871,0.0047,0.0006
6805,63467,56662,20176,2156280067.4141,1542643998898370150.6665,56663,7.6956,0.0003,0.0037
27954,119951,91997,16307,2153152247.1366,1527915054685415615.4064,91998,7.8522,0.0012,0.0034
22071,113692,91621,4038,2153109144.5009,1537668911379756260.4377,91622,4.0581,0.0007,0.0027
12811,94480,81669,17709,2150449549.4133,1533793289750613619.3331,81670,9.331,0.0012,0.0028
19863,118219,98356,13395,2155891979.3242,1544250067908024937.8547,98357,15.6646,0.000,0.0042
23022,74976,51954,28771,2150282930.9353,1540150451227387333.6184,51955,2.7278,0.0011,0.0021
8740,90707,81967,9691,2147911266.2152,1536741435078408034.6688,81968,8.3344,0.0014,0.0014
3942,26847,22905,12857,2157714065.8136,1528668202913737349.8986,22906,10.2244,0.0017,0.0068
28112,117717,89605,10507,2145317125.6952,1532207562002217765.8924,89606,2.8764,0.0021,0.001
28136,87003,58867,19569,2166913715.3333,1534381369996683335.9122,58868,36.1298,0.0001,0.0089
11420,87185,75765,21680,2144139500.4762,1538307024405035876.5897,75766,4.1609,0.0022,0.0002
17430,33898,16468,22214,2133096319.6264,1546618152123409360.998,16469,11.2139,0.0087,0.0031
3316,26471,23155,10923,2151381213.6458,1523805952195140129.3675,23156,19.0385,0.0037,0.0056
2776,64872,62096,15352,2148073378.4602,1529911500016679452.9944,62097,5.1307,0.0018,0.0022
23207,73897,50690,21702,2160751890.6723,1532674024039373281.9193,50691,10.7169,0.000,0.0051
13881,83161,69280,7007,2158039179.4561,1543833169177030518.6441,69281,16.844,0.0003,0.0069
19068,24670,5602,21928,2121074596.8194,1559895259000701468.9115,5603,17.2361,0.0116,0.0036
19732,65431,45699,9979,2152737315.107,1528160293617481127.9201,45700,4.8154,0.0013,0.0037
1771,73893,72122,30424,2144581175.9003,1537242537046247494.9622,72123,3.3752,0.0033,0.0012
14950,88776,73826,19755,2154079425.71,1535931057513550877.1171,73827,8.6941,0.000,0.0029
19,34857,34838,8344,2144411751.1221,1544377624319259348.5998,34839,4.7386,0.0037,0.0023
32459,109252,76793,3301,2153682574.9767,1533234777061393467.5974,76794,8.1307,0.0009,0.0038
24261,111595,87334,4851,2145603532.9993,1538303819534508842.5611,87335,1.9662,0.0018,0.001
18476,32249,13773,29465,2184696656.6114,1538491333211936060.7033,13774,24.7368,0.0007,0.0179
4659,16195,11536,8425,2147762314.2736,1543819022473596120.2663,11537,1.9345,0.0034,0.0041
19963,44990,25027,21217,2131307706.6171,1531553178946665381.6282,25028,7.3155,0.0069,0.001
30149,126320,96171,1719,2145809716.9474,1540467474319634089.0855,96172,10.932,0.0021,0.0017
13419,48626,35207,7748,2154258499.1414,1536480927547412683.9415,35208,5.6923,0.0017,0.0046
15135,74145,59010,12772,2141439096.5645,1532499644272282130.7692,59011,4.7877,0.0034,0.0007
11606,22727,11121,1839,2153915923.5838,1520060588659461203.7535,11122,3.4404,0.004,0.0058
18305,110798,92493,12693,2149869294.6132,1538663076160951101.4867,92494,3.3988,0.0006,0.0024
1800,61545,59745,30766,2158227879.5392,1531146864890046120.7952,59746,9.1222,0.0002,0.0044
28108,121345,93237,15535,2148221299.8437,1542354445625339614.8388,93238,17.431,0.0027,0.0029
10052,34288,24236,1804,2135366916.2754,1538644863733966540.7046,24237,9.7181,0.0064,0.0006
19719,109585,89866,14043,2157525218.2789,1538100022047332828.9938,89867,10.1473,0.000,0.0044
13948,101051,87103,25657,2148977342.558,1530346201665497962.2915,87104,11.7985,0.0024,0.0024
1456,58670,57214,13834,2138888070.8973,1546798538937970861.6121,57215,12.0054,0.0048,0.0011
29625,115751,86126,14888,2146054712.7365,1539222771255112640.4142,86127,4.5644,0.0014,0.0006
17424,89416,71992,12277,2158989411.3482,1534462845213613121.7994,71993,10.4533,0.0003,0.0053
11193,70323,59130,8580,2147192439.9446,1534613017506445652.2395,59131,3.7365,0.0021,0.0025
32751,88708,55957,32732,2148659484.4452,1539969117775001940.4563,55958,6.202,0.002,0.0022
8563,35704,27141,22356,2154883110.2852,1534392577839828145.8147,27142,7.2292,0.0012,0.0041
956,43086,42130,20242,2151437561.8775,1531583466043889858.3646,42131,10.8321,0.0022,0.0042
18199,70353,52154,3206,2146103164.4063,1540092461000141432.2893,52155,11.1447,0.0029,0.0026
3023,44045,41022,8317,2126671049.25,1533647516926649218.4781,41023,18.5227,0.0091,0.0006
10062,105752,95690,17582,2143484337.5572,1536878704828873045.6969,95691,4.8619,0.003,0.0005
15884,74636,58752,19523,2147145772.5019,1536749821461046729.3651,58753,6.3383,0.0031,0.0017
27860,41707,13847,5281,2137336999.9448,1518565370746877427.4617,13848,4.2389,0.0089,0.003
2881,52429,49548,1572,2147026764.4565,1548936287550291362.6953,49549,11.920,0.004,0.0028
21037,68972,47935,17803,2139896921.1395,1543825077348465922.2909,47936,11.8681,0.0047,0.0004
780,91662,90882,25500,2156195635.1647,1526311331485705745.1731,90883,24.1472,0.0011,0.0056
29289,47030,17741,29870,2124888411.9042,1544495440094408424.0595,17742,11.081,0.0091,0.0022
32590,59739,27149,1538,2169044014.3894,1535268472843516875.5802,27150,18.6086,0.0001,0.0088
16693,111810,95117,21971,2143222975.4272,1549895187765098518.912,95118,25.5181,0.0035,0.0014
25215,50551,25336,16016,2138842510.7439,1540807468734132400.7104,25337,6.8949,0.0055,0.0014
8421,40873,32452,16941,2143364736.6938,1544462006457476507.4425,32453,4.4112,0.0038,0.0023
17008,64757,47749,6346,2145794161.3947,1543301540809646806.5788,47750,14.2239,0.0051,0.0025
21432,29629,8197,6920,2142496215.9177,1523164088901945460.7528,8198,0.853,0.0055,0.0027
21568,121418,99850,32034,2141159901.2554,1542589678867985207.6983,99851,7.2071,0.0029,0.0007
26416,45777,19361,12016,2127117890.0022,1542773838623752528.7518,19362,12.4376,0.0079,0.000
21940,64143,42203,18506,2149012411.2388,1544335493968918044.7224,42204,3.8651,0.002,0.0032
9477,98138,88661,8454,2147112436.3959,1544931515010273649.9288,88662,11.0042,0.0021,0.0021
24315,103573,79258,29669,2150711102.4961,1532678063567371004.4188,79259,7.0732,0.001,0.0025
6281,59245,52964,8872,2136357258.8371,1540097168212719167.2906,52965,8.3838,0.005,0.0005
2989,9619,6630,23345,2135707586.8404,1522721818916793972.5832,6631,12.4558,0.0128,0.0062
13971,102868,88897,15815,2145457710.8315,1531966006166163533.9292,88898,8.7763,0.0023,0.001
4817,73776,68959,10798,2152554255.6383,1536340441301691307.2963,68960,3.4723,0.0003,0.0025
29609,70811,41202,8621,2146386024.1594,1525451251614013226.6717,41203,10.0676,0.0034,0.003
1877,98720,96843,15254,2142799834.4769,1541017065045204410.2275,96844,8.2228,0.0022,0.0003
18499,117657,99158,26788,2148909008.0885,1530942322824841182.9362,99159,10.6273,0.0022,0.0024
9143,20151,11008,706,2161197620.0288,1539422009254385417.9061,11009,12.7811,0.0017,0.0095
27354,87220,59866,14421,2147574759.2086,1539496255037520163.837,59867,7.3538,0.0028,0.0014
31009,43569,12560,17134,2158477977.5063,1549950473510855378.7568,12561,8.5434,0.0029,0.0087
14215,70484,56269,21444,2152418749.9888,1530826306281341586.1571,56270,4.9289,0.0019,0.0029
4136,62017,57881,2522,2139440183.7387,1543387480075271099.9823,57882,10.5775,0.0035,0.0008
29545,88957,59412,5071,2153190002.6377,1541872146084906236.4546,59413,11.8715,0.0008,0.004
12648,94248,81600,31364,2145749079.9443,1536730120198526575.7412,81601,9.3866,0.0018,0.0016
7440,31280,23840,24187,2163277630.4032,1536972218140251916.4849,23841,7.1097,0.0009,0.007
31830,39596,7766,17927,2155939882.6471,1521461434938470799.4855,7767,24.6666,0.0049,0.0095
13323,82506,69183,26669,2138920437.487,1544058064095380983.2471,69184,20.8067,0.0042,0.0001
8055,39367,31312,6827,2146921418.2188,1539689572740553653.12,31313,8.9329,0.0028,0.0025
8773,17328,8555,13654,2118334625.0418,1519097043586087479.9905,8556,7.1978,0.0153,0.0008
25920,89552,63632,10760,2136720340.8883,1536148981929199996.9509,63633,11.9711,0.0053,0.0003
16730,28038,11308,10844,2140454945.9731,1555237472628076593.9031,11309,7.8095,0.0072,0.0023
10413,70466,60053,8470,2136335043.1244,1534553682944654302.9676,60054,18.8917,0.0047,0.000
25117,123956,98839,14456,2145843725.2776,1544125881745223091.6673,98840,6.4025,0.0022,0.0017
29721,43648,13927,22024,2121956681.9227,1547330547373097230.4125,13928,11.4226,0.0096,0.000
26165,69865,43700,20697,2147761317.0525,1536768744579235327.4501,43701,1.0295,0.0015,0.0013
30474,81744,51270,32144,2137644217.767,1519356251250601960.833,51271,15.1281,0.0065,0.0017
8587,83379,74792,1358,2157227910.4978,1532449830893196774.2775,74793,8.7905,0.000,0.0043
31217,86953,55736,4627,2143943810.543,1532582532210316331.349,55737,9.6133,0.0025,0.0015
15079,113265,98186,24067,2149476137.6784,1534905831005033654.0538,98187,9.1446,0.0011,0.0016
17283,17989,706,27575,2235006518.4427,1604509116259717669.1802,707,7.2155,0.0048,0.0368
4542,103542,99000,2610,2149351076.2501,1541267722391953010.1217,99001,3.6631,0.0013,0.0022
8825,75231,66406,23659,2149635460.5788,1538884408660960890.368,66407,7.2575,0.0016,0.0031
5267,103308,98041,6543,2154651612.9542,1533804435621271240.6687,98042,8.5714,0.0001,0.0041
14136,113326,99190,7162,2136116964.5446,1531527845283012150.6898,99191,25.6627,0.0059,0.0007
29013,106551,77538,17355,2148582839.9219,1541349950682540325.9409,77539,10.5499,0.0015,0.0021
25940,99097,73157,13817,2137240149.9469,1539808799131333756.7202,73158,14.6811,0.0049,0.0004
11487,77135,65648,16066,2145575492.7615,1543333890108447820.2233,65649,11.7484,0.0023,0.0015
30116,105722,75606,1933,2148058233.9528,1538247412802019558.3154,75607,4.3817,0.0014,0.0016
22942,72660,49718,18923,2127958171.9799,1538171406631965497.0478,49719,24.2758,0.0068,0.000
15335,83244,67909,31497,2149887229.9882,1536316911061852133.0412,67910,2.8991,0.001,0.0023
13973,85842,71869,15380,2139875257.7946,1533775865902152164.946,71870,13.9132,0.0041,0.0008
25351,121710,96359,8865,2142208629.1189,1535732366394324703.5495,96360,10.0613,0.0031,0.0004
7176,25502,18326,29247,2166811726.8539,1513348198311160483.5735,18327,28.5548,0.0017,0.012
11033,29527,18494,20169,2143789608.1012,1522750425495146536.2687,18495,17.4011,0.0052,0.0042
14212,72945,58733,3666,2141874401.7895,1535042670348907959.8496,58734,4.2728,0.0033,0.0004
22475,79256,56781,1507,2133357016.2171,1534793836817800338.9872,56782,11.6421,0.0058,0.0001
8319,74108,65789,12979,2152102210.3386,1539639371987934586.5562,65790,12.3209,0.0009,0.0032
20486,41349,20863,22889,2131307643.684,1546486176739623160.4247,20864,9.0947,0.0085,0.0001
12638,104512,91874,26641,2152059622.8391,1530206098683229552.2567,91875,6.5719,0.0007,0.0033
22120,100066,77946,6722,2147999331.9312,1534464836948635774.4714,77947,7.2641,0.0016,0.0022
1203,72884,71681,22904,2147148759.5437,1543588880421986406.364,71682,7.3129,0.0017,0.0018
8379,95246,86867,6141,2133636152.0831,1531897949974105035.9335,86868,26.6212,0.0052,0.000
267,50746,50479,7498,2160246727.8455,1536767729662422977.2761,50480,14.6064,0.0008,0.0057
16942,68326,51384,678,2152579246.4568,1539795558884139318.4307,51385,9.422,0.0009,0.0036
7856,102498,94642,30566,2144609514.2163,1528916958630386043.6341,94643,11.0499,0.0029,0.0017
27854,29710,1856,29722,2154320902.1939,1500132877375974463.2904,1857,4.1076,0.0114,0.0115
12635,102451,89816,5828,2159609228.6579,1538856477166226884.2326,89817,13.4114,0.0001,0.0046
28823,94744,65921,27918,2151255571.1065,1535565882903689195.0698,65922,4.0992,0.0009,0.0028
20992,100522,79530,7811,2150070848.1961,1532040233189072187.2205,79531,6.2278,0.0011,0.0019
25224,75172,49948,9728,2146411300.5934,1540425352836067296.512,49949,7.198,0.0022,0.0019
27507,46600,19093,28464,2149830287.196,1540069320480398404.6618,19094,23.8895,0.0062,0.0044
30617,99724,69107,2692,2158494214.4347,1535684713939722496.4252,69108,15.8156,0.0004,0.0048
4436,65435,60999,27391,2146262182.3944,1536411636775981039.1573,61000,3.3694,0.0027,0.0018
26303,88896,62593,10749,2150484249.9804,1540687838900182061.5218,62594,6.5763,0.0014,0.0028
23373,75490,52117,31146,2155487379.7398,1536035155093849829.9568,52118,9.5358,0.0012,0.005
17061,110497,93436,31795,2142245505.3745,1537416246026247572.3024,93437,3.0756,0.0028,0.0004
16137,29174,13037,4790,2125176711.0677,1570858944606270551.5931,13038,19.8254,0.0114,0.0057
13347,38649,25302,5695,2148350202.4639,1539930883005756657.7404,25303,5.4411,0.0023,0.0039
17495,101792,84297,24862,2150602732.4135,1545200366562779887.4228,84298,8.5753,0.0014,0.0032
9360,34141,24781,4372,2159443886.4851,1534570033494387668.4153,24782,8.4008,0.0012,0.0075
26488,66919,40431,11085,2135290281.9005,1552340173425915545.0924,40432,17.9942,0.0062,0.0018
5091,67633,62542,23851,2149526721.5533,1534642361043749027.8598,62543,14.5144,0.0025,0.0032
31571,91770,60199,14218,2129103253.5542,1531930544104856120.6912,60200,24.412,0.0079,0.000
29563,122018,92455,19347,2150087681.0018,1535475067887903450.9449,92456,6.117,0.0007,0.0019
16394,87725,71331,28446,2147056662.3036,1532858050264341501.158,71332,10.7469,0.0037,0.003
27319,89481,62162,23133,2158232766.0676,1537325546868386101.7132,62163,16.5347,0.000,0.0049
13810,61715,47905,21806,2162540115.7552,1536113526544359400.4762,47906,13.0665,0.0001,0.007
65,76789,76724,28307,2146310515.4503,1543272390936870755.0672,76725,4.638,0.0022,0.0016
14215,67223,53008,16942,2149345521.6093,1538413841367276363.6308,53009,8.7832,0.002,0.0032
3667,70199,66532,5935,2143518765.1572,1537810418028662420.6891,66533,6.9403,0.0035,0.0009
24812,36972,12160,31414,2138952017.9273,1523418646296728231.798,12161,8.2997,0.0096,0.0035
25442,53073,27631,4455,2162744031.6285,1534994516498076190.3944,27632,10.293,0.0012,0.0087
14281,23343,9062,12092,2140500254.5276,1532173647321531322.9461,9063,7.6069,0.0064,0.0035
12199,47058,34859,18076,2159302092.1593,1540761702792638893.055,34860,5.6359,0,0.0047
18730,104045,85315,1579,2159959571.2704,1533658065154453454.1561,85316,21.1686,0.000,0.0056
12026,24506,12480,24340,2140826471.102,1546600433159022718.9808,12481,16.6356,0.0097,0.0035
29837,93069,63232,1979,2154509446.3773,1538600142918359590.4047,63233,6.0306,0.0012,0.0042
21531,101413,79882,27854,2150157773.2928,1540077465859663119.1039,79883,9.4178,0.001,0.0022
5306,8208,2902,25629,2161514052.1605,1530949287011999374.4503,2903,7.3259,0.0059,0.0159
23251,121200,97949,11878,2146272055.7951,1536986237287391724.2418,97950,19.1851,0.0021,0.0035
28977,88437,59460,27117,2141913871.9959,1534484083233585109.7964,59461,7.4464,0.0041,0.001
6529,67975,61446,10500,2131260640.7029,1534209955473892436.2479,61447,15.5773,0.0068,0.0003
29656,31579,1923,5862,2131373042.7765,1504287375415662480.7744,1924,7.1081,0.0165,0.0083
7547,52715,45168,6851,2144118469.4507,1541891904411218610.5876,45169,17.3134,0.0034,0.0011
20895,60111,39216,30854,2161866406.157,1522625178640948128.2514,39217,27.1492,0.0006,0.0073
24923,120604,95681,31450,2152568733.3242,1542479833201097445.917,95682,9.4168,0.0009,0.0042
20859,67337,46478,13010,2141039698.3194,1542963309194066389.1396,46479,8.8702,0.0036,0.0018
16310,36181,19871,5612,2133955278.3213,1550260274213755322.735,19872,11.2871,0.0066,0.0011
32230,121986,89756,18319,2142483200.2383,1539521817682534244.7257,89757,9.4415,0.0024,0.0003
19057,49825,30768,4631,2140351047.1213,1542296089662997124.4053,30769,7.8565,0.004,0.0014
24655,122613,97958,14504,2139988239.1191,1540456486034367168.0576,97959,9.1847,0.004,0.000
16496,35126,18630,16473,2144655529.316,1541286711181707107.6167,18631,3.1875,0.0029,0.0018
24133,93422,69289,12415,2143979858.6711,1529760731829206154.9785,69290,13.4946,0.0034,0.0021
846,12791,11945,12201,2151327829.6534,1568195596867906305.0616,11946,24.7114,0.0074,0.0081
8099,51752,43653,19592,2132891419.0385,1537609847583721734.1176,43654,13.1244,0.0066,0.0005
6697,64195,57498,17089,2160586280.6281,1530338483247005848.3617,57499,21.2662,0.0001,0.0051
27287,105674,78387,8236,2145483445.3161,1533339575037304776.596,78388,7.1429,0.0022,0.001
312,79192,78880,23665,2159687477.1533,1530959696481786872.1336,78881,18.4989,0.0006,0.0062
9182,88303,79121,6192,2156286092.7998,1538406167066014253.799,79122,7.2411,0.0005,0.0056
12411,64850,52439,9221,2127019585.5613,1539324379296300133.6558,52440,21.3588,0.0071,0.000
29974,80285,50311,12350,2143520846.6286,1536628297298203625.3823,50312,7.5077,0.0042,0.0024
2293,56444,54151,23424,2150572640.9433,1539539370842285871.2771,54152,8.1058,0.0019,0.003
23216,54883,31667,1908,2151848380.3902,1535308114457143751.9433,31668,2.8352,0.0015,0.0038
3100,16206,13106,20763,2177437763.0538,1533476068592440923.7955,13107,19.0213,0.000,0.0121
741,27138,26397,16455,2148492954.5251,1535413074458456551.3268,26398,7.6708,0.0028,0.0049
15525,90931,75406,16802,2133838971.0871,1529186297691496787.4318,75407,25.1066,0.0058,0.0002
16505,73041,56536,27882,2148242555.7663,1532430286763989898.634,56537,11.8388,0.0021,0.003
16411,69271,52860,19129,2144032526.716,1540465581087870073.4922,52861,11.8188,0.0032,0.0013
28381,90088,61707,6360,2159311457.3029,1537605347327290020.1417,61708,14.5991,0.0003,0.0048
19396,45572,26176,21160,2138150996.3476,1537714629853368494.5051,26177,3.6793,0.0057,0.0007
28304,50944,22640,612,2134175423.0804,1555277514013820603.3005,22641,13.7838,0.0087,0.0019
16773,100153,83380,10996,2143671699.8544,1538703889067625393.3952,83381,7.4521,0.003,0.001
11715,46372,34657,14719,2145853559.7211,1526564816096466040.6009,34658,10.589,0.0039,0.0033
27964,67674,39710,13244,2142918682.2567,1545870781194387551.7771,39711,4.0497,0.0036,0.002
6952,104407,97455,14949,2135202042.4726,1537403913501371871.175,97456,14.175,0.0051,0.0003
28607,96229,67622,14554,2154230936.6051,1530655197413737944.5052,67623,8.3723,0.0005,0.0046
9185,40808,31623,18760,2166051555.3558,1530229771615770472.639,31624,13.8189,0.0009,0.0091
29230,42968,13738,22986,2170230853.9577,1535003662009435860.18,13739,14.291,0.0004,0.0118
77,53474,53397,1136,2147082976.3564,1539026946659147009.6849,53398,4.7468,0.0014,0.0012
3698,92155,88457,11671,2158657921.3565,1528691208288536400.8693,88458,21.4823,0.0002,0.0051
25260,83067,57807,14269,2147677322.2916,1538299438152511484.3203,57808,9.9871,0.0018,0.0018
31921,68537,36616,29422,2133376357.2261,1528491742186238377.7149,36617,14.5448,0.0061,0.001
15981,102755,86774,7143,2139132546.6698,1542207148673733620.6394,86775,15.9509,0.0031,0.000
6574,71389,64815,18597,2142726854.7027,1538896009948677614.1208,64816,3.479,0.0029,0.0006
31564,113785,82221,32156,2163845381.2137,1539588476629847553.122,82222,19.169,0.0002,0.0059
13158,85303,72145,18656,2146548515.0406,1534372226202611101.0493,72146,7.1017,0.002,0.0014
12142,62559,50417,6541,2142257146.0938,1538783050202163525.9077,50418,8.6793,0.004,0.0009
21153,53404,32251,3757,2170934272.5944,1547627199309710034.1737,32252,17.329,0.0005,0.0088
9443,51441,41998,3078,2162190276.4178,1543334980581712557.672,41999,13.7865,0.000,0.0073
1148,34328,33180,2388,2149644979.6538,1539700624314800594.6935,33181,12.0185,0.0029,0.0039
15058,67169,52111,21217,2143199192.7963,1528710164889229029.4269,52112,7.6681,0.0029,0.0021
23890,42480,18590,24288,2139533805.7641,1543096619992953176.3923,18591,6.4651,0.0065,0.0025
3474,99723,96249,13806,2159265576.8733,1545562427696054148.6611,96250,13.7678,0.0005,0.0052
24402,66587,42185,15462,2149263966.505,1535354722371402167.9621,42186,1.8819,0.0015,0.0027
6005,79524,73519,22408,2140086578.6926,1533077655376686035.6347,73520,7.1759,0.0032,0.0001
21317,42161,20844,8931,2142880391.051,1524465311233358213.6958,20845,6.0701,0.0044,0.0028
9937,51703,41766,2062,2157278314.6671,1528865969748869088.3254,41767,7.7801,0.0003,0.0052
10406,96074,85668,23172,2142835438.3639,1543997113448830934.3547,85669,12.8403,0.0027,0.0008
17108,24889,7781,6296,2158101299.0014,1536239371632157049.3306,7782,4.2428,0.0035,0.006
17364,86824,69460,17912,2150300043.3346,1535171124153676774.9637,69461,3.3787,0.0006,0.002
25667,56282,30615,14134,2146982191.5549,1525509093812924335.8921,30616,14.382,0.0027,0.0046
28893,98061,69168,1552,2151269055.0685,1544539216138393240.302,69169,8.2532,0.0016,0.003
11146,66207,55061,7250,2152801902.022,1534107355574233526.2469,55062,6.6278,0.0005,0.0034
32198,107149,74951,4945,2141552041.3732,1529636331042664914.4892,74952,6.0658,0.0037,0.0006
27736,114107,86371,23450,2141832128.444,1541128996261558098.8039,86372,6.0086,0.0033,0.0004
3906,71325,67419,24290,2152162053.2398,1540191136601869260.1775,67420,15.0555,0.0019,0.0033
31822,36204,4382,15627,2162360681.9676,1556242968385650135.9634,4383,10.3286,0.005,0.0116
19707,21218,1511,6514,2106258849.5635,1515431688500495105.1666,1512,13.1401,0.0258,0.006
24279,89617,65338,6990,2162875956.3108,1532753532122745762.6866,65339,18.3513,0.0001,0.0059
29995,68233,38238,9814,2140957694.6016,1541364068158694715.6355,38239,7.1073,0.0041,0.001
1594,13232,11638,2653,2157192370.5581,1529308436204576244.9463,11639,10.3837,0.0029,0.008
8313,99934,91621,15516,2154076321.3764,1545399124878676760.1472,91622,6.0487,0.0005,0.0033
19677,75412,55735,24859,2148208890.4792,1545159601460676439.6216,55736,10.8138,0.0023,0.0022
4115,18300,14185,2500,2150151244.3541,1519602422075945668.687,14186,4.7452,0.0028,0.0058
31623,118431,86808,12489,2138533285.87,1546372819341236860.8457,86809,19.5451,0.0047,0.0008
8663,21539,12876,23640,2131562420.192,1547476819229128544.7334,12877,6.711,0.0086,0.0004
26944,121468,94524,12783,2142817382.922,1534147393817507485.8766,94525,5.5176,0.0028,0.0009
28565,94503,65938,21974,2141882655.2372,1523409905723527509.3435,65939,12.8701,0.0046,0.0016
9449,46532,37083,29353,2133964582.3877,1544615309596335259.3442,37084,13.4429,0.0069,0.0002
27075,113076,86001,9484,2153969437.7393,1538283924398201412.805,86002,6.1935,0.0002,0.0028
4065,18486,14421,12583,2140049327.9682,1546127323963377300.5506,14422,8.5027,0.0093,0.003
18209,71929,53720,26474,2132071057.4582,1528269560322545801.4937,53721,16.0035,0.0063,0.0001
1061,29306,28245,29269,2150259660.3434,1549784154532268205.1384,28246,3.668,0.003,0.0039
21981,92545,70564,32198,2154337741.0851,1545316535436644701.6815,70565,8.8379,0.0008,0.004
9283,76047,66764,30791,2151735077.4371,1539389782696613956.3004,66765,19.2158,0.002,0.0031
17539,73627,56088,21130,2137383293.8877,1536949446727329280.0719,56089,10.0819,0.005,0.0007
1044,89995,88951,28991,2140111832.1488,1544860283826002972.2953,88952,16.8573,0.0048,0.0005
9294,41299,32005,9075,2160866982.7438,1536569981982431722.079,32006,17.0378,0.0004,0.0076
5793,35855,30062,195,2159611472.8214,1535236083461332106.8739,30063,4.8101,0.0013,0.0069
17514,63073,45559,11886,2148772141.7174,1538992774784810150.5557,45560,6.2603,0.0016,0.0025
29796,109383,79587,28523,2151637032.1177,1527557904484356502.8639,79588,3.9917,0.0016,0.0032
14352,27221,12869,21698,2156827220.2695,1555540762706214398.0967,12870,11.4472,0.0032,0.0072
20856,21706,850,26968,2200188760.436,1624973329295224312.9956,851,9.5844,0.0143,0.0364
20244,98474,78230,27160,2151244426.7195,1537036929189965453.3981,78231,10.2862,0.0008,0.003
8816,48886,40070,13509,2150082567.683,1546515372300320790.5641,40071,6.9877,0.0027,0.0038
16713,96165,79452,17305,2135537592.9867,1538648465677112832.1517,79453,11.2235,0.0044,0.000
15747,85375,69628,11452,2153100487.2199,1544164636070365255.4891,69629,10.5883,0.001,0.0038
2234,26368,24134,18511,2153896127.1541,1539711575725939010.053,24135,8.1034,0.0019,0.0057
23453,24016,563,20593,2131810671.3865,1503698126494349665.9676,564,5.2028,0.0199,0.016
28932,38124,9192,5515,2162968561.7839,1512268109438064361.8135,9193,10.4093,0.0029,0.0106
30942,55164,24222,1106,2139292397.2688,1555127801965928749.7797,24223,13.596,0.0074,0.003
30971,96663,65692,31649,2158955766.0895,1536068511078454370.3672,65693,11.1216,0.000,0.0044
17102,54870,37768,15472,2148820187.2596,1542166036448072224.9579,37769,4.995,0.0026,0.0028
9228,65704,56476,24241,2151521306.2818,1538291537207162148.5572,56477,8.7637,0.0012,0.0038
29242,77515,48273,3406,2146229408.0404,1552590927796191555.7501,48274,8.5151,0.0033,0.0025
15172,57634,42462,9915,2138493621.553,1524093527519475613.2872,42463,9.2071,0.0054,0.0014
24020,38084,14064,19210,2157692513.8049,1531329329360305736.9141,14065,8.081,0.0017,0.0061
20239,61244,41005,32421,2154661040.9361,1552657034201446499.7362,41006,11.3131,0.0016,0.0054
14377,74103,59726,16782,2134883679.6334,1537598741214555478.0086,59727,21.710,0.0056,0.000
1036,27819,26783,27689,2151158674.6804,1543512457342126620.8853,26784,7.1049,0.0021,0.0039
18188,45713,27525,7648,2135849853.5115,1558553262215881883.0475,27526,14.0919,0.0078,0.0025
6451,94893,88442,2418,2150494373.1114,1537266186520648064.0124,88443,10.518,0.0006,0.0019
19340,102617,83277,12787,2143430742.6852,1545810447669183668.7256,83278,16.643,0.0034,0.0023
32350,55175,22825,4062,2146737059.1117,1533616362457777635.8873,22826,8.390,0.0041,0.0027
30821,49677,18856,25505,2143327264.7682,1541138490984108029.8652,18857,2.8202,0.0041,0.002
234,58091,57857,8889,2143094593.888,1536595666853083751.338,57858,7.898,0.0036,0.0013
18549,113980,95431,19339,2141553766.9283,1533266988649990008.5721,95432,13.6619,0.0037,0.0005
14744,50817,36073,29683,2145087204.3033,1535308232387581090.0207,36074,7.1614,0.0034,0.0018
30964,56947,25983,8358,2151710793.8251,1531287764690005034.0753,25984,8.7384,0.0042,0.0048
19322,71564,52242,1033,2141714199.1646,1529974358332622384.0379,52243,12.1593,0.0041,0.0012
9307,72036,62729,2626,2154294631.4368,1531362113960932410.7628,62730,10.2995,0.0007,0.0041
7886,69033,61147,16736,2133741452.2133,1538438061699946351.1908,61148,14.6951,0.0052,0.0002
19096,72007,52911,24333,2143384694.0999,1548004045932613954.9835,52912,11.4483,0.0036,0.0012
8108,88982,80874,2023,2133946938.1934,1539517411369228489.8497,80875,19.6613,0.0049,0.000
3186,31333,28147,18779,2155956250.2446,1562316045974256214.7138,28148,16.2757,0.0037,0.008
17104,101434,84330,12219,2148780639.3584,1534600436018117774.8505,84331,8.6388,0.0017,0.0023
18712,88064,69352,2932,2156065730.1617,1530412255202878790.6535,69353,11.5937,0.0004,0.0037
18355,36369,18014,22511,2139006213.7382,1522472362227632399.3732,18015,8.3561,0.008,0.003
26833,28758,1925,17246,2151914243.6682,1571672197827583687.2165,1926,8.9169,0.0102,0.0133
7756,69358,61602,25287,2142968189.8847,1538088235020487680.7526,61603,4.0503,0.0027,0.0006
20282,39954,19672,3047,2155348404.9293,1527657411620828978.3324,19673,6.2406,0.0018,0.0063
16737,104775,88038,26900,2143475879.3181,1538837633241001085.5616,88039,5.7008,0.0026,0.0006
27266,99819,72553,19143,2157678888.1948,1531319913823081168.458,72554,20.7059,0.0005,0.0046
5282,69912,64630,26298,2148474119.3442,1540994179367248575.5942,64631,8.2666,0.0024,0.0022
5178,57915,52737,7562,2140301129.3011,1552011026577417107.2268,52738,18.0016,0.0045,0.0019
8612,67409,58797,19614,2159570545.3209,1530774658593505882.4371,58798,11.7939,0.0004,0.0052
19608,35081,15473,22245,2158731125.7466,1542793859159376341.705,15474,4.5158,0.0009,0.0068
2800,83891,81091,19244,2143846886.0453,1542717117005251936.3316,81092,12.7985,0.0032,0.0012
21606,99096,77490,7689,2141215946.5825,1532175259098890214.8824,77491,6.7481,0.0031,0.0005
4512,76027,71515,23205,2149370320.6885,1530985078896954250.8831,71516,4.6441,0.0015,0.0023
12186,70097,57911,32744,2147400989.9401,1523901227747370544.1273,57912,12.0145,0.003,0.0026
1007,1622,615,5989,2174586896.2273,1608341674408358506.1107,616,6.898,0.0191,0.0308
4527,104120,99593,15970,2143678873.967,1539852388760844537.5905,99594,11.8639,0.0024,0.0009
25441,56772,31331,18186,2159672939.7168,1534422606143179961.1347,31332,8.9546,0.000,0.0068
8332,86435,78103,994,2143728725.2253,1543490827832688514.6496,78104,6.353,0.0031,0.0015
10301,74025,63724,23161,2136998742.675,1524221421133253187.2561,63725,11.6957,0.0064,0.001
400,60757,60357,28812,2143693360.8435,1539154751663970412.9911,60358,5.5697,0.0025,0.0009
18357,99153,80796,29206,2146049581.4931,1536621773869381906.2125,80797,6.3907,0.002,0.0016
23665,48127,24462,10410,2155467310.9861,1532936186871760345.5881,24463,10.9369,0.0014,0.005
28192,111295,83103,15120,2150116619.8912,1533314333129927358.3649,83104,5.3847,0.0014,0.0025
27511,112889,85378,8896,2140799057.0957,1531473431375130166.4812,85379,11.4369,0.004,0.0009
17515,89285,71770,8931,2150147543.1323,1528424511776649412.9352,71771,10.9435,0.0016,0.0027
14426,103046,88620,16397,2151374459.3341,1551489022731270528.2786,88621,15.0292,0.0022,0.0043
14192,73911,59719,30116,2143937668.1462,1547052045451680040.7672,59720,8.6587,0.0036,0.0016
2615,25307,22692,27975,2144809183.3061,1537736545555524419.2601,22693,6.5707,0.0031,0.0018
32731,45461,12730,12932,2143743786.8461,1552963778921784916.1146,12731,4.1909,0.0047,0.0031
6147,32183,26036,9692,2140631443.6359,1548809118432895785.0567,26037,13.3796,0.0046,0.0026
23007,76331,53324,29869,2149795755.6387,1538824343030909771.5961,53325,9.1383,0.0017,0.0025
18270,21621,3351,12172,2148562063.1468,1559768459939578867.5859,3352,3.6189,0.0074,0.0092
25397,51074,25677,757,2161240928.1739,1530313127784556317.3251,25678,13.7161,0.0016,0.0066
21144,54327,33183,15227,2150416320.6977,1542091446795475330.4954,33184,2.6339,0.0017,0.0025
13984,109408,95424,24504,2138374687.8993,1536303024280325258.9022,95425,7.9098,0.0032,0.000
21156,75850,54694,24460,2145163081.4173,1534624759661876899.4296,54695,3.5314,0.0028,0.0014
1591,76615,75024,18324,2149229673.8896,1545508916203729019.1252,75025,8.4696,0.0021,0.0024
1513,47142,45629,18830,2150278505.3177,1536231207372940150.3045,45630,3.2352,0.0014,0.0026
21916,121353,99437,16286,2151571128.3368,1537403408267187374.3492,99438,7.5128,0.0007,0.0024
22983,85269,62286,23630,2156788808.8238,1532017554848413392.826,62287,14.3972,0.0007,0.0064
16696,22681,5985,32374,2157046126.483,1549213612858893272.8695,5986,10.5212,0.0055,0.0101
18929,115483,96554,18923,2136138219.003,1537095067416790377.3315,96555,27.4057,0.004,0.000
16479,88286,71807,15997,2144854518.7299,1538372593178506597.6178,71808,13.527,0.0026,0.0016
21973,51168,29195,19342,2143389675.0131,1521674839714737182.1148,29196,11.0405,0.0049,0.0027
12542,36777,24235,19973,2154470748.0701,1528685270700272152.8113,24236,6.366,0.001,0.0048
32471,55452,22981,31140,2149909407.8065,1529482258744685889.4125,22982,5.6613,0.0028,0.0053
10466,11964,1498,13472,2173086854.006,1506238239057258493.543,1499,9.3233,0.0083,0.0203
15384,51904,36520,6209,2145802462.7434,1536543509899895136.2634,36521,7.3862,0.0027,0.0023
31469,86917,55448,6653,2144835264.894,1534291635118207964.581,55449,3.7737,0.0023,0.0013
20949,64169,43220,10789,2156574100.3461,1534360390844432603.5075,43221,8.6938,0.0006,0.005
9184,36171,26987,810,2134915520.0857,1533345351007199669.6867,26988,10.0486,0.0062,0.0008
1182,10840,9658,28264,2160037281.7703,1539437521434117258.3074,9659,8.0067,0.0017,0.0115
8029,88360,80331,17192,2145440684.3733,1539295351398293650.1647,80332,8.4082,0.0022,0.0022
9292,26052,16760,16886,2145345753.4258,1508013900627396971.8794,16761,13.5505,0.0066,0.0056
10285,85758,75473,24996,2157163447.6161,1526138114607108162.5272,75474,19.6956,0.0014,0.006
2608,46872,44264,1753,2133195206.8028,1537526155983812939.8182,44265,10.9186,0.0058,0.000
15013,37036,22023,20629,2158771077.9337,1534405124231362788.4731,22024,6.0239,0.0004,0.006
11807,12716,909,18804,2105641180.8495,1534936394483977005.4224,910,16.0787,0.0314,0.0089
4192,94325,90133,18066,2152451556.5177,1538110614954047887.9351,90134,6.1592,0.0001,0.0022
18832,29414,10582,25372,2137362703.4759,1528261792230516078.9492,10583,2.6036,0.0071,0.0022
26705,109326,82621,22490,2136809084.1718,1544459573273937880.8586,82622,14.076,0.0051,0.0001
22161,119504,97343,9290,2146831747.3646,1526993031323186812.7537,97344,12.8119,0.0025,0.0022
10361,44446,34085,16010,2122843704.6734,1546226910520590618.8661,34086,22.165,0.0095,0.000
5969,50238,44269,2698,2147853467.7556,1541469085007595028.7633,44270,10.6495,0.0019,0.0021
1824,77519,75695,6177,2158051732.964,1532386071419593001.605,75696,18.2966,0.0011,0.006
19483,54256,34773,24412,2157784119.7858,1531394679257463796.9575,34774,22.4524,0.001,0.0085
26753,57769,31016,9388,2123904639.4929,1535203126419131141.9943,31017,18.4283,0.0097,0.0004
16827,20773,3946,5126,2153906402.2316,1544394371128715638.5534,3947,8.4834,0.0047,0.0079
24800,96138,71338,25556,2156606149.7361,1543146535943593369.0959,71339,7.5162,0.0008,0.0038
14909,65293,50384,19720,2140312545.1256,1550560916982330776.447,50385,14.8235,0.0049,0.0017
25832,103567,77735,26974,2150408816.3612,1541079610821678749.8688,77736,8.8694,0.0013,0.0025
22703,98068,75365,26708,2143887558.5279,1546927294687706641.4813,75366,13.7254,0.0028,0.0018
4383,79278,74895,26247,2139528925.7405,1532382820945868821.3675,74896,10.3657,0.0038,0.0004
31268,85391,54123,29694,2152071287.5414,1549472219136783863.8196,54124,8.7643,0.0015,0.0038
19416,102682,83266,12121,2150427026.5898,1542437136244894942.3782,83267,3.6946,0.0007,0.002
22997,35967,12970,389,2133015238.8637,1547658294531516608.0075,12971,5.4014,0.0072,0.0027
32210,89284,57074,14337,2149433312.3869,1545284930299830675.6436,57075,5.3183,0.0017,0.0033
5021,87083,82062,24836,2147114618.9675,1540716665318525651.2818,82063,10.0838,0.0015,0.0013
11189,83269,72080,13695,2142263067.2744,1540511918749412273.6949,72081,2.6452,0.0027,0.0002
18516,63731,45215,20624,2143549312.7031,1531640043695297104.2675,45216,9.6479,0.0032,0.0011
27250,50362,23112,6172,2155104167.9486,1519701314291529722.6693,23113,6.4529,0.0028,0.0067
849,28264,27415,28151,2150670321.7142,1531220862995230914.7375,27416,6.4766,0.0019,0.0045
11444,24587,13143,6073,2143123665.4537,1567459214983314711.6745,13144,12.6465,0.007,0.0053
16754,98622,81868,25587,2156067232.6092,1530494331069806230.6035,81869,20.8221,0.0005,0.0036
9516,96162,86646,8849,2143044459.8128,1537938241761920885.5022,86647,4.9135,0.0025,0.0005
8550,40676,32126,32149,2167407614.2473,1543891787559352270.8178,32127,15.515,0.0004,0.0095
31293,76756,45463,22778,2142282745.9652,1545167670041593199.4518,45464,5.7293,0.0037,0.0017
12699,67346,54647,30711,2151222327.182,1532702945655798994.1565,54648,1.6253,0.0008,0.0026
17826,96787,78961,14098,2147623593.77,1534952610429436771.1982,78962,10.7349,0.0013,0.0018
22479,116471,93992,9574,2146489644.0567,1536513976809693016.357,93993,7.7797,0.0021,0.0014
4103,56429,52326,4784,2152006957.432,1539187040422178385.5884,52327,9.8526,0.001,0.0042
1561,69076,67515,876,2150669827.1129,1543324923676041431.0743,67516,8.1256,0.0017,0.0023
17957,99527,81570,26412,2149294135.2203,1536985405251082162.5559,81571,1.855,0.0007,0.0018
18490,77802,59312,32466,2134925345.3233,1539136842298422588.1087,59313,13.6155,0.0059,0.0001
20861,76487,55626,10788,2146914197.7816,1533729642904267611.3569,55627,5.6869,0.0028,0.0018
27268,78380,51112,18533,2145367208.9945,1546486500378845958.5252,51113,7.513,0.0026,0.002
11211,72701,61490,30538,2163447547.6026,1535207308139573740.1507,61491,19.8295,0.0001,0.0068
19376,22957,3581,18957,2154413146.7909,1552084495858354187.7114,3582,11.7149,0.0074,0.0126
21299,21657,358,24845,2008655516.6435,1463194626210330564.5637,359,9.9682,0.0563,0.0034
27511,112964,85453,1693,2148924306.9523,1538412490271806805.5153,85454,19.0479,0.0018,0.0034
29528,63113,33585,27206,2171763093.4508,1536779700678625100.1698,33586,17.7222,0.0002,0.0086
28683,112731,84048,4398,2150301163.1176,1541253235869278168.7783,84049,10.5104,0.0017,0.0024
10076,68041,57965,17363,2132046790.8158,1533731250368370193.4894,57966,17.2506,0.0066,0.000
4183,56643,52460,25437,2154918324.407,1537762932549287034.6641,52461,10.6823,0.0008,0.0046
11299,35377,24078,19277,2159905934.9737,1547360908287781942.6994,24079,6.6087,0.0016,0.0068
26887,67982,41095,4625,2154211437.8928,1534866984992328004.8019,41096,8.7781,0.0013,0.0031
20994,105332,84338,9212,2162546270.8677,1535085524489637540.9412,84339,28.5554,0.000,0.0059
11093,70291,59198,4180,2163795498.7254,1533123821419151042.643,59199,17.4789,0.000,0.0067
17970,86497,68527,21112,2151483508.7048,1538730637281493804.1439,68528,9.5407,0.0013,0.0038
5915,13627,7712,3887,2160614754.4323,1530146958542911695.2536,7713,8.1971,0.0025,0.0112
11626,24691,13065,18738,2128385478.8859,1529407398569163506.5702,13066,17.9414,0.0114,0.0027
17871,66497,48626,20016,2165335113.8296,1539974199695917794.1121,48627,16.3582,0.0002,0.008
22055,99641,77586,14724,2146242977.9873,1534050246519427116.4216,77587,4.503,0.0028,0.0014
25243,58770,33527,32267,2129730558.4435,1544763105445139377.6529,33528,17.2168,0.0077,0.0003
20559,38801,18242,13288,2169122297.2889,1530665151084495725.1745,18243,26.8031,0.0002,0.0094
2715,100033,97318,30849,2146462609.3967,1533750949557476816.4457,97319,4.1221,0.0017,0.0009
10691,102841,92150,30147,2145146255.0761,1538671453184909390.6729,92151,5.4332,0.0019,0.001
4415,17419,13004,832,2162127823.2917,1532179166395348124.6077,13005,5.8127,0.0023,0.0083
14587,16882,2295,7540,2154724512.0784,1577462149503505283.4137,2296,10.7468,0.0092,0.0127
1244,4927,3683,24971,2163258299.2025,1561518103101187430.8195,3684,3.7886,0.0052,0.0112
16722,94310,77588,17177,2153882979.979,1539671963307052511.9531,77589,9.8953,0.000,0.0026
23994,115695,91701,3165,2143367833.0635,1536619512900239359.5206,91702,11.9069,0.0028,0.0007
23537,54293,30756,1808,2143039271.8961,1524171987640308377.5276,30757,13.1134,0.0052,0.003
26728,28789,2061,10221,2144686922.7338,1581259610049882564.6794,2062,16.4591,0.0178,0.0134
1206,43507,42301,29416,2149678154.0542,1536526846078177038.6877,42302,9.8851,0.0023,0.003
3588,87729,84141,23624,2149489057.9809,1534073522030365340.17,84142,5.5546,0.0008,0.0024
22837,39678,16841,32440,2135460299.4822,1570466554497849584.4784,16842,22.4075,0.0094,0.0039
5958,16656,10698,18425,2145790027.5323,1513907271243867358.5402,10699,2.3679,0.0072,0.0049
28680,42301,13621,22528,2147533348.4438,1537278032665028817.1394,13622,5.7807,0.0034,0.0031
5005,26013,21008,20292,2149892275.9562,1525262854185702446.0831,21009,5.416,0.0038,0.0039
9005,100596,91591,5051,2152075029.5418,1540099834848358161.5306,91592,3.4039,0.0002,0.0023
2698,25547,22849,8187,2157949450.1207,1537617701700434457.9228,22850,4.6255,0.0005,0.0048
21005,34817,13812,5329,2169472569.0077,1531023210074115843.6049,13813,9.0759,0.0021,0.0109
28009,61901,33892,25284,2158170858.7517,1549227728289813580.3415,33893,13.0963,0.0018,0.0062
21755,89667,67912,22624,2147528387.8138,1537334968957199348.969,67913,7.4582,0.0019,0.0012
25889,75943,50054,3299,2159802188.2817,1541287774398989689.2937,50055,13.2184,0.0002,0.007
16733,72165,55432,4638,2143336488.5427,1540203149388635756.4803,55433,11.6018,0.0026,0.0012
10551,37750,27199,1264,2142423090.4412,1526097935888019816.4842,27200,11.3461,0.0043,0.0023
18260,112185,93925,2490,2145103340.5872,1529256536515781548.7085,93926,7.288,0.0028,0.0016
22179,118583,96404,11469,2166181808.0032,1538220138470031516.5087,96405,38.4588,0.000,0.0087
25985,106382,80397,16270,2143356119.6735,1546069160680322463.9634,80398,9.6045,0.0035,0.0014
8588,32956,24368,13748,2134102506.1416,1549359037274307096.7575,24369,17.2233,0.0083,0.0002
6584,75263,68679,6958,2147136824.3359,1541574884661079718.2388,68680,8.705,0.002,0.0023
4630,103674,99044,12568,2152711842.4758,1540988629653797242.2274,99045,9.8859,0.0005,0.0026
17711,57082,39371,26285,2145648580.0986,1542461082425226523.3504,39372,3.9659,0.0025,0.0012
15971,65756,49785,9355,2135428075.6586,1531940081767064874.4476,49786,8.9042,0.0047,0.0004
31345,110010,78665,20476,2144474598.9144,1533466665262880323.9231,78666,1.5553,0.0024,0.0007
24994,42756,17762,9515,2131479697.7554,1542951448465005246.4629,17763,10.2321,0.0076,0.0003
25655,53623,27968,7126,2156814844.7065,1543737189411893069.9809,27969,10.2904,0.0005,0.0052
11477,93346,81869,3674,2143338814.789,1541626605811951652.2729,81870,7.498,0.0032,0.0009
23904,89763,65859,4877,2150010222.154,1530362586057298159.8071,65860,6.5734,0.0016,0.0023
27305,28182,877,10655,2095820699.9282,1497881230278202802.545,878,5.3731,0.0262,0.0047
11228,29622,18394,15253,2132635508.5999,1534521479639698836.9229,18395,9.5054,0.007,0.0003
24228,108635,84407,4286,2154619561.8922,1534068501392498418.7757,84408,9.6978,0.0008,0.0045
1045,85863,84818,8025,2154656258.243,1539566054068055807.6229,84819,14.7135,0.0001,0.0038
17075,89756,72681,15672,2154858252.8402,1543364595465372466.521,72682,6.3884,0.0013,0.0033
26123,67656,41533,13810,2140899892.4389,1543551025991246967.9247,41534,5.0319,0.0039,0.0009
26780,29684,2904,10123,2180828480.4816,1530493687273629273.8214,2905,10.2167,0.0003,0.020
19159,68260,49101,13493,2149624044.3616,1523643527152123932.9225,49102,15.3078,0.0026,0.0037
2306,26759,24453,1451,2151299568.2251,1554491456300879207.2602,24454,9.8172,0.0031,0.0048
21578,103466,81888,566,2151025288.8241,1539171949109363556.1476,81889,4.5151,0.0009,0.002
19391,41288,21897,2617,2147869672.6417,1544218889298747466.2271,21898,21.9944,0.005,0.0038
17768,53819,36051,1172,2140166246.1593,1532894970048445150.5942,36052,10.8052,0.0039,0.0008
25325,112041,86716,30571,2157970510.7551,1531786899755483494.4544,86717,12.9072,0.0002,0.0044
16171,58343,42172,20858,2158541307.6477,1533824870201518890.7558,42173,8.9104,0.0001,0.0055
21681,52920,31239,22316,2155520497.0288,1544377017217022215.7238,31240,5.2935,0.0009,0.005
15492,59343,43851,12537,2132349354.8255,1537372291014660117.4521,43852,12.4262,0.0057,0.000
20262,74923,54661,9850,2155601126.3949,1528827170288437262.1382,54662,15.8588,0.0005,0.0053
21005,57817,36812,29759,2131119197.7501,1542969570524914057.6731,36813,11.8027,0.0077,0.0004
1151,79259,78108,660,2155749405.406,1543562859592592141.1657,78109,11.5352,0.0015,0.0053
3720,37150,33430,9715,2143132020.9245,1541986069382898580.5825,33431,1.5531,0.0029,0.0009
18058,71568,53510,16123,2144402002.2667,1525513569500002520.562,53511,7.3644,0.004,0.0015
29598,54799,25201,16325,2159612013.1918,1529919810468987228.1807,25202,6.5017,0.0012,0.0061
23500,114682,91182,27919,2145654394.7469,1539439926354235615.9852,91183,4.7667,0.0018,0.0006
8301,55113,46812,2252,2138693661.8658,1538768567411334558.1867,46813,13.1969,0.0058,0.0008
19636,101062,81426,3224,2146211936.6532,1538545602561713010.3574,81427,6.8793,0.0017,0.0009
3962,23970,20008,24426,2162432288.5726,1526754385263018618.981,20009,8.5912,0.0013,0.0075
31564,51449,19885,1412,2167858413.8828,1534875495548816207.1714,19886,7.7284,0.001,0.009
29242,82615,53373,2404,2150001294.3024,1536545603001499396.1675,53374,3.937,0.0014,0.0033
13544,65706,52162,13008,2158900710.4008,1540255890332949188.5905,52163,8.7265,0.0004,0.0048
10758,90130,79372,17429,2146211983.5486,1532709579057445067.9203,79373,7.2038,0.0018,0.0011
30315,55625,25310,4556,2133600880.5452,1532731922915001724.9864,25311,7.4699,0.0077,0.0009
14268,18659,4391,26928,2116907552.1193,1559768507314982712.2271,4392,9.8294,0.0178,0.0035
8250,82012,73762,3896,2147211983.5165,1545610705940681464.5265,73763,11.9793,0.0022,0.0025
22147,75003,52856,26897,2148908460.166,1539162467965399597.602,52857,5.4625,0.002,0.0026
2918,76072,73154,4775,2145719422.4677,1529598336837918252.3807,73155,14.5672,0.003,0.0025
17101,74475,57374,17643,2148060242.7429,1531175518969805008.5123,57375,7.6272,0.0028,0.0024
29581,76971,47390,24104,2143014365.7697,1533294138885776139.1493,47391,8.4401,0.0041,0.001
23629,89668,66039,7968,2153032347.9945,1538263361093640740.6092,66040,19.5153,0.0011,0.0038
3256,21857,18601,18040,2126993518.1393,1542746608875428256.4524,18602,10.3836,0.0079,0.0004
13771,16720,2949,25230,2154051982.4302,1552266265101663617.1746,2950,2.6953,0.0058,0.0099
6956,33439,26483,16615,2146110816.7533,1538457140036864378.2377,26484,7.8598,0.0034,0.0021
14079,52693,38614,17354,2133611595.4755,1550390290657274139.1955,38615,13.3658,0.0063,0.0011
11037,95638,84601,16309,2135888560.031,1547630278571330780.096,84602,27.1988,0.0063,0.0007
20122,75795,55673,13560,2140455423.1893,1535065760315529286.6515,55674,2.8366,0.0031,0.0002
24555,39375,14820,29581,2153544818.8905,1535481648009337431.6908,14821,33.1123,0.0042,0.0088
27636,85044,57408,12815,2164723997.1337,1532585655652332799.1784,57409,17.1434,0.0008,0.0065
6398,98436,92038,2872,2142388470.9574,1540408048274923131.7098,92039,9.2535,0.0023,0.000
11590,102773,91183,4756,2144558059.493,1529297766701707866.3615,91184,10.9005,0.0036,0.0014
23444,115262,91818,7079,2148371161.7189,1541174340441094544.4757,91819,5.8913,0.0015,0.0016
14957,33313,18356,31290,2167316859.8082,1530865713079423023.2944,18357,12.8033,0.0002,0.0091
16505,107110,90605,8471,2148845322.2405,1539500275175969985.8074,90606,9.541,0.0016,0.0021
12564,65598,53034,25420,2159522922.7149,1542742698720320612.1119,53035,19.1322,0.0001,0.0056
24279,105613,81334,10162,2147162469.345,1538622975576440557.1509,81335,10.0344,0.0021,0.0015
21077,82377,61300,28525,2146560984.9308,1530621758487795831.4933,61301,5.3942,0.0035,0.0021
5729,94818,89089,26653,2147852022.7196,1542627695868147581.1776,89090,4.6949,0.0015,0.0017
3996,16946,12950,8987,2142649962.2262,1556946007179416292.3821,12951,8.1943,0.0063,0.0042
3946,24583,20637,20228,2134733967.9318,1526212885424234013.58,20638,7.937,0.0063,0.0012
15487,43294,27807,27738,2138774123.6956,1536759551971644370.8377,27808,9.1565,0.0042,0.0007
19246,69158,49912,30460,2152312116.8886,1521513691426883418.9136,49913,10.2067,0.0024,0.0048
26793,59328,32535,28885,2140660723.2728,1529984394474529216.2053,32536,3.8614,0.0038,0.0011
20466,54220,33754,16205,2142479353.0069,1536187728916646843.9651,33755,11.3824,0.0045,0.0013
2464,34489,32025,12188,2151658366.6112,1532771947132915344.51,32026,2.9021,0.0016,0.0041
30353,95642,65289,30960,2157666236.3722,1544278377249310556.5874,65290,8.1649,0.0007,0.0049
4731,87472,82741,5360,2144557906.4233,1539220821586162130.9618,82742,8.9491,0.0032,0.0019
27269,33403,6134,30472,2166709855.1817,1550136970157892629.0778,6135,8.4727,0.0027,0.0152
2748,53272,50524,4513,2141712002.7135,1544884786674689360.3771,50525,5.8226,0.0034,0.0017
1579,49040,47461,18260,2149943346.1376,1538990671660687845.4537,47462,2.3249,0.0011,0.0022
9663,64451,54788,30157,2145647787.7136,1551798940338599351.9685,54789,15.0757,0.0036,0.0028
12663,108883,96220,22801,2147560901.8766,1541503831652803423.0224,96221,3.3956,0.0015,0.0016
17331,77531,60200,25215,2137670805.0238,1538880157220147800.3551,60201,8.8261,0.0045,0.0008
9979,61020,51041,23787,2138039550.6659,1546371199742215524.7604,51042,27.919,0.0074,0.0019
26611,78117,51506,14297,2145022480.8589,1540060321383494459.7427,51507,9.4251,0.003,0.0014
10490,55164,44674,4452,2139904764.2054,1534559865169818015.3538,44675,7.2828,0.0042,0.0013
24047,110241,86194,16512,2145924584.666,1526666447267783279.0115,86195,13.647,0.0028,0.0021
21656,121152,99496,6576,2146254082.9794,1534377438184039303.4751,99497,1.6866,0.0014,0.0007
11282,50052,38770,2908,2148380038.592,1531248802637919404.5639,38771,8.0342,0.0021,0.0033
26527,47230,20703,13997,2135213464.2666,1528644157120482035.5943,20704,4.1134,0.0079,0.0005
23516,37624,14108,2287,2128317280.9872,1540688155417361871.5929,14109,9.359,0.0077,0.0004
12379,49459,37080,31742,2152767078.8201,1541517690224271636.7235,37081,11.5274,0.0021,0.0039
9271,30416,21145,18288,2183359318.1341,1534410180863139951.4392,21146,23.577,0.0004,0.0116
22122,89731,67609,3603,2142999008.8321,1546091987843781021.3283,67610,8.5571,0.0038,0.0016
12566,52299,39733,24297,2152058683.5363,1542904875979947528.4587,39734,4.0458,0.0015,0.0036
23421,44100,20679,15507,2158954899.0915,1538495359121290578.7624,20680,12.5752,0.0022,0.0072
10407,96910,86503,4948,2155312939.397,1544459145600376020.8853,86504,9.9986,0.0003,0.0045
13915,29390,15475,27419,2181145870.1487,1541525510004318443.5143,15476,19.9667,0.0002,0.0125
31288,41779,10491,12287,2197303998.3525,1518030014812490524.9232,10492,21.4126,0.0008,0.0187
20173,74284,54111,15488,2142672014.089,1536061919042018749.9918,54112,11.6548,0.0029,0.0007
11024,42184,31160,32257,2145379631.6618,1535144697962362404.099,31161,10.9812,0.0037,0.0028
18951,36225,17274,25381,2143195073.3592,1535983423208684944.4261,17275,3.2546,0.0033,0.002
21080,87473,66393,22564,2141343882.3875,1543726125497292758.8956,66394,8.4597,0.0038,0.0009
17516,64013,46497,22457,2132263586.7608,1539252854015624718.0328,46498,15.0945,0.0069,0.000
205,71646,71441,20850,2144573519.1361,1545436944927915644.4003,71442,22.9575,0.0034,0.0019
18297,85544,67247,4217,2147845777.7631,1532255968042391975.3442,67248,14.1508,0.002,0.0021
13933,76705,62772,2650,2141581369.5169,1539820516975074730.446,62773,9.4113,0.0027,0.0004
22340,76832,54492,27711,2142403185.4862,1529792025327240828.0524,54493,9.5947,0.0035,0.0012
24914,98204,73290,31534,2148685982.4338,1535864980121735407.6143,73291,2.4336,0.0012,0.0015
24917,87569,62652,22473,2147762833.7265,1536986295149726311.3519,62653,6.0446,0.0015,0.0022
31451,93372,61921,1475,2142094745.3506,1539912553918030298.3219,61922,4.6129,0.0041,0.0009
7296,53312,46016,25687,2150578686.4338,1539815541103036211.2033,46017,4.4894,0.0008,0.0023
21725,120142,98417,18774,2148108395.9784,1546566418669445777.8145,98418,8.8054,0.0019,0.0023
26871,102708,75837,25987,2151833453.0219,1525813770618071695.3398,75838,7.879,0.0013,0.0034
13502,91523,78021,18106,2150145804.1659,1535591988714407265.6186,78022,3.4177,0.0004,0.0025
4265,85945,81680,3059,2156285497.8308,1538848266778338127.0436,81681,7.9152,0.0008,0.0047
10609,76707,66098,32339,2146074897.1688,1537527684427161852.7413,66099,2.6617,0.0019,0.0016
21717,113313,91596,4427,2149874723.6848,1536311822666558207.9979,91597,8.7417,0.0011,0.0018
29351,78969,49618,28258,2142556031.1181,1526863654430718369.9226,49619,10.8747,0.004,0.0012
11748,80231,68483,9299,2147691615.409,1542987497686470671.6976,68484,9.8513,0.0023,0.003
31164,70947,39783,271,2146182612.201,1542399229347482754.6341,39784,3.1194,0.0029,0.0018
7617,19268,11651,3655,2165777396.582,1549146265025321833.4568,11652,11.7311,0.0008,0.0106
8926,81622,72696,28969,2152930990.509,1529156748018970976.7304,72697,7.4347,0.0006,0.0036
2456,51732,49276,30620,2149190950.4401,1523850515342610496.2573,49277,16.7138,0.0038,0.0042
21565,57828,36263,16553,2157528112.536,1535070395239789088.864,36264,9.8303,0.0001,0.0066
26635,71014,44379,26339,2142097018.6614,1538595192998477829.7162,44380,7.0431,0.0037,0.0011
2239,37237,34998,28435,2139384013.3742,1538803975068953477.3255,34999,17.5376,0.0057,0.0018
6021,52769,46748,15469,2165980692.6822,1530982724340060217.9354,46749,27.6388,0.0001,0.0067
27842,91431,63589,26111,2168730712.1905,1545254442325880476.873,63590,30.3245,0,0.0098
26510,42876,16366,23721,2135898192.7893,1538871809369193290.2939,16367,9.1852,0.0079,0.0008
5657,18176,12519,7081,2175734524.7345,1533233082350977717.3254,12520,11.6048,0.0003,0.0128
5498,37775,32277,13909,2140836824.574,1543121726482274647.9991,32278,7.0121,0.0039,0.0008
15448,63405,47957,31752,2145184317.1336,1529197352684597620.7865,47958,4.1648,0.003,0.0017
19583,114441,94858,31988,2147151294.6684,1530530897599959061.3952,94859,21.6451,0.0016,0.002
20516,45557,25041,10625,2156220377.7933,1531473158755662843.282,25042,8.0167,0.0018,0.0046
29279,101406,72127,3533,2144071436.4689,1538324490527076596.1665,72128,3.5725,0.0026,0.0007
22238,93163,70925,18594,2138591351.4,1537475332161101500.1665,70926,23.8817,0.0057,0.0013
18424,106021,87597,17478,2148410045.5269,1544965756427265495.5989,87598,13.8757,0.0017,0.002
8141,60698,52557,2224,2141714017.1954,1523696808370271576.7375,52558,13.8361,0.0052,0.0015
7869,81976,74107,17519,2151459818.655,1536931273071707112.7965,74108,6.041,0.0002,0.0027
7728,102669,94941,7227,2142880586.4248,1541386295311617811.4284,94942,8.874,0.0028,0.0007
3863,41618,37755,21408,2147011448.3338,1556721552148880357.8771,37756,9.9104,0.0045,0.0036
23319,27482,4163,28427,2165311595.8305,1524844579281589083.0899,4164,5.2518,0.0023,0.0109
6025,66429,60404,30427,2151653807.6503,1538263317218493745.5354,60405,3.2181,0.0009,0.003
20160,33847,13687,20949,2149415913.7922,1547450360011938689.7625,13688,7.9112,0.0038,0.0041
10680,19439,8759,12344,2151246149.5164,1553149333610474163.3821,8760,7.0817,0.0039,0.0056
29244,89704,60460,3597,2150856354.6529,1544873483487786687.4664,60461,2.4777,0.0016,0.003
14302,96751,82449,6140,2151457294.6667,1546230150056715163.8294,82450,10.788,0.0013,0.0036
17390,42398,25008,25103,2141105905.5772,1533424396487504319.5772,25009,3.709,0.0066,0.0013
26684,28081,1397,2274,2209118527.7804,1604949438197696451.23,1398,7.3728,0.0072,0.0279
25377,34052,8675,10736,2144619380.908,1536088074638559018.0701,8676,6.4026,0.0049,0.0071
29269,35017,5748,25068,2120902439.0804,1545485162232925823.7323,5749,10.8061,0.0166,0.003
29765,51260,21495,7791,2132392957.4531,1529202677555068462.9624,21496,15.8673,0.0081,0.002
10989,104974,93985,28056,2141379133.0056,1532986517084328409.4549,93986,10.1423,0.0036,0.0002
19650,87499,67849,5465,2146048519.555,1535817653114440100.432,67850,8.2431,0.0023,0.0011
11231,71256,60025,30689,2162684876.6915,1545131134268314028.5294,60026,14.3056,0.0005,0.007
12165,55119,42954,7891,2151012063.491,1537792283700749108.5203,42955,1.8124,0.0006,0.0024
21711,47540,25829,12172,2150201397.2113,1529437012687034439.294,25830,4.7067,0.0022,0.0031
13222,111979,98757,8736,2154871063.1544,1538261998819016283.9542,98758,7.136,0.0005,0.0042
9260,12985,3725,1628,2212606484.4297,1525813460551042478.6943,3726,14.5207,0.0015,0.0269
9901,41762,31861,21641,2162324695.336,1543152188268154036.4836,31862,10.4546,0.0001,0.0066
6635,40224,33589,21103,2147562467.8399,1542733648322985685.0829,33590,11.9205,0.0044,0.004
14801,108132,93331,458,2139825445.2939,1540530908146741299.0134,93332,12.3545,0.004,0.0001
9340,11804,2464,9253,2095596021.9704,1538321199139626082.9983,2465,9.635,0.0226,0.0022
19301,112255,92954,6097,2144540795.6249,1544912709856174359.1568,92955,7.8076,0.003,0.0014
19997,96178,76181,6699,2134713345.5127,1536031127284095512.7394,76182,17.4321,0.0062,0.0002
22692,102267,79575,16928,2154869749.0812,1539211712057787507.1628,79576,18.8032,0.0007,0.0049
30135,129779,99644,7939,2152028844.6878,1529541251237994031.8691,99645,13.0805,0.0013,0.0042
11674,54815,43141,31250,2149514766.0245,1537212872494641097.882,43142,6.7393,0.0014,0.0032
146,65689,65543,3857,2164059789.9853,1534820477391782029.9212,65544,21.9375,0.0003,0.0088
19977,57682,37705,21818,2138328449.5021,1543026402850246249.6823,37706,9.7815,0.0053,0.0009
31383,76812,45429,4836,2149274896.3186,1537288732373121048.3814,45430,3.3616,0.0013,0.0021
24573,115708,91135,12703,2142057529.882,1534206268068949339.4973,91136,6.1786,0.0027,0.0003
32377,33299,922,27444,2186228992.9339,1561654543033763958.831,923,4.2127,0.0044,0.026
147,91090,90943,27041,2145016899.3621,1534338341956890155.4991,90944,5.6922,0.002,0.001
4975,81068,76093,13414,2139614722.0227,1536526158166919926.2782,76094,9.405,0.0033,0.000
25043,108122,83079,14316,2141842358.9378,1537621822249661577.3318,83080,8.6201,0.0031,0.0001
17570,52798,35228,13407,2159396734.4437,1544789572726940264.2482,35229,9.687,0.0013,0.0055
2422,69313,66891,31123,2151208455.1966,1541301574557159959.6958,66892,10.3846,0.0012,0.0044
32147,93664,61517,31033,2149324168.1446,1545855035157078870.0299,61518,20.5584,0.0022,0.0038
15386,91138,75752,17,2138526281.9804,1543076312676024589.2447,75753,17.7843,0.0053,0.0005
7253,86611,79358,19089,2141662062.3374,1538175672297203892.1281,79359,5.9139,0.003,0.0004
18104,104270,86166,32705,2154208739.0629,1531904589845503744.4759,86167,12.5626,0.0005,0.0031
680,79833,79153,8464,2146032984.8198,1537432815595065852.5851,79154,8.486,0.0022,0.0014
25778,76848,51070,11439,2140511619.4917,1525671765425836246.826,51071,9.6468,0.0046,0.0014
15395,78876,63481,27687,2154372889.3931,1542316186329227740.2935,63482,9.9648,0.0007,0.0033
13180,97080,83900,14881,2155736019.6349,1540237446350565102.4914,83901,16.097,0.0006,0.0047
711,23981,23270,32508,2141732355.5421,1537100308277116277.4944,23271,4.9086,0.0037,0.0006
29839,119781,89942,8656,2134367143.1441,1538062129639593242.8466,89943,13.0373,0.0049,0.0001
7248,56270,49022,32553,2143832276.9016,1532114688774957071.6842,49023,4.7336,0.0028,0.0013
7255,34372,27117,21148,2148592681.4802,1533054018614716731.4954,27118,6.721,0.0026,0.0035
12586,18598,6012,6581,2138846747.0951,1510053168674624316.1809,6013,8.4312,0.0115,0.0063
23222,118536,95314,1610,2149749671.6248,1533614290434027738.0718,95315,3.1554,0.0006,0.002
14555,40182,25627,261,2137865206.4124,1525016368428637385.012,25628,3.7344,0.0048,0.0011
9777,30643,20866,9727,2127142913.8114,1544155421427704997.553,20867,12.1496,0.0107,0.0014
22855,85018,62163,1188,2137793657.8217,1528052288296852803.9921,62164,7.2686,0.0049,0.0006
25068,41854,16786,2820,2115440909.8993,1557018554880601006.6837,16787,19.4224,0.0135,0.0006
26320,41311,14991,11606,2152610785.1393,1524549792314151897.0761,14992,8.6263,0.0038,0.0051
16628,73097,56469,2615,2145510317.6476,1533707462246519105.2562,56470,5.5442,0.0024,0.0017
20811,81212,60401,16081,2141940765.1731,1538975658305474525.2556,60402,3.8357,0.003,0.0009
18349,34169,15820,26088,2143359182.3299,1522466032881606573.8912,15821,6.2439,0.0064,0.0045
14516,98554,84038,2531,2147604531.9369,1542913280705413905.159,84039,11.7735,0.0022,0.0019
23599,53281,29682,15456,2136114019.4784,1514618005890902659.643,29683,11.2372,0.0072,0.0023
7418,94292,86874,4228,2142358329.3725,1536780061093906317.5303,86875,7.9404,0.0028,0.0001
29247,83179,53932,24540,2165730277.4543,1535583116616303667.772,53933,16.3857,0.0002,0.007
14672,76556,61884,21458,2147592895.7978,1528690229860935140.7673,61885,7.9498,0.0023,0.0022
9733,67577,57844,15425,2160405245.8839,1542236331927265441.7773,57845,16.1565,0.0001,0.0053
6174,59110,52936,32759,2141526071.956,1533358818494026662.8569,52937,10.7466,0.0049,0.0006
27623,50505,22882,26485,2162216816.7924,1536715060926203706.2364,22883,11.6732,0.0001,0.0082
3406,79281,75875,22056,2159418363.4085,1532566572583766243.8002,75876,12.3049,0.0003,0.0051
14237,53613,39376,31389,2147069231.6857,1553149520610726025.0089,39377,8.5398,0.0051,0.0036
1607,39952,38345,24711,2159199209.8162,1544921675689154360.537,38346,13.0723,0.0006,0.0062
31089,123780,92691,11517,2137684083.2109,1537224489239753103.3106,92692,10.9192,0.0037,0.0002
20823,46979,26156,24367,2137936624.4913,1532986727228015342.1529,26157,3.9812,0.0053,0.0008
22145,109935,87790,21900,2139609428.5506,1537627489365974136.8401,87791,11.5184,0.0037,0.0005
31651,109540,77889,15125,2153596190.1505,1540494625986550217.691,77890,15.6591,0.0013,0.0056
5311,49454,44143,25160,2146710659.7211,1536969692557220255.3486,44144,7.5552,0.0018,0.0017
6289,73055,66766,32521,2131992736.6899,1536666227594124959.7961,66767,14.4801,0.0065,0.0003
25617,73722,48105,24043,2149049214.6399,1541538271111073892.6898,48106,3.1702,0.0016,0.0027
5184,100233,95049,13701,2151672609.6257,1539324258290105732.4421,95050,6.0735,0.0003,0.0022
22437,55945,33508,21104,2149618954.8004,1539521095814884791.4684,33509,16.5417,0.0033,0.0046
5173,35459,30286,26219,2150708488.8531,1544688179062985120.2628,30287,17.4103,0.0032,0.0045
10121,21804,11683,24328,2136025427.5103,1539507031743627575.253,11684,4.4769,0.0068,0.0014
23253,90255,67002,3028,2147049382.7795,1544912828714863707.5303,67003,9.4058,0.0026,0.0021
16156,106834,90678,27745,2150889043.1809,1538581430985516197.2522,90679,6.5311,0.0008,0.0029
9388,86704,77316,25929,2155239669.1108,1538086746359422036.6386,77317,7.7436,0.000,0.0037
22794,88730,65936,22968,2136649353.2519,1540637542639551599.882,65937,7.8975,0.0047,0.0005
6239,104444,98205,14083,2155687512.3509,1533454214983158868.1001,98206,8.3005,0.0004,0.0035
29532,50762,21230,16248,2152868056.4034,1548614313716795966.9834,21231,3.1455,0.0021,0.0056
2940,73039,70099,9203,2154931148.5092,1521730950190534575.6613,70100,15.3122,0.0016,0.0044
30649,59761,29112,12763,2149451351.702,1533675352459474463.5676,29113,6.5711,0.0031,0.0036
30372,66619,36247,18883,2145199076.7876,1536435358799409226.6407,36248,2.2904,0.002,0.0013
30786,104282,73496,1733,2143292184.1176,1539517219751842771.0761,73497,5.4028,0.0022,0.0003
16029,114340,98311,4449,2154762373.9051,1539624875496501836.2278,98312,12.1507,0.0001,0.0038
7730,20855,13125,5612,2118620566.225,1554066852580566447.6854,13126,20.9006,0.0144,0.0032
26287,50730,24443,18528,2125611680.276,1534907358156934990.1286,24444,17.4876,0.0108,0.0009
22776,62818,40042,9846,2138164070.7473,1538424486814902849.0082,40043,7.3814,0.0043,0.0003
15401,79472,64071,23604,2159830142.0499,1530998777625613389.1483,64072,19.9167,0,0.0063
12635,70824,58189,27837,2146029719.815,1532162717739791754.0929,58190,13.2495,0.0032,0.0017
2627,61680,59053,22121,2157331011.2935,1531204987357040821.6155,59054,12.7346,0.0003,0.0048
16898,86530,69632,14947,2145633790.9539,1544451458167521216.1762,69633,7.642,0.0026,0.0017
3872,88416,84544,16153,2150194954.8953,1539628700829349005.8553,84545,4.8955,0.0008,0.0021
12825,59952,47127,10114,2144729185.5428,1550775680219803533.9297,47128,7.7377,0.0039,0.0022
31431,78546,47115,28475,2162909788.0793,1532289343982471476.2606,47116,24.116,0.000,0.0072
16452,30437,13985,27979,2147355501.5172,1540779974732738851.4149,13986,8.7694,0.0051,0.0039
9674,10460,786,9558,2281381566.4917,1546636953582791648.5422,787,22.9192,0.0071,0.0694
20054,72382,52328,6781,2150669937.5766,1536333527175216036.7561,52329,8.6263,0.0011,0.0025
17549,78239,60690,12559,2142856847.4022,1534385603873790066.1413,60691,11.6403,0.0033,0.0016
1951,49860,47909,3429,2143759713.1479,1541267569474122914.8063,47910,8.2488,0.003,0.0017
5616,13768,8152,2286,2131599199.9708,1536711728581028326.5126,8153,11.5791,0.0081,0.0018
4598,67157,62559,32134,2143409273.6524,1542875085420625299.1628,62560,10.1967,0.0039,0.0012
15134,25133,9999,21445,2120019569.5704,1509889379224589805.2082,10000,22.3132,0.0175,0.0013
32256,56102,23846,21931,2147104430.8738,1551179529638476936.9967,23847,11.9761,0.005,0.0042
91,77802,77711,10064,2153345110.8827,1543025622544504073.7978,77712,4.5607,0.0006,0.0027
5981,105560,99579,31329,2138164329.7723,1534001563622481042.8411,99580,10.0661,0.0036,0.000
15763,35610,19847,17657,2148282767.6935,1556825320798101258.5616,19848,12.2338,0.0044,0.0055
3444,35288,31844,28979,2149753757.9217,1560239082407602733.0078,31845,19.7631,0.0051,0.0064
28684,82339,53655,24294,2148685675.175,1540450356455576697.6168,53656,5.2051,0.0012,0.0017
8919,101789,92870,29556,2139392301.3059,1539647957888435121.0827,92871,10.2226,0.0036,0.0001
4004,74428,70424,30281,2152412530.9933,1547816026242802940.0484,70425,14.1677,0.0019,0.0032
20853,75022,54169,13229,2130072852.0467,1532134968573427077.8634,54170,26.5761,0.0066,0.000
16482,66645,50163,10319,2151342888.9501,1539899663198437839.6351,50164,7.7019,0.0017,0.0036
32274,35718,3444,4565,2200273826.4705,1542224229535254218.9307,3445,9.6211,0.0017,0.024
22921,108563,85642,2656,2141804339.843,1546254607719103904.8738,85643,12.0501,0.0034,0.0012
23655,33921,10266,9990,2140796590.5219,1538710262932002274.3121,10267,7.537,0.0065,0.0027
12481,58955,46474,7542,2147579823.4826,1528429403436649575.9226,46475,11.284,0.0031,0.0032
19513,61895,42382,23752,2143251975.3833,1549459790366684645.6646,42383,11.3222,0.0038,0.0018
9825,105588,95763,252,2140098722.8029,1536429256886051875.4305,95764,11.9672,0.0045,0.0009
28627,117635,89008,14263,2144261045.5436,1540936871008946910.6459,89009,5.2963,0.0021,0.0005
29311,48616,19305,9975,2160651804.2745,1538691669009921894.9847,19306,7.1597,0.0011,0.0062
26733,40321,13588,7395,2154809050.2999,1529050711757809751.0298,13589,5.1536,0.0018,0.006
13887,15284,1397,116,2232602328.0637,1540846041959548498.4359,1398,13.9779,0.0002,0.0454
3112,79752,76640,14113,2144337663.5307,1535498141841248275.7981,76641,4.6151,0.0025,0.0005
32213,92132,59919,21416,2144790079.3745,1540036644084951268.7234,59920,3.5694,0.0024,0.0011
27429,81099,53670,30634,2142982496.1021,1536283896537132107.2788,53671,6.7073,0.0036,0.0012
3464,13613,10149,4176,2172438872.3512,1532299780201824030.9571,10150,8.9686,0.0014,0.013
11424,62154,50730,6116,2149379519.4805,1537297585353338499.5118,50731,2.0127,0.0012,0.0019
14319,93040,78721,28423,2157973675.6513,1534121874599988143.9029,78722,11.4303,0.0007,0.004
30625,52383,21758,16200,2152514377.1736,1521034085393367455.8242,21759,18.4695,0.0021,0.0051
21891,79012,57121,13959,2147075309.7807,1530874119782198325.435,57122,13.211,0.0025,0.0028
5012,52264,47252,12530,2136843335.7938,1540852602459667808.5114,47253,9.4157,0.0076,0.0009
15006,91633,76627,3460,2148222137.2374,1541059717473455705.1652,76628,11.1499,0.0018,0.0023
12013,101386,89373,6155,2139149094.2873,1541184517219360226.2967,89374,15.3146,0.0047,0.0004
18600,91512,72912,18953,2160841404.9505,1542379256159969140.4159,72913,15.0821,0.0005,0.0055
22863,23566,703,6000,2009086171.6818,1547245782033723977.6715,704,13.0169,0.059,0.0045
3748,78882,75134,20017,2147120253.451,1534015508580970926.7904,75135,9.5726,0.0014,0.0015
8023,51501,43478,11045,2145675905.4386,1538819060144119754.8599,43479,4.8771,0.002,0.0015
25690,36828,11138,1509,2138539508.2991,1529774251592695985.1054,11139,4.6021,0.0064,0.0018
17572,115728,98156,4121,2150765013.4841,1538785395794997077.8844,98157,4.690,0.0005,0.002
2242,73645,71403,14416,2141741511.001,1541756346789351676.4239,71404,6.3386,0.004,0.0005
11897,39124,27227,23383,2130279497.7124,1533017669355229635.7257,27228,8.700,0.0071,0.0008
967,56761,55794,17915,2138871841.99,1540866741563068615.8977,55795,12.2539,0.0042,0.0004
3651,69081,65430,32747,2148806376.634,1537641921610632597.0813,65431,5.4273,0.0014,0.0017
27463,30580,3117,19621,2145586179.5564,1506105986548147095.4219,3118,7.7035,0.0097,0.0094
11208,74514,63306,30746,2138988415.2733,1535768955569449653.0675,63307,9.4462,0.0043,0.0007
10251,79930,69679,14967,2151717680.3955,1536282189427061906.4648,69680,6.2109,0.0009,0.0027
13390,49932,36542,9699,2156840767.4409,1537882790427332605.809,36543,13.0389,0.0003,0.0042
8888,40949,32061,4632,2150046137.035,1535210342106768963.8978,32062,10.1335,0.002,0.0024
9748,60235,50487,8531,2146113270.9914,1544751654235618637.0555,50488,6.144,0.003,0.0024
28852,65236,36384,24003,2148450866.316,1539953663507958808.2566,36385,11.2655,0.0039,0.0026
25492,106117,80625,18758,2139891831.9684,1535456858836386421.6682,80626,9.7379,0.0046,0.0006
13142,89569,76427,7428,2148891883.0821,1539849017143880092.0173,76428,20.324,0.0021,0.0038
5441,82520,77079,11467,2146534774.3197,1536514317596670258.1178,77080,7.2505,0.0016,0.0015
26970,86270,59300,24751,2150170428.9951,1540813282580661119.3158,59301,8.1855,0.0012,0.0024
19114,26056,6942,32487,2180359439.7367,1545952849675050486.8142,6943,8.6744,0.0007,0.015
9557,31321,21764,5323,2139808857.3514,1527374006225228160.5875,21765,6.9999,0.0051,0.0014
26474,48962,22488,10533,2145909593.532,1546771465851525525.6739,22489,7.652,0.0042,0.0023
32058,57265,25207,14490,2153189497.3001,1527546005739920510.8898,25208,4.0295,0.0024,0.0056
10090,64074,53984,31971,2140834473.6535,1536238103204972378.6914,53985,6.8918,0.004,0.0003
24881,30718,5837,1117,2156059582.7258,1546546379076367791.4882,5838,4.9983,0.0043,0.008
5093,63901,58808,15926,2133530077.8846,1533539019593389405.0142,58809,13.9116,0.0085,0.0001
29408,42361,12953,5434,2131651834.0537,1545459178664279943.0996,12954,10.4103,0.0099,0.0013
28895,123782,94887,7207,2147445365.8836,1528840784395288232.0349,94888,17.0829,0.0018,0.0025
28105,87451,59346,1083,2141465402.5382,1538283143535645313.5076,59347,12.0695,0.0034,0.0006
25558,90690,65132,15384,2148372936.2679,1532412804377456349.8328,65133,3.4696,0.0012,0.0017
6147,47215,41068,4201,2146216221.8306,1540842967089111894.1447,41069,3.0006,0.0023,0.0014
11355,33469,22114,21167,2155502063.2108,1535058919710324110.7102,22115,12.5166,0.0014,0.0052
13094,67713,54619,9573,2134193858.8695,1541434085567435669.7692,54620,14.665,0.0058,0.0001
20969,58637,37668,24603,2139965897.2525,1530715568216058164.7632,37669,11.6103,0.0053,0.0017
15493,80870,65377,1617,2145934857.28,1537425013303904373.8867,65378,10.4221,0.0021,0.0025
23499,73200,49701,19163,2133446389.977,1552598125719099815.1757,49702,19.339,0.0065,0.0006
13818,77120,63302,31045,2145944016.5896,1531071200213362799.5894,63303,9.7223,0.0028,0.0019
27037,27912,875,29234,2046365510.7785,1585343974205230471.4281,876,12.417,0.0443,0.0035
20819,92772,71953,19503,2149539522.8813,1529907502019954840.8758,71954,7.0964,0.0017,0.0032
27622,86382,58760,6046,2146674055.1282,1534754274153533302.5274,58761,6.4145,0.0017,0.0015
17768,45515,27747,30439,2142608303.385,1529011736859498239.6336,27748,4.9805,0.0043,0.0026
622,8450,7828,13405,2138856148.0096,1537739076420378634.3822,7829,10.4275,0.0083,0.0017
62,82039,81977,9772,2138241218.1415,1549780965016560349.6563,81978,25.5059,0.0045,0.0008
14117,56043,41926,14022,2135216180.3385,1529261589644544203.7826,41927,10.1396,0.0062,0.0004
20043,101629,81586,20580,2144732074.288,1535655865861964710.286,81587,6.0489,0.0025,0.0008
6257,50620,44363,23928,2147501849.8671,1538599617488766176.1401,44364,5.8229,0.0022,0.0023
18635,75646,57011,18654,2145507617.2359,1530724292740842511.5369,57012,6.7556,0.003,0.0018
1857,74991,73134,5305,2141592724.6664,1543555101498665584.8245,73135,5.9746,0.0036,0.0005
21184,63316,42132,25071,2142503434.1937,1532056593345600307.7862,42133,10.5502,0.0033,0.0016
14924,66197,51273,3328,2134624984.4365,1535796997715647370.99,51274,9.1913,0.0053,0.0002
12223,47436,35213,32102,2147659744.5286,1545516941824192431.5948,35214,7.187,0.0034,0.0038
29363,87737,58374,4682,2146590366.2541,1540835853584479425.2662,58375,3.9168,0.002,0.0019
30615,38936,8321,6499,2159457105.9244,1539292687225467150.3645,8322,13.4379,0.0019,0.0084
31706,78062,46356,19454,2154450054.8203,1530011481815377917.1386,46357,7.0495,0.0007,0.0043
26845,58738,31893,17112,2149185640.1026,1553894619196503337.1986,31894,12.9125,0.0038,0.0054
10134,77961,67827,11243,2129627047.9879,1538874818026573636.566,67828,18.9762,0.0064,0.0001
11953,87401,75448,2133,2152906859.341,1539659619166508706.7458,75449,6.4867,0.0005,0.0037
14018,51056,37038,13339,2151190465.0599,1534427329921503479.9562,37039,3.1258,0.0015,0.0025
9000,11792,2792,24581,2150854300.6549,1547577792701700278.1666,2793,5.2027,0.0065,0.0083
13408,68495,55087,16275,2146451007.3298,1525320298909461070.6364,55088,8.7956,0.0031,0.0036
27260,79291,52031,8091,2152466006.0658,1540665966161450542.1537,52032,5.2292,0.0012,0.0033
15574,24970,9396,11767,2150595234.085,1558928485405012703.5376,9397,13.014,0.0086,0.0101
28246,127875,99629,9478,2146132012.5808,1531495915418748719.9448,99630,2.5948,0.0017,0.0012
25604,27700,2096,2246,2168461268.1764,1520074636635498626.0423,2097,5.2286,0.008,0.0167
16389,23568,7179,16448,2166679918.3446,1547112473920003389.6671,7180,4.5597,0.0029,0.0101
466,65078,64612,17986,2151358337.3613,1534423913178860602.258,64613,6.2523,0.0004,0.0024
23824,27512,3688,4803,2150113533.5232,1552499527450333055.5073,3689,4.5798,0.0074,0.0093
2333,4194,1861,28346,2209876309.5559,1521425794543358022.0643,1862,9.9026,0.0001,0.023
8649,26442,17793,27350,2173042588.2344,1534505888231892200.158,17794,14.5769,0.0003,0.0114
13391,76103,62712,32704,2144872035.0291,1535294009572898250.9373,62713,8.2089,0.0022,0.0011
19839,46299,26460,6736,2140275855.3608,1523234085363954120.703,26461,8.4062,0.0062,0.0027
19342,43758,24416,2616,2139033271.2984,1548140799623723341.5648,24417,7.5512,0.0057,0.0013
5779,55110,49331,25419,2144491262.9165,1535213997361660576.477,49332,5.1102,0.0039,0.0015
32101,118253,86152,16316,2148971413.1466,1530336840929307605.314,86153,8.3397,0.0018,0.0026
5174,30278,25104,16827,2130720443.171,1541677632224028423.835,25105,11.1536,0.0095,0.0015
12218,76403,64185,14234,2138828269.4548,1527618873447960757.4464,64186,11.9745,0.004,0.0008
1478,50079,48601,13907,2158331992.0872,1537279106680046117.1655,48602,6.7149,0.0004,0.0065
9167,16983,7816,3428,2126479260.531,1518755489537265335.1189,7817,9.838,0.011,0.001
27592,71837,44245,22825,2145888211.3902,1526838083147837347.0658,44246,21.8307,0.0031,0.003
24811,117086,92275,2156,2146305511.5923,1544857340534103143.6908,92276,14.4243,0.0031,0.0021
18054,46974,28920,13565,2147966138.6983,1537994563665483397.0308,28921,2.7752,0.0021,0.0023
8285,91962,83677,22422,2159128212.3569,1544237270160984515.8308,83678,13.6806,0.0005,0.0052
27900,123114,95214,18372,2158104276.2942,1530685589952716193.3643,95215,24.3539,0.0001,0.0048
21237,93429,72192,28715,2157368206.0263,1531675551767237614.0595,72193,8.8505,0.0016,0.0044
26128,74853,48725,22128,2142343834.5669,1543833595750547999.1553,48726,8.6696,0.0042,0.0022
10898,55628,44730,1338,2145071768.6701,1533494020664521285.4327,44731,3.982,0.0032,0.0015
18579,85099,66520,25767,2143389365.1791,1530190657990290128.9034,66521,10.0041,0.0034,0.0009
12280,31937,19657,1538,2142147913.9153,1523470690126739614.2371,19658,6.4433,0.0054,0.0022
15643,31003,15360,5073,2125927933.3802,1535928579676722365.3869,15361,10.308,0.0122,0.0005
10529,48247,37718,25399,2152889511.8657,1542036773234913703.4908,37719,3.5637,0.0007,0.0038
3536,92434,88898,3214,2147339966.3289,1537599456195282588.8013,88899,7.2055,0.0012,0.0017
30094,115989,85895,30197,2147885275.6298,1536303361534106189.9817,85896,5.5345,0.002,0.0011
20138,21408,1270,18955,2232134448.3053,1563076134067453658.5787,1271,10.4619,0,0.041
19684,45856,26172,15957,2162325707.258,1541146336467972874.2617,26173,11.3924,0.000,0.0075
27329,62152,34823,27148,2149542930.8048,1531165825169513283.0105,34824,5.8187,0.0023,0.0038
26136,118723,92587,31856,2137294970.7099,1534953335410801366.5218,92588,28.9136,0.0038,0.000
19780,60875,41095,24302,2153776921.1181,1530530526184390641.4092,41096,4.4089,0.0011,0.0042
1257,54537,53280,8301,2151005037.0149,1540128054749370402.5799,53281,3.214,0.0008,0.0026
135,2245,2110,20423,2182290007.9342,1548013836340760350.1799,2111,5.094,0.005,0.0192
26898,91562,64664,16562,2145462706.3019,1554928077523430316.7976,64665,14.213,0.0038,0.003
7180,26426,19246,7740,2141100489.1003,1550412375526139548.99,19247,7.7096,0.0065,0.0032
21062,109069,88007,6072,2153523690.9182,1532519867152006665.9937,88008,10.8279,0.0011,0.0036
26288,79443,53155,19293,2152885496.8309,1535867979323076589.4898,53156,4.1601,0.0006,0.0029
6679,72856,66177,877,2147785237.2214,1545908811971297225.5405,66178,4.5474,0.0025,0.0032
2687,12499,9812,16311,2144498896.9479,1537302754011850003.786,9813,8.1837,0.0067,0.0038
24897,93590,68693,7558,2142858504.7808,1532844723959737339.9239,68694,10.4804,0.0042,0.0011
26623,124573,97950,22792,2144572804.5581,1541385145080663833.9164,97951,4.5554,0.0028,0.0009
20948,120416,99468,27078,2146060313.0183,1536393992496264143.3185,99469,2.7869,0.0019,0.0006
1855,9607,7752,3065,2131059131.7088,1522443334793778953.2401,7753,7.1844,0.0095,0.0035
18172,117748,99576,27465,2138276442.2182,1534619241382909002.7057,99577,14.5824,0.0038,0.0001
19156,99302,80146,18964,2137156466.1668,1536904777127770997.409,80147,10.4853,0.0047,0.0002
15514,38763,23249,31659,2158418900.7492,1524293199601590995.9421,23250,12.7755,0.0025,0.0071
24657,88960,64303,2288,2144866484.4321,1522929943960392668.7587,64304,11.2132,0.0036,0.0017
30860,71863,41003,23372,2138610242.0781,1541817027175292753.3555,41004,12.4547,0.0053,0.0008
31393,83793,52400,11314,2142681121.9511,1537322483233522807.4989,52401,5.3342,0.0022,0.0006
13599,55195,41596,17297,2148006766.486,1537704049989048733.031,41597,3.2784,0.0023,0.0023
15256,23409,8153,13496,2165358961.2699,1540837159921930284.8662,8154,10.8848,0.0029,0.0109
16157,85718,69561,12387,2145771878.0107,1520222097999148908.3535,69562,29.5697,0.0032,0.0028
28206,80708,52502,26679,2158637844.2175,1547075652139352018.6615,52503,11.8087,0.0005,0.0052
20266,43244,22978,4510,2125834153.9282,1523070518419118230.7437,22979,18.2496,0.0095,0.0001
14867,58364,43497,3297,2149288670.3772,1533731064335175730.5377,43498,3.8893,0.001,0.0019
10204,20477,10273,6935,2142713089.63,1541085966480796148.7155,10274,2.4539,0.0068,0.0025
21353,76948,55595,23032,2140314375.8832,1531643808174331555.3575,55596,8.548,0.0049,0.001
1152,35673,34521,9928,2145131440.3889,1527968355493748471.0199,34522,5.0463,0.0031,0.0021
29137,57303,28166,28601,2150286030.2585,1537703460800261580.03,28167,1.2386,0.0018,0.0026
5467,17043,11576,22937,2145143989.1006,1542405280931996398.3505,11577,5.4672,0.0057,0.0042
2892,64372,61480,22631,2147181941.7685,1531643212507802699.0667,61481,3.9497,0.0022,0.0019
29099,54544,25445,20451,2139361661.259,1543140711152227549.3193,25446,5.6215,0.0056,0.0006
1789,4933,3144,27322,2086780252.6833,1592427079174386539.3223,3145,20.5038,0.0329,0.0064
10058,30173,20115,6095,2162173370.3972,1531813077462504323.3997,20116,7.4958,0.0018,0.0083
18252,110245,91993,27817,2150916695.0802,1525754104507250087.8944,91994,10.7317,0.0025,0.0032
10756,41930,31174,12512,2155678998.6733,1541600822531413971.0277,31175,3.8196,0.0015,0.0049
3436,25769,22333,23428,2136895598.189,1529181292718723332.304,22334,8.2518,0.0069,0.0017
3008,59369,56361,11144,2148141563.7869,1525537806515935334.8394,56362,10.1543,0.0025,0.0038
9638,107243,97605,4842,2148116865.4716,1539997049771611356.2234,97606,5.7356,0.0014,0.0018
29493,93006,63513,20004,2149672277.1312,1541891499209422434.1925,63514,3.5914,0.0017,0.0021
21019,28302,7283,14187,2124130091.2584,1546556519116009724.4607,7284,4.4253,0.0114,0.0019
28937,81016,52079,10998,2150264262.7608,1542956015192988984.283,52080,10.1643,0.0028,0.0026
23067,109530,86463,26727,2131188659.1566,1545642549268918112.6369,86464,41.8657,0.0084,0.0001
30350,64443,34093,6452,2151038166.4225,1545949722408185169.9899,34094,8.7678,0.0025,0.0048
29144,60914,31770,17621,2163243949.624,1542049413771034474.2794,31771,10.6242,0.0001,0.0079
9426,38530,29104,9616,2161870435.4046,1548614037197943576.7263,29105,6.6434,0.0003,0.0064
12979,81546,68567,10953,2146702040.3447,1535393184303086444.6117,68568,0.9285,0.0017,0.0011
14383,106295,91912,17559,2147651899.7726,1541873512137208742.6158,91913,5.043,0.0013,0.0021
25808,40428,14620,23490,2157029198.8408,1540100409549503558.8617,14621,2.3567,0.0014,0.0051
16127,96353,80226,12725,2139346995.0167,1533592787734286027.7166,80227,10.1866,0.0042,0.0002
9747,65982,56235,26487,2148580894.1392,1538599443654103920.059,56236,2.5835,0.0012,0.0021
21380,104162,82782,7730,2134198461.2295,1534520287293511142.1283,82783,20.5278,0.0063,0.0001
17114,59857,42743,17534,2119994267.9499,1530432006974604568.913,42744,30.346,0.0117,0.0004
31960,54677,22717,2319,2156149365.6606,1511851712847795278.151,22718,19.5289,0.0031,0.0067
32001,107569,75568,7452,2152812916.1161,1534913952751107549.9119,75569,4.5513,0.0003,0.0026
25083,71986,46903,27062,2133127093.631,1550649595162732574.6197,46904,24.7177,0.0067,0.0003
21361,71975,50614,30341,2150420198.5849,1552502103246578304.2284,50615,11.6038,0.0033,0.0044
16720,40595,23875,12412,2141194148.6339,1534323074490380783.5484,23876,2.2234,0.006,0.0016
29945,120305,90360,24460,2137775654.9718,1532100087596350236.1727,90361,16.2351,0.0049,0.0001
11606,38018,26412,16530,2145080973.1562,1531758922197882236.9068,26413,16.6818,0.0047,0.0026
22965,45717,22752,7807,2148964778.2487,1530325317515491508.8509,22753,2.827,0.0025,0.0027
27124,55110,27986,16715,2152209438.2487,1528084127528959571.2553,27987,3.4362,0.0026,0.0044
30631,65679,35048,13924,2158249470.6794,1551249124145344784.7159,35049,9.4223,0.0012,0.0063
2361,46014,43653,18011,2143721075.3188,1542436299978079810.0796,43654,8.6647,0.004,0.0025
15870,72587,56717,11307,2152754702.3883,1534015556057303161.9835,56718,5.1158,0.0009,0.0037
6309,7530,1221,20737,2184887239.7291,1546936065018668197.1893,1222,6.9007,0.0057,0.0264
16639,17525,886,31848,2077020416.8207,1438279223167814955.4797,887,21.6594,0.0406,0.0139
25548,94172,68624,8087,2146276992.3018,1539834044369359983.1334,68625,9.1512,0.0023,0.0027
17116,77005,59889,11148,2146872068.7515,1540949888083283792.8118,59890,3.6494,0.0017,0.0016
13079,23209,10130,30994,2163135081.1916,1548489183399992337.8451,10131,14.6316,0.002,0.0094
25373,90366,64993,17233,2154752471.9814,1526831431919265661.2904,64994,19.6585,0.0008,0.005
10352,70879,60527,11553,2151580618.1968,1530175327079196713.2749,60528,10.3709,0.0009,0.0032
4725,25317,20592,27082,2151535915.1671,1530981596369659773.8072,20593,5.1744,0.0037,0.005
9934,22768,12834,20349,2159073219.1252,1542124151352959814.0385,12835,12.5075,0.0017,0.0089
26066,48376,22310,32197,2120101236.0582,1543392090762818944.8651,22311,22.360,0.0104,0.0005
26928,45033,18105,5122,2164454740.0019,1518924546850796583.7588,18106,10.0868,0.0019,0.0092
16037,58655,42618,1525,2137103819.9634,1539270546237661686.2174,42619,16.3244,0.0067,0.000
24506,89600,65094,28230,2151915756.4477,1524026451416205347.874,65095,15.834,0.0023,0.0047
2051,57716,55665,20467,2149444757.1471,1538621238595943792.6175,55666,2.663,0.0011,0.0019
2220,4363,2143,5436,2152079700.5746,1496901315037618437.6325,2144,9.7954,0.0122,0.0184
13663,56581,42918,12428,2139561518.1609,1534397373707043157.3871,42919,5.939,0.0054,0.0003
28928,86658,57730,5017,2144578419.0761,1543568658813108944.6301,57731,6.2416,0.0031,0.0016
26390,109336,82946,7922,2153926490.2671,1539312881564901231.4825,82947,5.6637,0.0007,0.0038
31369,43644,12275,28212,2148134503.3416,1528455920320258390.9646,12276,5.2238,0.005,0.004
19558,23246,3688,4657,2206132791.6663,1535143385208321353.1478,3689,14.6345,0.0019,0.0238
3969,77437,73468,13940,2147086561.0481,1531614126563918875.8434,73469,7.3575,0.0019,0.0021
18265,90247,71982,22545,2146736439.8817,1526093805452401496.9156,71983,9.7754,0.0031,0.0021
624,47941,47317,11779,2141024476.5404,1544602365720084366.7596,47318,9.0554,0.0037,0.0014
29445,79489,50044,31578,2147214089.0304,1532882937461843869.1819,50045,20.3558,0.0026,0.0028
7656,64942,57286,13733,2145608523.0156,1545479491072271415.743,57287,4.5407,0.0024,0.0019
8637,42543,33906,11465,2146725473.2513,1538277901307941673.0795,33907,3.0251,0.0018,0.0013
2990,37607,34617,1684,2153936484.5896,1540225215649361613.7927,34618,8.592,0.0011,0.0039
6437,93797,87360,32556,2142351284.194,1533165584267851900.1945,87361,14.3098,0.004,0.0011
27052,123879,96827,30993,2153975594.5273,1528985450760519340.1465,96828,14.6834,0.0005,0.0037
26444,73805,47361,23539,2149566771.9798,1524215183989759201.461,47362,10.1764,0.0023,0.0038
305,55804,55499,3721,2154409884.4453,1540640334389846743.8935,55500,9.5038,0.0012,0.0046
5871,8876,3005,29785,2235009031.6091,1547347364929823969.2161,3006,19.7209,0.0023,0.0366
22370,53807,31437,9822,2168617547.5275,1539147049620726447.3318,31438,11.4099,0,0.0084
3877,27185,23308,26543,2127288910.1057,1538799180299024800.2741,23309,8.2676,0.009,0.0004
23986,28483,4497,10864,2137237603.0678,1525325813378972186.2455,4498,16.5053,0.0175,0.0092
27347,31874,4527,93,2153344885.5777,1567270735452708541.5443,4528,13.5593,0.009,0.0107
32660,53014,20354,32015,2130893936.5183,1545160308001014363.3292,20355,7.299,0.0083,0.0002
11175,30812,19637,4724,2162323795.6978,1545799738856017473.1159,19638,11.7887,0.0012,0.0085
21632,115842,94210,19628,2153757508.3095,1536887063337370283.9933,94211,5.1199,0.0001,0.0036
32293,78579,46286,21154,2154638588.4506,1535646646873005439.3967,46287,10.8861,0.001,0.0042
17948,70377,52429,2072,2146556482.6966,1534905796367169512.8764,52430,3.4941,0.0026,0.0015
8848,105724,96876,29449,2135972515.7011,1537428161216481823.7076,96877,24.5136,0.005,0.0007
9199,68626,59427,25725,2139685228.9444,1538385034197888673.5918,59428,11.0505,0.0036,0.0001
29765,103888,74123,12682,2157891452.2049,1528499960139351181.6118,74124,16.478,0.0002,0.0054
9409,27764,18355,8917,2135301663.5994,1536138115824685065.9887,18356,8.9932,0.0066,0.0001
29238,80831,51593,5540,2152346377.1991,1553504707637925622.8252,51594,10.4904,0.0021,0.0046
25240,66434,41194,8702,2148218616.8934,1546727878149132711.9725,41195,6.7641,0.0022,0.0027
1208,19636,18428,4602,2155827019.0932,1521551871809778709.9593,18429,9.8865,0.0014,0.0069
32600,92421,59821,9505,2155187417.6551,1543217375024863114.4789,59822,5.723,0.0003,0.0045
24622,57348,32726,3264,2141423803.7578,1540261056034918389.4038,32727,18.3582,0.0072,0.0017
23299,78994,55695,25457,2163070141.0501,1549135963774500125.4507,55696,19.0414,0.0002,0.0065
26333,107468,81135,5367,2140527831.8778,1535386219403105796.1944,81136,10.0101,0.0037,0.0003
1235,86115,84880,29954,2152336938.5888,1539220374923358447.5749,84881,7.5919,0.0005,0.0041
13124,31976,18852,4635,2154978677.3713,1541783211655796918.208,18853,7.0744,0.0017,0.0069
25813,119850,94037,13857,2149161435.3608,1542027508925638026.5698,94038,9.5389,0.002,0.0025
24075,33154,9079,31894,2114649873.2991,1493434784859411629.5295,9080,28.3995,0.019,0.0015
8184,96234,88050,11232,2151972336.4507,1539693542744392770.7687,88051,11.5765,0.0009,0.0024
17786,108547,90761,9448,2137154923.5514,1522923136022954985.1195,90762,21.7454,0.0051,0.0014
14059,69498,55439,22996,2156502704.9251,1538134960105550354.7709,55440,6.718,0.000,0.0036
17094,20549,3455,32181,2151125527.5741,1532133036692531796.9112,3456,8.0175,0.0056,0.0098
11226,78064,66838,4704,2147369339.9098,1542443606686150729.791,66839,8.2017,0.0021,0.0018
11445,71395,59950,20115,2134244545.735,1536655572699461329.9857,59951,11.9305,0.0068,0.0001
23965,28269,4304,6379,2165263591.7305,1512520853038987127.2175,4305,14.6046,0.0094,0.0172
7200,66964,59764,13349,2160527228.6173,1540114669017136982.1117,59765,12.9642,0.0003,0.0058
4988,43384,38396,28247,2147586069.5267,1535757825809215612.9424,38397,6.9315,0.0025,0.0033
16832,17747,915,29181,2166363010.5306,1514728816999738788.9085,916,3.205,0.0121,0.0199
18428,95445,77017,6881,2152548295.1864,1532823124067443371.2045,77018,11.5676,0.0009,0.0034
21890,34014,12124,3500,2154161200.1348,1561430975908446159.5733,12125,10.7087,0.0049,0.0054
21212,26941,5729,17385,2162468334.7133,1541015047050899853.2031,5730,20.0659,0.0039,0.0167
10801,53961,43160,8499,2151652850.7161,1535615733197537732.6515,43161,7.6549,0.0013,0.0026
18157,115284,97127,18588,2159327664.4905,1538611353382265948.0177,97128,11.311,0.0001,0.0047
14021,15888,1867,27298,2190354656.8233,1562021413261358576.8756,1868,9.3556,0.001,0.0231
3845,33025,29180,26801,2140554181.1196,1558488350565338190.0858,29181,11.2426,0.0063,0.0029
24788,81971,57183,11507,2141128154.1939,1531621532998526118.2665,57184,9.092,0.0043,0.0008
9517,96105,86588,368,2144749849.0481,1534192551195688177.6548,86589,3.7297,0.002,0.0007
688,68412,67724,18374,2147866689.9331,1532195993871137881.2184,67725,9.6492,0.0023,0.0019
19042,116940,97898,9348,2145017600.0234,1546366804769440585.7171,97899,11.9221,0.0022,0.0023
1358,48715,47357,3586,2141351446.8434,1539134604415169038.365,47358,6.6836,0.0042,0.0012
23316,117968,94652,15702,2141900781.1285,1535587127951345872.0498,94653,6.5357,0.0041,0.0006
1244,42617,41373,10565,2140721769.017,1543963020646335854.9892,41374,5.6839,0.0039,0.0004
12291,91827,79536,12951,2143123119.9476,1536342170178718845.4939,79537,9.2327,0.0034,0.0006
2001,56794,54793,29394,2138542609.3578,1543546965901224034.9429,54794,8.1971,0.0045,0.0008
22479,44647,22168,10612,2156009450.4648,1544704468359025562.7674,22169,3.7034,0.0011,0.0057
19339,85235,65896,27405,2138819992.9232,1532782782799323201.1817,65897,5.317,0.0043,0.0001
21737,24757,3020,21905,2194078997.5995,1495237138046563573.0028,3021,12.0881,0.0038,0.0276
29321,57690,28369,7951,2145001850.6335,1530973992242973660.8927,28370,11.0175,0.0046,0.0026
19944,60078,40134,25645,2151680679.4154,1540483024227731179.366,40135,9.5598,0.0015,0.0035
8961,76500,67539,24433,2139118864.531,1526401994446018761.832,67540,7.5638,0.0045,0.0011
14078,63610,49532,10267,2146568081.0054,1534956621260943509.543,49533,18.6111,0.0022,0.003
9504,58618,49114,11293,2147914256.5048,1545035051974160386.6216,49115,5.6725,0.0023,0.0024
26794,55992,29198,12820,2145817533.2847,1527657086214664636.0044,29199,15.3087,0.0041,0.0024
26616,110333,83717,27026,2143332850.9005,1541404795680782375.9229,83718,10.6568,0.0032,0.0009
13662,89866,76204,1143,2145961365.46,1530041220782836666.4085,76205,8.3098,0.0026,0.0019
31361,113944,82583,253,2153498258.7735,1532387530504552625.0446,82584,7.2412,0.0007,0.0031
9249,16249,7000,13690,2141435665.168,1550799866269125279.3107,7001,7.5813,0.0081,0.0033
10328,30776,20448,26337,2138862841.1631,1515187662400771662.8795,20449,10.1326,0.0075,0.0021
6278,102322,96044,24303,2146621136.2228,1538070641142214750.4813,96045,2.6177,0.0013,0.0011
25046,92407,67361,18580,2142304000.8952,1532153477101220438.0421,67362,3.7436,0.0032,0.0004
6494,43180,36686,18051,2134336499.3047,1533023934481445649.1252,36687,8.0927,0.0054,0.0002
25462,33405,7943,30821,2153618950.636,1556530821201785434.2849,7944,7.0885,0.0051,0.0066
1005,37347,36342,1589,2142834599.8666,1532066389898535509.0658,36343,14.8906,0.0051,0.0026
16320,38635,22315,11916,2144754109.8617,1552491339900360643.5402,22316,10.4187,0.0058,0.0044
2341,44946,42605,4327,2144386539.3203,1537258761652250640.1741,42606,13.2503,0.0031,0.0019
23539,82784,59245,29529,2157599990.0062,1545497841857280360.1,59246,11.3986,0.0005,0.0058
4253,72024,67771,31392,2144148978.6011,1546775865255180183.9571,67772,19.8106,0.0033,0.0016
29672,77597,47925,10050,2138144972.7519,1531605879621672570.2619,47926,9.0305,0.0042,0.0007
2124,61508,59384,29972,2161596867.3951,1545122864128847865.1502,59385,22.6659,0.0009,0.0073
7235,75838,68603,5780,2136280747.0285,1547635315595163851.305,68604,18.9948,0.0055,0.0004
30836,90321,59485,14823,2148804753.6344,1533319534666172521.7079,59486,1.7076,0.001,0.002
4887,76892,72005,7361,2134051430.426,1539018103116371110.6205,72006,16.8789,0.0056,0.0001
5108,6149,1041,14673,2199742068.1411,1535349232519592957.5281,1042,6.4535,0.0025,0.0295
5171,69019,63848,23085,2149038017.0818,1544595562052381892.7767,63849,15.5824,0.0025,0.0038
6631,65297,58666,26142,2145674968.4315,1551132603451782800.9552,58667,28.8439,0.0036,0.0025
26837,41597,14760,15534,2140576583.1278,1517242438077693287.6032,14761,5.0188,0.0075,0.0028
5819,38115,32296,782,2137551107.6068,1528000278716959886.3866,32297,5.0277,0.0048,0.0006
11008,21782,10774,13374,2164992142.4556,1532390845970687017.2346,10775,6.1444,0.0031,0.0101
3356,99970,96614,28233,2153381968.2654,1542949293024638156.3028,96615,11.8466,0.0009,0.004
18778,79063,60285,24904,2149715083.0572,1541532446692587576.3151,60286,8.1057,0.0019,0.0026
3831,101362,97531,11406,2151613627.7755,1531038502082288600.363,97532,6.906,0.001,0.0029
27196,42707,15511,13351,2141233140.417,1541105271154089413.0348,15512,10.5974,0.0043,0.0013
8472,62786,54314,21271,2156378051.902,1532610703813731531.9379,54315,7.4126,0.0005,0.0041
20159,62870,42711,9739,2152024705.2299,1546612616272129468.1362,42712,8.3942,0.002,0.0039
30826,126250,95424,20437,2144647926.859,1532859438696426624.2997,95425,14.0057,0.003,0.0014
24702,54595,29893,12668,2150412592.7605,1535567889638183659.4785,29894,4.3059,0.0014,0.0028
31110,55621,24511,29958,2150530221.7663,1556510413999687148.0746,24512,9.1965,0.0039,0.0055
1074,76020,74946,13090,2153322396.0333,1534853928383402474.9812,74947,5.577,0.0002,0.003
10569,85158,74589,18910,2149497927.7702,1548327946204757347.6857,74590,19.8918,0.0023,0.0032
19799,40223,20424,21735,2143253830.7895,1534224818733724212.5574,20425,23.9841,0.0099,0.0031
25586,53817,28231,341,2135286884.2373,1543978534202703786.4136,28232,12.0333,0.0084,0.0022
7950,82289,74339,31763,2159475718.8815,1547635055251916357.7381,74340,14.8975,0.0006,0.0053
28028,71112,43084,4637,2144519839.1596,1527256522823836649.2223,43085,4.946,0.0034,0.0021
32516,68751,36235,8923,2138201862.6282,1533787479159056988.4154,36236,10.664,0.0072,0.0013
6365,75217,68852,11681,2143366427.5798,1544114290231359158.1578,68853,10.5604,0.0031,0.0006
30229,78001,47772,4331,2140070939.2603,1535316480672783877.0725,47773,6.7619,0.0036,0.000
4346,45028,40682,22218,2152769982.1572,1535775582947479431.6112,40683,11.239,0.0014,0.0042
8506,62074,53568,11492,2142754654.3313,1535782280343304222.4196,53569,5.4417,0.0034,0.0008
30897,65425,34528,27410,2144554276.8452,1523589181572735841.5316,34529,16.5193,0.0053,0.0029
12715,14873,2158,3359,2153121508.4044,1551889871201703848.34,2159,5.8625,0.0062,0.0143
18876,115158,96282,7895,2145418105.9228,1535239958902420782.5245,96283,12.7092,0.0019,0.0019
21689,113232,91543,485,2142158808.3858,1541006151494682367.7727,91544,11.2909,0.0028,0.0005
11112,61173,50061,960,2145875335.546,1534092515962969509.0466,50062,3.0654,0.0016,0.001
35,95319,95284,11908,2142649732.9948,1538878863650404459.0613,95285,4.9747,0.002,0.0001
10479,68122,57643,14450,2144161903.7577,1529667738756863072.2492,57644,16.4793,0.0052,0.0022
8596,102452,93856,9542,2147553011.3886,1542810370265237613.6399,93857,10.1783,0.0024,0.0015
29242,52531,23289,3945,2140521054.2059,1537270297547567347.4522,23290,13.0005,0.005,0.0014
22687,48647,25960,2416,2160737265.6538,1527301233917631060.0583,25961,12.7106,0.0011,0.0075
29436,57926,28490,13024,2140305681.9644,1534439655146577588.6325,28491,19.5021,0.006,0.0018
14153,44520,30367,25661,2147046143.264,1549490203428869367.2965,30368,5.4273,0.0032,0.0034
1791,63839,62048,1134,2151539006.8518,1540033674135826021.4404,62049,8.0545,0.0008,0.0027
29055,36722,7667,6533,2142972893.4384,1536793698048729892.2191,7668,3.5525,0.0051,0.0048
10795,71954,61159,8540,2138817016.238,1540919316879960022.6155,61160,7.7073,0.0041,0.0006
26158,48403,22245,11247,2153911465.2724,1535332498716568848.1628,22246,10.3257,0.0017,0.0039
31478,106322,74844,26343,2145558877.3467,1525256006692722165.6738,74845,20.7659,0.0037,0.0036
5028,104155,99127,9727,2146856346.932,1538053238048448300.7577,99128,7.9162,0.0022,0.0012
10134,31061,20927,16347,2149177302.4664,1548903050514254960.4415,20928,3.8063,0.004,0.0038
7531,47001,39470,4005,2158405144.9909,1529482830799483094.0335,39471,13.2881,0.0006,0.0053
15818,105961,90143,17716,2137559294.729,1541520696995434778.3016,90144,9.3525,0.0045,0.000
13,70226,70213,1052,2137886950.1128,1539789534279747566.8625,70214,23.5386,0.0063,0.000
5727,99908,94181,27975,2150144191.6208,1534806389275806507.298,94182,3.0447,0.001,0.0019
2946,91756,88810,23110,2149118080.957,1537183137190682443.596,88811,2.2291,0.0006,0.0011
29488,78088,48600,7583,2145012644.691,1530834430708550862.4922,48601,3.4021,0.0028,0.001
30021,87414,57393,9264,2147073754.9726,1540089700793296196.1177,57394,7.1064,0.002,0.0013
28660,61297,32637,9293,2138282631.3572,1536074691447343307.6742,32638,4.5549,0.0046,0.0005
23247,93081,69834,7872,2145856599.6196,1533128742282104838.371,69835,13.0746,0.0025,0.0013
10107,98625,88518,11625,2145423822.2207,1539910975561326009.8125,88519,7.2868,0.0024,0.0012
28757,115845,87088,31448,2146990881.6762,1540984861080108666.2483,87089,6.508,0.0016,0.0016
20261,31217,10956,9126,2157278230.9131,1550600229824399840.4066,10957,5.7306,0.0035,0.0084
6570,34912,28342,3929,2135020180.2246,1548077162179848806.0821,28343,12.5169,0.006,0.0005
23064,64775,41711,7119,2141571716.0869,1533614566051545369.9969,41712,13.1356,0.0056,0.0013
22959,74236,51277,13459,2142116463.6853,1520931347349183431.6512,51278,21.2734,0.005,0.0037
28038,61316,33278,13740,2133232896.0247,1525555032497121539.2843,33279,42.8303,0.0122,0.0021
26710,100835,74125,9089,2138882977.7033,1534315384668185790.59,74126,6.9306,0.0035,0.0003
16293,98681,82388,8870,2144493621.1129,1542397013408540992.9051,82389,25.0541,0.0042,0.0018
7845,55886,48041,4574,2148377477.3533,1537676169076833969.4198,48042,15.3052,0.0032,0.0022
11243,75703,64460,75,2131783773.9289,1537807225089618536.651,64461,21.6649,0.0068,0.000
24933,94634,69701,26597,2165016700.4749,1536110200984289396.8971,69702,24.6118,0.000,0.006
18598,59379,40781,20555,2154387551.4063,1536997041939664071.5043,40782,10.4839,0.0009,0.0035
14303,114086,99783,16080,2152902754.4762,1539434292599708404.955,99784,3.8472,0.0003,0.003
6502,103041,96539,17681,2141726714.7521,1538997077105188819.7358,96540,10.2204,0.0049,0.0007
352,98012,97660,6326,2149230992.2938,1534404558879896352.8509,97661,7.8425,0.0016,0.0029
2307,41344,39037,28542,2137443037.4727,1536526572274779841.8752,39038,6.451,0.0045,0.0004
1552,65560,64008,21374,2148651954.4521,1524950946924317782.0991,64009,10.8958,0.0023,0.0031
15545,27280,11735,17868,2140315688.3712,1545569490062206443.7883,11736,5.8249,0.0049,0.0022
31220,108925,77705,24083,2150526621.7391,1545624901332337197.4794,77706,10.8083,0.0021,0.0033
22407,30317,7910,14636,2143113094.2551,1545181810430168359.7519,7911,10.7532,0.0054,0.0033
19059,77072,58013,950,2154302591.0134,1540437525040832057.2958,58014,6.5693,0.0001,0.0041
25177,98253,73076,6497,2149187599.1514,1542925725662911870.5242,73077,18.4931,0.0025,0.0027
19706,68138,48432,31549,2145771324.5378,1538246951226090637.3904,48433,4.7946,0.0018,0.0008
2863,4339,1476,5873,2051600458.7867,1481090692098308848.1136,1477,15.1507,0.0367,0.0015
28246,54719,26473,5593,2139185182.0448,1533334471600737257.746,26474,9.8009,0.0048,0.0005
3782,39688,35906,13222,2158188823.3892,1547074728824518896.9722,35907,12.5129,0.0021,0.0055
13412,110504,97092,20024,2148819952.1115,1532050182794188535.656,97093,10.4579,0.0015,0.0023
49,72837,72788,28508,2153485771.7626,1523262877183524109.5018,72789,19.0666,0.0017,0.005
19840,56048,36208,15903,2142479950.9772,1523471932672441047.9076,36209,15.6719,0.0054,0.0032
13386,18621,5235,6294,2148025297.9935,1518707996298697433.2715,5236,1.6141,0.0056,0.0048
20491,80594,60103,17715,2150643717.9651,1536647030160330130.5975,60104,2.0724,0.0007,0.0027
22144,29879,7735,3530,2116819905.5269,1570860363277682465.362,7736,13.2472,0.0153,0.0046
5807,86075,80268,31574,2148607195.0988,1536221824899585061.7341,80269,5.1973,0.001,0.0013
31799,119846,88047,23466,2150074602.2087,1535604643926129585.795,88048,3.2932,0.0007,0.0019
19114,91037,71923,9198,2156558156.3954,1535291646453947946.4619,71924,9.2275,0,0.004
1961,70644,68683,2974,2131891457.2715,1543658186699759367.1461,68684,24.9473,0.0077,0.0005
31964,129723,97759,30517,2140754965.3638,1533950701420701095.6783,97760,10.7773,0.0033,0.0006
30436,114101,83665,8462,2148811399.0472,1543647863049538649.2343,83666,8.0845,0.002,0.0025
27091,67456,40365,14750,2156444811.4022,1536495965248453075.9142,40366,6.3372,0.0009,0.005
30914,48494,17580,21442,2139434499.2399,1512870152003689066.1889,17581,10.0127,0.0076,0.0036
9959,31819,21860,26089,2144322200.1747,1529714251824252205.332,21861,1.9619,0.0037,0.0027
23503,75303,51800,5287,2146996870.0532,1536558242660184764.2119,51801,4.6039,0.002,0.0014
4282,14772,10490,18754,2152976258.0274,1535651175631642813.3132,10491,13.4262,0.0054,0.0089
12792,36417,23625,15037,2136811314.9323,1550663960989433357.611,23626,15.3766,0.008,0.0023
11007,69764,58757,5524,2148194172.2814,1532403329012968848.677,58758,8.6083,0.0017,0.0019
32565,87573,55008,9631,2140537007.1958,1538115452480825476.9902,55009,8.7197,0.0047,0.0013
6875,21640,14765,26883,2175524647.3646,1524481064148293285.6419,14766,23.0664,0.001,0.0139
7017,96234,89217,13319,2141914207.871,1534805625100227845.9475,89218,7.3755,0.003,0.0003
4545,71555,67010,16484,2154072185.4646,1541960589658325937.0865,67011,16.6466,0.002,0.005
5845,70864,65019,13682,2137383294.3967,1535593553515674222.1497,65020,7.5793,0.0045,0.000
10449,42761,32312,3602,2140972029.7359,1524994258714645472.1094,32313,12.1048,0.0056,0.0021
24825,83107,58282,8846,2147165601.2114,1527894828258920289.5092,58283,9.2089,0.0043,0.0026
22621,84026,61405,27730,2150285736.2188,1537928161937769833.5852,61406,19.3121,0.0013,0.0041
10594,98679,88085,10748,2147613140.9501,1527199126772170559.2556,88086,4.7944,0.0022,0.0025
4115,98212,94097,32400,2147244648.4749,1537598764731885747.4278,94098,0.5546,0.0011,0.001
19116,47660,28544,5898,2139526133.0447,1529009009186817516.9609,28545,14.273,0.0062,0.0016
26345,71422,45077,6132,2155098518.2905,1545176653718492060.6454,45078,13.0786,0.0013,0.0046
17852,101066,83214,4883,2158928181.7855,1542065932191184373.3675,83215,11.605,0.0004,0.005
2982,4996,2014,1999,2153068398.3782,1554755853360888949.2545,2015,2.5989,0.0117,0.0125
26661,55004,28343,1361,2167490652.9011,1536625272748785522.8458,28344,14.8332,0.0003,0.0075
20798,70541,49743,3640,2140792126.279,1534677519867555694.0754,49744,4.8485,0.0041,0.0007
13121,95702,82581,11867,2136313154.759,1534207237965830273.0528,82582,8.8394,0.0045,0.0002
10791,28995,18204,10843,2136044673.6408,1549013622539887853.9586,18205,9.3783,0.0065,0.0014
30162,44673,14511,188,2132666803.9587,1525144235511900530.044,14512,10.8171,0.0081,0.002
31901,74996,43095,32260,2147889677.9685,1515665887713317836.5428,43096,25.7737,0.0048,0.0053
1433,16368,14935,21199,2128442352.6762,1531742812683486113.6721,14936,14.2826,0.0099,0.0018
22041,42103,20062,13828,2142588931.7289,1529223828250944632.7355,20063,8.7384,0.0055,0.0034
26429,117518,91089,5422,2155694276.831,1530098570006281265.423,91090,18.7527,0.0005,0.0046
17895,31966,14071,29758,2131194679.9559,1519790046275719221.278,14072,12.067,0.0083,0.0011
21588,111768,90180,5149,2140268593.102,1538918874967780746.9758,90181,13.0777,0.0035,0.0006
19241,86616,67375,18466,2146940575.7095,1533393045821367078.816,67376,9.7695,0.0036,0.0021
31825,109379,77554,1917,2157015592.0199,1535508243941308999.9962,77555,12.0699,0.0001,0.0053
26540,103743,77203,31692,2140784693.6578,1538279237643881033.615,77204,5.7766,0.0032,0.0004
14050,87273,73223,2582,2144057134.3594,1531975868260474556.3374,73224,6.5083,0.0035,0.0007
30783,34882,4099,14808,2155011442.2571,1511650721492976206.9744,4100,10.579,0.0068,0.0105
15124,57359,42235,24020,2144955064.2686,1526521341538363664.8754,42236,5.2414,0.0034,0.0024
15455,36831,21376,21015,2156134758.8519,1553053627258557727.4437,21377,11.1293,0.0023,0.0069
13641,64486,50845,28951,2146963593.9655,1529656775989798240.9077,50846,2.7126,0.0023,0.0019
24060,32341,8281,1023,2191390849.727,1500389189061853091.2649,8282,22.6314,0.0013,0.0193
581,44376,43795,20246,2158766956.4223,1542490606714147059.7218,43796,13.5459,0.0003,0.0047
31963,72423,40460,13876,2157205260.0581,1540303388301786632.689,40461,5.845,0.0007,0.0048
27406,37115,9709,9690,2121105029.5762,1518532414541973527.2263,9710,7.0701,0.0129,0.0024
12964,105975,93011,25638,2148868291.6715,1529152298737942603.7535,93012,9.0371,0.0016,0.0026
11099,85702,74603,2305,2144870979.1069,1537037604563013450.8921,74604,2.7856,0.0022,0.0006
26511,29585,3074,9512,2187024647.8784,1525223283399420105.8694,3075,8.8035,0.0009,0.0182
9808,40950,31142,28247,2145575203.0683,1534727517361773984.9513,31143,8.1174,0.0036,0.0034
24921,74983,50062,23721,2142876419.6127,1536149078262074102.0348,50063,9.6569,0.0055,0.0016
3599,92221,88622,16181,2157807260.4581,1542788904200654335.6706,88623,8.2952,0.0002,0.0045
22265,114317,92052,9781,2145283202.677,1539845931512111653.8512,92053,5.4872,0.0019,0.0009
15781,21403,5622,19745,2161693241.0704,1499974321533615907.1044,5623,14.8463,0.0074,0.0106
575,52848,52273,13369,2156845446.9119,1529493637071472599.5147,52274,15.0161,0.000,0.0045
19436,27246,7810,15698,2133744645.4381,1521935307792602243.1175,7811,11.3543,0.0099,0.0054
29683,88309,58626,8914,2146208028.7262,1525618057987582803.2208,58627,8.3574,0.0025,0.0026
11494,70667,59173,3004,2152668194.8931,1538198513598860143.8031,59174,4.8482,0.0005,0.0029
15702,69878,54176,5231,2156386217.0269,1535582396043087572.8475,54177,8.480,0.0004,0.0045
19775,74794,55019,9248,2150587170.2032,1535625451271898707.2696,55020,8.5513,0.0011,0.0036
31003,128945,97942,1928,2143737714.5548,1544787726363870853.5997,97943,8.977,0.0028,0.0009
16168,82634,66466,5988,2136780715.9679,1544510139582037266.4372,66467,13.2549,0.0054,0.0008
32484,57007,24523,31785,2170175653.9254,1535200614546103467.2056,24524,18.9636,0.000,0.0101
12326,24075,11749,24156,2136445484.7208,1524358930095864055.9451,11750,17.6135,0.0073,0.0037
2414,97899,95485,18840,2150986084.0825,1530258835591183732.467,95486,16.1264,0.001,0.0027
26358,94010,67652,28954,2145273724.6264,1531972726491172202.1394,67653,7.499,0.0025,0.0018
2980,25901,22921,31957,2143921085.6448,1544361310056035891.2532,22922,1.3243,0.003,0.0021
14573,61215,46642,5229,2144141906.977,1541518265080756463.4957,46643,5.2414,0.0035,0.0028
21078,61630,40552,25542,2157722756.5674,1534712234508346841.4275,40553,6.361,0.0002,0.0055
31901,100689,68788,26723,2153991947.7595,1543846783037580305.3606,68789,5.8018,0.0005,0.0035
24520,90550,66030,28221,2150467951.3162,1539129060262509780.446,66031,3.413,0.0007,0.0017
1322,53264,51942,12420,2136408530.5052,1537454648154526417.2224,51943,6.5744,0.0051,0.0003
26897,122094,95197,10849,2139857861.2068,1534181394901623792.4773,95198,10.3005,0.0033,0.0007
26879,26947,68,28208,2373236302.0435,1452230771224850343.1141,69,6.4102,0,0.1035
27365,79907,52542,6448,2146437362.1537,1537539787495067848.4856,52543,8.0711,0.0017,0.0019
27180,36425,9245,17329,2164957763.5472,1528927824022680578.07,9246,10.4571,0.0015,0.0096
14931,27933,13002,21673,2129732281.1577,1552629765915503305.2615,13003,15.8633,0.0096,0.0023
32560,102420,69860,27476,2137282664.3294,1535689200234256973.5806,69861,12.7716,0.0038,0.000
6614,31595,24981,32265,2139093173.9755,1529412675926944603.0571,24982,13.4111,0.0066,0.0021
20152,28390,8238,22192,2117076873.1697,1526761278461744999.3415,8239,12.2003,0.0163,0.0001
32059,99879,67820,31470,2157121922.2446,1529799007299057024.3411,67821,15.7529,0.0004,0.0056
18233,82132,63899,11786,2140798810.9951,1543605578049592198.1686,63900,10.3456,0.0042,0.0011
14522,56129,41607,2806,2151054740.9743,1528621283505175413.0319,41608,18.2392,0.0016,0.0032
21696,106204,84508,11701,2151893208.3387,1534142161351472396.8375,84509,5.8874,0.0004,0.0023
6856,39070,32214,1972,2151817071.4715,1524953204287366730.577,32215,9.3062,0.0031,0.0053
27301,61121,33820,9043,2139320135.993,1545479002681143759.5498,33821,8.4057,0.006,0.0019
30642,54328,23686,2607,2137732039.0594,1539465490229909589.0049,23687,6.8145,0.0057,0.0019
27328,125789,98461,7137,2148687194.005,1534332045797456065.3876,98462,4.5165,0.0015,0.0015
5475,79207,73732,19663,2152849719.1787,1527604445569030360.9097,73733,9.6538,0.0018,0.0035
1676,39259,37583,32100,2158642612.2935,1546773281650773600.5679,37584,9.7432,0.0006,0.0054
2981,67914,64933,14942,2145706266.9967,1535469125062532001.6271,64934,8.9026,0.0022,0.0025
17956,68964,51008,15837,2146648765.0974,1529267416281501054.5897,51009,3.5154,0.0023,0.0021
19778,51703,31925,19835,2157232102.7148,1545388153828853128.8046,31926,10.9152,0.0011,0.005
6503,87936,81433,22026,2154447418.3906,1538870553744618742.462,81434,5.1581,0.0002,0.0035
1642,38781,37139,22310,2160365042.8499,1548423996376520321.7432,37140,11.5311,0.0006,0.006
11651,106804,95153,4740,2140647544.9432,1535797383874112549.7724,95154,10.7418,0.0029,0.0001
17359,92715,75356,28520,2150518167.5904,1534365095546158118.3979,75357,10.7329,0.001,0.0024
16904,19354,2450,29562,2194945195.4978,1499589047225439842.9534,2451,13.7165,0.0054,0.0279
8473,62813,54340,18388,2147494786.9866,1533729730379991538.9276,54341,1.3596,0.002,0.0016
23385,100417,77032,32290,2135682356.9506,1531702765935024420.1139,77033,12.7194,0.0057,0.0001
14438,54739,40301,32436,2130564035.0035,1534758028619698999.274,40302,9.6224,0.007,0.000
2223,2294,71,16244,2202596670.8333,1435078335293264726.4722,72,2.0962,0.023,0.0576
1797,80103,78306,10630,2149968086.1559,1537055754239619971.4426,78307,6.0088,0.0008,0.0018
26081,53563,27482,29378,2132518572.4441,1526131280117910527.8661,27483,9.9852,0.0077,0.0003
29897,119083,89186,31748,2157843899.0656,1544779163880887463.1611,89187,22.254,0.0003,0.0047
9577,107858,98281,17945,2145599121.3722,1532557714088570563.0829,98282,4.1082,0.0014,0.001
24391,34777,10386,1577,2151283925.1766,1523695992210994636.1319,10387,3.5773,0.004,0.007
10232,59251,49019,12947,2145878692.0139,1544045461502229420.6309,49020,6.718,0.0025,0.002
32154,106247,74093,25629,2149787131.96,1534038925845438838.7594,74094,7.1341,0.0008,0.0019
20201,97930,77729,23609,2144310569.1668,1529947465750547988.4476,77730,7.3979,0.0026,0.0021
31424,45125,13701,6037,2146348397.0627,1534483611399971891.0773,13702,9.1225,0.0059,0.0033
30571,113675,83104,26244,2133586273.1089,1538729387661800343.9711,83105,15.6482,0.0054,0.0001
10136,62220,52084,2723,2151812212.7546,1544012899646378751.4516,52085,10.2511,0.0017,0.0044
32753,126121,93368,1215,2149503563.8821,1539335979332334473.6641,93369,2.6001,0.0008,0.0019
28851,106311,77460,15855,2146287997.768,1533397819635387855.859,77461,7.5513,0.003,0.0021
14019,70791,56772,23741,2148317736.7708,1540678670656582197.0887,56773,4.1842,0.0014,0.0021
23279,36258,12979,20095,2160667990.096,1526312307469663559.761,12980,14.4301,0.0005,0.0071
5761,86277,80516,19705,2159183370.464,1536657579222327817.6229,80517,11.2881,0.0011,0.0053
8337,23206,14869,15422,2128302843.0968,1517021083652798771.2788,14870,10.8795,0.0098,0.0028
19199,33695,14496,32110,2169562937.6354,1545140079499361266.4867,14497,6.9459,0.0004,0.0095
28680,117840,89160,29508,2141872681.658,1535567699917400232.0273,89161,5.7827,0.0025,0.0003
11412,67560,56148,22443,2140350395.0285,1531631861182502712.3091,56149,9.8858,0.0035,0.0004
26676,68138,41462,420,2145776476.4187,1536588148933151732.259,41463,6.9272,0.0033,0.0021
23379,95227,71848,23272,2157219017.9625,1517290063256087199.6689,71849,31.3171,0.003,0.0054
32142,70507,38365,8264,2133470840.4888,1531398407664424228.1608,38366,11.1249,0.0057,0.0002
10683,34250,23567,30512,2143319027.629,1532181790505600941.0073,23568,7.3215,0.0035,0.0022
4545,42199,37654,29663,2134599358.4042,1543420875177055583.2659,37655,14.3764,0.0065,0.000
25355,70544,45189,7191,2140581796.2603,1536300580635369617.6976,45190,12.9324,0.0036,0.0003
29181,56760,27579,15908,2143353400.9872,1541853416359259355.7671,27580,5.5519,0.004,0.0015
27893,31230,3337,27713,2132686712.0536,1556763510589832201.3443,3338,6.4371,0.0114,0.0041
28484,76170,47686,6857,2156991907.7328,1541601672421554012.0553,47687,9.6626,0.0006,0.0047
8406,84187,75781,3810,2147311343.9737,1526438952605062164.1298,75782,8.1256,0.0028,0.0019
13550,16018,2468,15300,2166361491.2458,1528513760171102211.2717,2469,7.792,0.0057,0.0125
6867,42226,35359,17038,2152534223.795,1542247927732190104.2335,35360,5.6729,0.0011,0.004
18587,66756,48169,28928,2152694754.7916,1530154257932938447.257,48170,16.7509,0.0011,0.0058
4814,38216,33402,16250,2145974707.9514,1542718133484043533.7803,33403,18.5508,0.0058,0.0057
1532,16291,14759,8118,2152618537.0913,1561309959577810851.2787,14760,12.928,0.0059,0.0079
12338,48441,36103,31531,2162610449.0622,1532654493435575931.8748,36104,23.3401,0.000,0.0083
27386,54869,27483,25605,2133530715.282,1554890270453965397.6634,27484,18.6546,0.0092,0.0028
24359,50951,26592,11336,2142982547.6877,1540545630284022192.8989,26593,2.3142,0.0036,0.0011
18706,27828,9122,3993,2149221183.1095,1556140518047410626.7635,9123,8.3545,0.0064,0.0073
13236,44849,31613,15824,2144426100.7893,1534151881672258900.7032,31614,9.3779,0.0045,0.0021
18632,81867,63235,5944,2138036399.7163,1534216505095087222.3457,63236,11.2727,0.004,0.001
6476,12406,5930,5207,2121722129.3802,1491235110700944385.0783,5931,9.803,0.0149,0.0059
9872,92634,82762,2797,2152161510.991,1542571740729091757.6928,82763,6.2657,0.0007,0.0032
32277,119631,87354,19191,2148100228.0668,1544493831165815739.8396,87355,18.8544,0.0027,0.0018
30640,57444,26804,32422,2146944726.5715,1544575451691370215.4906,26805,13.7359,0.0036,0.0049
30654,111666,81012,31211,2148697616.4929,1536417864717967865.6071,81013,3.5754,0.0007,0.0012
25893,120712,94819,14797,2141947401.2914,1537390728580725102.3113,94820,9.2048,0.0025,0.0001
7408,99209,91801,4425,2152641921.8095,1537399575732622562.3851,91802,9.8668,0.0006,0.0045
805,14603,13798,8508,2160653671.4063,1534356740516853651.1519,13799,4.815,0.0003,0.0069
5718,78387,72669,15694,2147395089.1576,1534019455586658785.961,72670,6.7493,0.0018,0.0018
3182,20717,17535,14492,2148534083.5,1545614321616754687.2427,17536,1.0695,0.0032,0.0034
21272,56804,35532,34,2154279910.0848,1539477931390732954.9784,35533,7.8658,0.001,0.0055
3610,9131,5521,9278,2160924162.7409,1510067626939922970.2184,5522,5.4302,0.0034,0.010
2464,21023,18559,5854,2161780175.9414,1535778863630210669.0483,18560,12.6177,0.0013,0.0079
2441,78969,76528,8158,2146817570.2758,1529346303113360059.1857,76529,8.7613,0.0027,0.0022
30958,60565,29607,11324,2155308216.3419,1544795549190784482.288,29608,6.9699,0.0017,0.005
24879,74425,49546,31948,2141150912.698,1536232150836208662.8812,49547,8.7575,0.0041,0.0003
26353,28626,2273,6416,2108226287.062,1551134600009736337.3018,2274,9.9129,0.018,0.002
2240,55092,52852,14400,2153744262.874,1534678030374820305.7684,52853,8.8589,0.0013,0.0043
7534,72498,64964,29728,2148374723.9294,1522012756411008244.8697,64965,10.7091,0.0034,0.0035
16053,23393,7340,8091,2149047019.8799,1548838523905796666.8547,7341,7.3648,0.0056,0.0082
15199,41126,25927,1666,2149075665.3704,1544709195933986491.8241,25928,16.8868,0.0039,0.0052
5473,45608,40135,24338,2154883441.96,1534950283330962209.5664,40136,11.4562,0.0002,0.0035
28694,72408,43714,31137,2166992283.8803,1545476837594197480.9411,43715,23.6545,0.0002,0.0077
23623,25116,1493,57,2145396762.6111,1554957579042392970.2095,1494,2.5586,0.0103,0.0089
28930,123531,94601,914,2146071560.133,1534023809530115194.1792,94602,2.3289,0.0017,0.0011
1541,52742,51201,24899,2145916087.2553,1540813381977984345.4779,51202,11.7187,0.0021,0.0015
6549,37777,31228,10506,2140146235.5818,1531924023415124015.4802,31229,3.7205,0.0038,0.0007
3377,24693,21316,13532,2146131397.4192,1543019866712960299.1905,21317,3.0037,0.0041,0.0028
6169,18747,12578,24356,2159138466.7864,1538275310091050823.2358,12579,5.4585,0.0008,0.0065
1696,100307,98611,15802,2147258635.591,1543383787484662759.2551,98612,9.4242,0.0017,0.0019
7398,76832,69434,594,2142286578.3089,1546025246090586244.1099,69435,10.5091,0.0039,0.0015
3032,12466,9434,15649,2157416941.6695,1528511520452068239.4047,9435,3.9797,0.0024,0.0094
28956,37804,8848,4196,2139779933.9464,1532695989029184845.7329,8849,5.5647,0.0071,0.0032
23109,64796,41687,15860,2149033971.7998,1536120857309216672.567,41688,6.211,0.0018,0.0024
5958,36001,30043,9625,2137604137.0457,1529925385374874229.4344,30044,5.0404,0.0052,0.0005
5113,28805,23692,2977,2159161600.2872,1536513358683131130.8079,23693,7.6685,0.000,0.0066
18791,64392,45601,23314,2144443622.3938,1536568934519620316.6224,45602,18.9302,0.0042,0.0023
22621,101205,78584,26809,2144144121.7186,1535937607420204829.8422,78585,11.8294,0.0027,0.0008
27511,111283,83772,6346,2140037125.2253,1546940776757232498.0718,83773,14.3616,0.0042,0.0009
21440,109097,87657,9465,2146688186.9261,1539739346565036978.6294,87658,5.0158,0.0014,0.0014
2686,77628,74942,6414,2146381463.087,1536766032613400994.1517,74943,1.9409,0.0018,0.0011
10549,94885,84336,5061,2147015635.068,1534075261789368699.0624,84337,4.0202,0.0019,0.0014
4192,80991,76799,19974,2155171936.3533,1530741617253323730.2418,76800,5.6055,0.0006,0.004
11384,57070,45686,7651,2154338997.8833,1541116468460766202.9747,45687,4.771,0.0008,0.0038
20664,30058,9394,241,2171130978.5256,1571675017878291218.2189,9395,15.5147,0.0026,0.0144
31183,109995,78812,11223,2150317924.5469,1530838460885612024.4297,78813,6.2453,0.0012,0.0029
24528,57587,33059,4363,2149032918.0483,1547274786147843310.752,33060,10.9755,0.0037,0.0039
7602,48913,41311,23635,2143411100.1274,1532344363977198342.3846,41312,17.1263,0.0029,0.0015
1078,18647,17569,13161,2142476751.9801,1527404251937010335.1352,17570,7.9411,0.0057,0.0036
27711,114784,87073,18122,2147272240.7488,1534398488146086105.6739,87074,7.7509,0.002,0.0023
10341,69525,59184,10127,2141903166.0451,1545479178311635507.6899,59185,6.1978,0.0036,0.0015
26074,113974,87900,4990,2141454610.8403,1544639572813902496.9598,87901,12.360,0.0033,0.0008
4258,42042,37784,9603,2141070593.136,1534027003181185141.405,37785,4.5591,0.0032,0.0007
23945,61517,37572,5800,2147493558.4371,1552259310135849309.4639,37573,13.3153,0.0038,0.0039
5449,52383,46934,4948,2155081005.0826,1554695691865692194.0432,46935,11.3992,0.0019,0.0063
18673,108954,90281,4122,2144214259.7236,1542378479211553395.3721,90282,11.1969,0.0027,0.0016
30958,48480,17522,8265,2127494408.1961,1538753739827047827.0289,17523,9.7894,0.0067,0.0002
16824,102800,85976,19775,2145418649.9281,1533642108392939344.786,85977,8.9214,0.0022,0.0015
3544,5201,1657,9262,2126792057.6665,1531485729791907558.0824,1658,3.7068,0.0124,0.004
29008,31031,2023,6461,2143245050.749,1524325929552536210.4291,2024,4.2925,0.0077,0.0056
12251,109587,97336,29528,2143982400.368,1531523503780514609.4329,97337,10.4149,0.0027,0.001
19780,114043,94263,2200,2160090411.5917,1529851604274904297.8312,94264,31.4015,0.0002,0.0066
27083,116304,89221,20784,2147509116.7809,1533517500477883561.9316,89222,3.7833,0.0012,0.0013
23650,88341,64691,30980,2153457725.6943,1541794592505114010.1096,64692,5.7018,0.0008,0.0041
18100,87370,69270,4524,2156245591.698,1542221891518702186.6163,69271,7.7126,0.0003,0.0039
28887,98213,69326,27952,2163633079.3738,1531098908239713592.3093,69327,20.0849,0.0002,0.0063
14909,53853,38944,13769,2155859339.9739,1532420287607477689.332,38945,2.9218,0.001,0.0043
27806,64014,36208,8798,2167771809.7806,1544592668950387247.6065,36209,15.2305,0.0004,0.0097
3030,42882,39852,18010,2156909932.5489,1543717561821705726.7627,39853,8.9241,0.0007,0.0054
27615,66206,38591,8907,2146481859.0622,1539188411755018798.0252,38592,6.1364,0.0021,0.0018
30640,38102,7462,28540,2149745482.0117,1516794932870556509.3493,7463,9.0325,0.0048,0.0086
27786,103924,76138,11623,2159914802.3259,1536489582270541152.827,76139,16.0166,0.000,0.0051
6657,71783,65126,31258,2145438969.8422,1525617060293660401.6234,65127,14.7262,0.0039,0.0029
27554,80280,52726,678,2152405272.3895,1542460701935935283.2049,52727,6.5174,0.0007,0.0036
1617,46822,45205,24574,2133420120.9422,1534771419260603622.7141,45206,9.7546,0.0057,0.0006
23860,26006,2146,13369,2230527830.3978,1512441359566767989.3909,2147,19.4062,0.003,0.0313
22658,32262,9604,3926,2110498818.3446,1546332484853632861.2603,9605,14.3485,0.0149,0.0007
10850,32787,21937,24651,2138056413.9376,1538669049804457136.8945,21938,7.3756,0.0056,0.0006
1257,39279,38022,3110,2161542181.9048,1550280964281701294.7901,38023,11.2769,0.0002,0.0069
17948,36991,19043,13630,2157269779.2454,1534485468586022969.3076,19044,11.1717,0.0011,0.0066
9291,40458,31167,25027,2136691513.2331,1540602068258033581.0781,31168,12.8116,0.0078,0.0005
8724,17278,8554,201,2145266643.986,1534608594738334498.0985,8555,3.9466,0.004,0.0027
24314,66105,41791,17916,2151719514.9487,1544170603256863079.3549,41792,12.2785,0.0017,0.0036
22391,34882,12491,4038,2137144038.4709,1543472517255250988.8053,12492,5.5048,0.0093,0.0016
22840,116265,93425,14981,2147294101.5881,1534224586829799519.2942,93426,12.7356,0.0022,0.0019
10089,81610,71521,12479,2144978322.8183,1533926644690686637.3756,71522,3.1958,0.0019,0.001
3217,43348,40131,16251,2149554532.4624,1537632002697374996.5953,40132,12.1173,0.0036,0.0031
32555,132456,99901,32092,2148450421.9673,1539817179016500847.9242,99902,3.2495,0.0008,0.0012
22464,100566,78102,16146,2144828445.7472,1533281338958482656.0896,78103,2.6645,0.003,0.0009
2954,96839,93885,20228,2149250244.3527,1525139852954431997.2043,93886,23.4721,0.0019,0.003
19315,92376,73061,18813,2146008850.3339,1545829753590148989.5035,73062,9.850,0.0034,0.0022
629,24953,24324,3847,2144262557.1013,1536499018461600033.5836,24325,8.0329,0.0039,0.0025
16376,114071,97695,23697,2148656261.7594,1537947427343946097.5656,97696,10.8149,0.0011,0.0028
31249,108087,76838,8713,2143999545.4673,1551661568171961999.8673,76839,16.7082,0.0037,0.0026
9543,40790,31247,13179,2165987422.5394,1542777491162612749.3949,31248,11.5149,0.0001,0.0072
7498,15684,8186,10218,2162116304.0563,1539918858879749547.0432,8187,7.5557,0.0019,0.0099
20514,33461,12947,9523,2137507983.3301,1535992016594350787.5254,12948,4.1707,0.0063,0.0016
31488,129065,97577,27005,2166454731.911,1541244216295164701.7781,97578,24.0951,0.0002,0.0068
22054,57562,35508,2095,2155681461.267,1530639615741244654.6463,35509,10.5528,0.0014,0.0042
1981,9487,7506,14582,2153361226.6727,1526950596382704341.0082,7507,2.5507,0.0053,0.0062
30901,32915,2014,24581,2164130095.7712,1525754225633661631.1094,2015,5.0488,0.007,0.0156
7168,103997,96829,5973,2149969356.0521,1543365114620226237.8687,96830,5.1455,0.0012,0.0026
31274,106122,74848,9477,2150353738.2599,1535235251362678162.2377,74849,6.8804,0.0008,0.0023
8139,28057,19918,2690,2154524373.7181,1533783894576824614.6763,19919,10.2596,0.0013,0.0065
8733,10117,1384,16734,2256879810.9552,1532963207681363897.315,1385,15.9785,0.0011,0.0406
16378,20860,4482,32453,2138690067.1586,1550793731731881118.8455,4483,2.4002,0.0079,0.0044
29314,78990,49676,3330,2151051129.9362,1543106300218594991.0648,49677,8.5957,0.0015,0.0031
20557,33436,12879,13417,2141116043.813,1551042072986182811.3719,12880,10.4751,0.0062,0.0036
179,50926,50747,17723,2150720418.8568,1533516351897303024.8498,50748,13.0452,0.0016,0.0028
219,14016,13797,18618,2151030165.8937,1534122781267747936.6116,13798,2.5391,0.0027,0.0046
24942,86206,61264,18449,2142836691.1196,1547821597963333029.7654,61265,10.263,0.0038,0.0013
31946,66167,34221,26803,2158368336.5993,1538782946791344459.7,34222,9.116,0.0006,0.0049
26336,106600,80264,22468,2151480619.3215,1534728520709408694.4867,80265,7.2023,0.0005,0.0031
11463,101088,89625,29579,2141456145.9452,1532823851043762749.5374,89626,11.0831,0.0032,0.0005
21974,85202,63228,30388,2141927336.7176,1537246083803083013.484,63229,15.0484,0.0028,0.0006
23439,70694,47255,17392,2150873203.0548,1537591422275403311.6563,47256,4.0755,0.0008,0.0028
1707,37891,36184,7708,2159034389.2573,1525904892716849191.751,36185,14.095,0.0008,0.0073
29214,65086,35872,20407,2148855644.4315,1542909498137348405.6428,35873,9.6008,0.0024,0.0028
5664,58642,52978,15915,2157214908.5303,1542603062750339780.6588,52979,5.0406,0.0007,0.0046
6009,22101,16092,20890,2157989773.3136,1534598452766547394.2594,16093,7.8672,0.0022,0.0083
29572,90960,61388,220,2141100242.8011,1534830129664111417.3284,61389,8.5081,0.0041,0.0008
9866,57420,47554,20229,2152375469.1075,1540437225861930150.8607,47555,2.3688,0.0009,0.0027
7321,22134,14813,8733,2177708223.6226,1539430558223390266.4769,14814,26.4712,0.0008,0.0119
26408,31577,5169,7757,2134542830.1236,1550225924088236860.4244,5170,3.3975,0.0084,0.0026
5857,39468,33611,20848,2157592471.7892,1550918930023668815.8893,33612,16.0167,0.002,0.006
20139,95628,75489,32336,2157569603.3152,1540927893466902729.4329,75490,6.9377,0.0001,0.0037
32093,105017,72924,15121,2140920247.1039,1544849014268788542.8609,72925,20.2137,0.0037,0.0011
9195,33998,24803,18265,2155691227.2413,1542034368786285465.5764,24804,5.9472,0.0011,0.0057
21300,106774,85474,21828,2143218915.2091,1535663134418801491.0162,85475,11.0732,0.0027,0.0004
13331,102103,88772,2277,2156344404.4742,1539600769970344605.1932,88773,9.5814,0.0001,0.0038
14558,78929,64371,20471,2135914506.883,1535039582506791763.6316,64372,13.3057,0.0067,0.0005
3656,28277,24621,24022,2151404459.5695,1538088710953444007.9955,24622,10.8213,0.0036,0.0035
23738,68874,45136,872,2145994238.7178,1538652488708803034.6848,45137,4.477,0.0022,0.0016
30009,75006,44997,15361,2144722093.8887,1532059680335333694.7448,44998,5.1573,0.0034,0.0017
10444,44697,34253,1544,2150406332.5662,1537634848876996893.0023,34254,3.5443,0.0019,0.0028
16269,73454,57185,5635,2144267494.6581,1535276295490544252.0142,57186,14.7541,0.0037,0.0016
20657,59992,39335,21300,2149609497.1469,1543005735636099629.5734,39336,5.1201,0.0016,0.0028
13022,106875,93853,26011,2150014279.976,1542637706439999218.5415,93854,7.6069,0.001,0.0021
27838,41240,13402,25386,2167637984.6092,1527028358495202228.427,13403,11.8061,0.0002,0.0097
32640,40902,8262,23265,2144366749.863,1509153024402749143.2507,8263,10.9443,0.0074,0.0057
11866,68231,56365,17913,2138151704.2025,1534515983767216454.0254,56366,6.221,0.0049,0.0002
850,84938,84088,11988,2143675438.7475,1538586390073114536.2487,84089,6.0543,0.0025,0.0009
5176,83300,78124,3891,2143533858.7811,1535884828846498223.4499,78125,5.8332,0.0025,0.0003
6227,43515,37288,12909,2133877772.3673,1538680410503365615.0028,37289,14.6823,0.0076,0.0007
15067,114745,99678,10317,2146158263.393,1526072639231443149.7026,99679,13.3501,0.0031,0.002
12898,43722,30824,2123,2140237462.4362,1542631677637667836.0602,30825,6.5908,0.006,0.0008
14765,68533,53768,22532,2146331698.0761,1523354658733062570.564,53769,7.2668,0.003,0.0025
18311,80459,62148,9223,2145183024.1493,1529706674107549617.607,62149,9.3104,0.0024,0.0019
623,15570,14947,31595,2120530678.9552,1516235259047054078.3621,14948,15.2733,0.0143,0.0002
23401,113807,90406,28590,2133775261.721,1535063618631613326.3353,90407,19.2267,0.0057,0.0002
18592,110411,91819,17778,2142688723.9518,1534428420933597856.3356,91820,5.089,0.0035,0.0002
31091,66175,35084,13389,2146312092.8111,1533522885488648960.1214,35085,4.1174,0.0026,0.0021
23186,56563,33377,28368,2156354815.9616,1540307550748351359.1973,33378,4.792,0.0008,0.0047
15284,77403,62119,19812,2141861046.565,1528990607909782879.169,62120,8.3714,0.0034,0.0013
7246,36426,29180,28573,2141993725.1859,1541855227219902092.4998,29181,2.4985,0.0033,0.0012
25465,79527,54062,22674,2136486409.6493,1540009511305508904.3203,54063,9.8032,0.0044,0.0005
1008,23403,22395,12618,2151184777.6075,1539622161445354919.0168,22396,5.0335,0.002,0.0041
12779,91636,78857,28998,2150234469.5537,1540628836761787666.9289,78858,7.2769,0.0013,0.0025
28912,51930,23018,19270,2138466329.5026,1535759887590886101.8063,23019,9.9429,0.0057,0.001
11444,20033,8589,4380,2177176594.7782,1538929430754442118.0899,8590,11.8818,0.000,0.014
31696,99336,67640,17004,2160602442.4926,1535557846053310853.5848,67641,17.1645,0.0001,0.0054
26987,102617,75630,13369,2142520606.7442,1533980917741775192.4847,75631,4.669,0.0028,0.0008
15513,63392,47879,11322,2164251254.8768,1537230308146632361.1806,47880,15.7904,0.0004,0.007
13476,65308,51832,9862,2140345812.4377,1529042489200726931.5006,51833,4.7622,0.0038,0.001
20000,101733,81733,22053,2147474106.2253,1528623240260645216.8733,81734,3.8877,0.0021,0.002
27449,70205,42756,18549,2134227213.1587,1542405200765611882.3331,42757,15.3335,0.0065,0.000
13316,66977,53661,9339,2151837707.3455,1546959260829627618.0131,53662,15.4107,0.0013,0.0041
16871,81758,64887,17911,2144576386.0403,1532560864321692840.8179,64888,5.0968,0.0022,0.0011
7095,73525,66430,10918,2137536152.7242,1537674836759105468.5746,66431,12.0517,0.0057,0.0013
6184,93214,87030,4789,2142271600.2469,1537150515835429636.1541,87031,2.1873,0.0035,0.0004
26347,43443,17096,32048,2159694598.2822,1549503286132476098.2663,17097,4.7939,0.0024,0.0074
31603,130679,99076,2925,2147102433.8834,1534646122061350004.4406,99077,2.5066,0.0016,0.001
17087,75816,58729,10532,2154756072.3461,1536696597516275041.5925,58730,6.8498,0.0005,0.004
16883,19430,2547,2890,2137954634.8752,1515528808533036863.4923,2548,7.7116,0.0103,0.0048
20638,79473,58835,23923,2145971774.2204,1539533506024350259.1301,58836,6.9036,0.0027,0.0024
28060,100424,72364,25595,2140128972.9023,1544910246380824471.6652,72365,13.2433,0.0044,0.0012
14135,56021,41886,23035,2154183305.2483,1540512611644486751.1189,41887,5.0512,0.0003,0.0051
18695,52380,33685,16968,2148834908.0855,1531450412664069801.9411,33686,16.4928,0.0024,0.0028
9728,85587,75859,10301,2154684821.8446,1548872110114527512.291,75860,12.6835,0.0005,0.0045
31990,61465,29475,10883,2157130344.181,1524053249887572822.3565,29476,20.9782,0.0024,0.0073
11407,38422,27015,1627,2149684250.2587,1529621598196254699.5234,27016,5.7327,0.0024,0.0031
30678,118828,88150,20026,2145405398.7201,1543744841989812532.5906,88151,11.9352,0.0021,0.0011
28693,59098,30405,14978,2157239026.0315,1531518264052616545.6462,30406,8.0112,0.0002,0.0051
30130,119112,88982,18914,2144916920.4408,1532969338705265124.0025,88983,9.0196,0.0025,0.0011
23397,71620,48223,31541,2146118032.3175,1538784742136906859.0349,48224,1.3809,0.0022,0.0017
2804,29010,26206,20307,2142828388.5556,1540772986331113613.8402,26207,2.9573,0.0038,0.002
31806,60065,28259,29228,2130031554.1808,1543583309431850189.4649,28260,9.6517,0.0075,0.0001
29745,52348,22603,3197,2120350010.7136,1544457303189827532.1433,22604,18.7266,0.0116,0.000
10516,99627,89111,3596,2148080386.7969,1536892052141918416.2453,89112,11.8702,0.0013,0.0013
25126,30254,5128,819,2163245358.4892,1529656972719451914.6675,5129,4.6019,0.0016,0.0089
13294,107442,94148,29782,2149617980.8105,1542767324476173639.064,94149,8.6945,0.0013,0.0021
1734,25428,23694,19912,2129790795.3952,1528880776015155727.1027,23695,9.4172,0.0078,0.0001
11626,57876,46250,19309,2151847070.2161,1534742231269656445.7645,46251,9.2918,0.0011,0.0042
7109,77138,70029,27285,2147254874.1358,1537204853728807446.6731,70030,4.8756,0.002,0.0015
5557,66106,60549,28064,2140965385.0689,1536559662208697657.5535,60550,3.8122,0.0026,0.0005
31279,84303,53024,21594,2144860635.767,1536899576089945889.2932,53025,7.4511,0.0024,0.0011
3323,12357,9034,27526,2159894095.6219,1516758181600401118.6938,9035,18.8313,0.0048,0.0134
25380,82653,57273,7654,2143601954.394,1535186533720247794.7308,57274,18.6827,0.003,0.0023
907,6370,5463,26801,2194048096.765,1512635044425251028.2662,5464,19.7374,0.0004,0.0229
1890,25739,23849,32032,2140057111.92,1526276778021040114.6923,23850,8.6764,0.0049,0.0025
920,14512,13592,17613,2144587303.77,1523893070429011967.6296,13593,11.0978,0.0061,0.0046
5454,54426,48972,28242,2140774954.2837,1546493489661229015.3825,48973,5.0682,0.0037,0.0018
7678,95870,88192,14106,2144450250.0367,1535928440307417858.046,88193,11.2292,0.0022,0.0007
26264,118077,91813,18665,2155719595.4668,1543624152674696445.583,91814,7.743,0.0006,0.0046
30786,51646,20860,25445,2121855876.3386,1543154104321067808.2899,20861,14.565,0.0122,0.0013
7608,8889,1281,30599,2163861868.5016,1477939330535367202.7383,1282,18.0239,0.0121,0.025
213,37685,37472,16262,2143358100.3729,1523978311546858236.8365,37473,6.2481,0.0041,0.0027
8473,42344,33871,6056,2144380642.4636,1548701840435471195.2024,33872,10.529,0.0047,0.0024
19254,63400,44146,31061,2140131002.6249,1537030567456228406.2257,44147,12.3761,0.004,0.0005
25899,42215,16316,11288,2146521142.8138,1525369661602175645.2662,16317,11.4325,0.0069,0.0046
6436,34641,28205,10103,2153524034.5423,1544025920186519581.4233,28206,3.4725,0.0008,0.0046
5442,95271,89829,22198,2141458353.6902,1540249772269668150.913,89830,12.4622,0.0036,0.0007
5025,71779,66754,26728,2143294151.1038,1537573019324498404.6011,66755,9.7036,0.0024,0.0004
8412,92309,83897,5546,2146930360.5469,1538413386062146812.8568,83898,21.2873,0.0021,0.0019
28107,66189,38082,25935,2150034512.6437,1519642276464445319.5766,38083,24.7236,0.0035,0.004
19034,70995,51961,5205,2139386754.069,1532181060288135081.8079,51962,7.7555,0.0041,0.0009
4498,18300,13802,15405,2159009263.7812,1521495580582334105.7542,13803,3.7543,0.0037,0.0087
26393,88788,62395,18073,2136707503.2518,1538729833462229888.9631,62396,8.7549,0.0056,0.0006
15199,17904,2705,6215,2157285204.6559,1482950478346432433.5331,2706,7.4764,0.0097,0.0148
32431,118850,86419,13210,2133665757.9825,1556231021941010401.4359,86420,61.5684,0.0068,0.0003
1172,65250,64078,18913,2154841522.7765,1534791034263041648.6921,64079,7.2147,0.0004,0.0043
31526,116601,85075,11076,2147960144.3356,1530163080266864296.6788,85076,3.4286,0.0015,0.0015
17978,101461,83483,11457,2154450385.2848,1533486791315243556.6689,83484,17.7183,0.001,0.0041
27051,68305,41254,5544,2147471173.2107,1536665429928160442.8367,41255,5.3051,0.0019,0.0017
1612,95504,93892,16090,2144693503.6335,1538338483772871688.7513,93893,4.0685,0.0025,0.0006
7846,18212,10366,18188,2166306186.3981,1527379980782465498.1341,10367,7.325,0.0017,0.009
13802,29687,15885,18928,2144733590.1856,1550513555469135738.8422,15886,10.5139,0.0043,0.0031
18976,82004,63028,11757,2151045284.7311,1539427473554585860.3963,63029,2.2955,0.0003,0.0023
22048,51428,29380,4321,2153988771.8588,1540560220092288748.2899,29381,4.9978,0.0009,0.0035
215,70508,70293,32058,2147584007.6768,1533342417669134025.063,70294,8.1563,0.002,0.002
5731,84680,78949,29421,2138936847.2018,1541715184996321813.0562,78950,7.3078,0.0044,0.0003
25792,107367,81575,15773,2145593817.826,1534023482508196895.4488,81576,11.895,0.0034,0.0017
14241,62409,48168,1387,2140284133.2833,1532222786605777526.4547,48169,6.0982,0.0041,0.0009
25272,119830,94558,20670,2141500829.3778,1535286108170632772.3391,94559,7.0068,0.0026,0.000
5102,76571,71469,10333,2156335309.861,1543665352249169845.3756,71470,19.7439,0.0016,0.0059
15515,107226,91711,7548,2155917676.9948,1526310351375426027.1601,91712,16.0338,0.0007,0.0044
2411,20657,18246,1267,2167145394.687,1533506409894041395.8209,18247,15.629,0.0009,0.0106
19473,57671,38198,11039,2154487196.0356,1540919460938373512.2026,38199,4.5324,0.0012,0.0046
11905,76780,64875,14103,2152646816.3758,1542396556745876827.4311,64876,10.5619,0.0005,0.0033
27894,76832,48938,17585,2135424355.6375,1534194490904031496.0666,48939,7.5881,0.0052,0.0002
29284,68848,39564,9551,2139571799.8563,1546858367130142572.3959,39565,9.5528,0.0046,0.0011
14141,92424,78283,9018,2139848356.0256,1532813006235164982.8361,78284,6.2086,0.0041,0.0005
29869,112871,83002,16994,2137526854.0492,1544102057577045338.9736,83003,20.2712,0.0061,0.0007
23196,105876,82680,4174,2144133452.435,1537392507407018521.0757,82681,15.3364,0.003,0.0024
10531,102850,92319,2055,2149669864.6466,1539100333897701852.0507,92320,5.1612,0.0012,0.0024
23095,68512,45417,9361,2151381496.8973,1541394448488071848.446,45418,8.9119,0.0014,0.0037
1248,95904,94656,25802,2143872444.3244,1538705004653474013.8523,94657,7.0906,0.0023,0.0005
25556,30253,4697,11754,2151071575.7231,1579147359756731658.3365,4698,7.6515,0.0084,0.0106
13891,49531,35640,10867,2159645131.8957,1539955593164308617.0002,35641,11.0389,0.0001,0.0059
16687,39522,22835,19342,2142229158.1964,1527321923165917042.2799,22836,3.732,0.0048,0.0018
5870,60735,54865,12809,2147803766.6649,1541753401627467839.1668,54866,5.6946,0.0021,0.0024
13345,53532,40187,8186,2138709435.9218,1537624275421649270.649,40188,7.6142,0.0041,0.0003
10295,28413,18118,24576,2141318485.674,1523242277406140634.8074,18119,9.6753,0.0079,0.0028
16702,72671,55969,5444,2141492267.3618,1537898800779092108.4331,55970,13.6988,0.0039,0.0016
23127,26138,3011,9763,2174407167.9515,1499823991039771621.908,3012,6.6993,0.0067,0.0153
2155,64981,62826,22069,2138456251.6346,1537268664387339679.323,62827,12.2795,0.0042,0.0007
1798,90090,88292,18420,2141354427.9248,1536478494026967755.6516,88293,2.9544,0.0028,0.0003
4087,24801,20714,21385,2142737108.0186,1532970167900450829.519,20715,10.7649,0.0044,0.0034
31179,41427,10248,7895,2144825710.031,1541909352469173362.6522,10249,11.1027,0.0044,0.0038
31411,98671,67260,15755,2154703940.5862,1538662394546935986.5332,67261,8.4191,0.0001,0.0034
19047,106114,87067,32675,2143811872.2246,1535248687924355803.8348,87068,5.4182,0.0025,0.0004
22094,103477,81383,29072,2144786185.3909,1533454783255857644.0173,81384,6.5181,0.0021,0.0009
24057,95775,71718,17156,2149340820.6404,1549013976846448716.0782,71719,10.5988,0.0025,0.0027
23258,66770,43512,18488,2161945853.2229,1534227065056014305.2346,43513,15.8284,0.0007,0.0071
2381,15790,13409,22139,2122412806.4942,1539769294041167482.9395,13410,21.4039,0.0107,0.0003
24827,63310,38483,21885,2149507243.3391,1554218981579203149.2768,38484,16.6862,0.0038,0.0042
18856,76842,57986,26283,2143735361.0628,1535239392438727853.5623,57987,16.5717,0.0036,0.0018
1112,4574,3462,20108,2119183916.7742,1560880464487903323.3842,3463,10.4687,0.0157,0.005
31410,129590,98180,31358,2139256899.5891,1541481469773380486.1233,98181,14.0878,0.0036,0.0004
11878,101392,89514,2167,2149544211.4016,1533576957001674801.9099,89515,10.1662,0.0013,0.0025
27689,120752,93063,5823,2147670865.8461,1538200181929612962.9599,93064,4.3944,0.001,0.0011
4553,79839,75286,22487,2135124696.1176,1537850695259031143.2985,75287,23.4436,0.0056,0.0002
8443,51104,42661,7139,2139622901.6934,1535249554833718483.863,42662,5.941,0.0041,0.0006
8947,66906,57959,23956,2128964179.0293,1523157050371849059.9821,57960,23.6489,0.0081,0.0006
21681,112906,91225,21770,2148402981.5573,1546537359689861487.9048,91226,7.0241,0.0017,0.0025
18362,103191,84829,14892,2142751451.2519,1540015808954866492.3014,84830,14.7063,0.0039,0.0007
20017,32387,12370,18741,2136454503.0922,1542056508208957519.1604,12371,10.3498,0.0105,0.0035
22802,70321,47519,26123,2149717634.9492,1531092623431125780.0813,47520,12.1622,0.0019,0.0031
13468,38969,25501,15643,2137663707.1987,1522553187972365834.0391,25502,6.4262,0.0063,0.002
2852,67012,64160,6687,2148884507.6827,1528246664329066827.7826,64161,6.7484,0.0033,0.003
7636,103842,96206,6480,2141379945.1192,1537389890996491382.3639,96207,5.8092,0.0028,0.0002
10938,23950,13012,23981,2149519802.7344,1555377120576703708.3329,13013,2.8635,0.0046,0.0063
16881,115306,98425,21172,2150618708.4573,1539810300237980857.7665,98426,3.4454,0.0007,0.0023
28560,31988,3428,5250,2105970116.5471,1569131996431870127.4691,3429,17.396,0.0222,0.004
11763,94397,82634,22552,2144332055.4906,1537773697397732485.0958,82635,8.5548,0.0022,0.0009
21908,36633,14725,13210,2129023440.3784,1564113147405184999.5405,14726,17.458,0.0097,0.0038
32585,107204,74619,13106,2157306534.9242,1530434336696810787.0947,74620,11.8166,0.0008,0.0051
19266,68165,48899,12192,2151655338.6918,1540297430166803233.4565,48900,7.5698,0.0016,0.0045
28632,92862,64230,4926,2147244784.5516,1535914678885629291.1109,64231,4.0061,0.0011,0.0013
6381,73796,67415,12097,2153191798.4405,1536147285852055137.3556,67416,5.251,0.000,0.0026
31710,83063,51353,20941,2162459382.1766,1541543516517245832.3596,51354,12.6432,0.000,0.0061
14121,37679,23558,14403,2145681959.9715,1541662829362862982.1792,23559,2.7196,0.0038,0.002
25210,89271,64061,28312,2157320464.2892,1525663687873550707.0026,64062,28.1031,0.0011,0.0063
1126,55532,54406,29271,2137406765.8141,1523374885548882177.9146,54407,21.2913,0.007,0.0022
21245,50984,29739,14646,2152545065.1541,1519338153118200314.1239,29740,13.9302,0.0026,0.0053
21458,67980,46522,23498,2157025265.1039,1541042286081780489.9416,46523,13.6988,0.0014,0.0052
24953,36668,11715,9964,2139539567.5362,1549509019210893522.7465,11716,14.6637,0.0082,0.0042
1493,10045,8552,4079,2161280666.9791,1555810119325081750.1846,8553,6.7896,0.0023,0.008
14503,94565,80062,7331,2146223034.145,1536548234675537754.5661,80063,3.0495,0.0018,0.0011
24143,114772,90629,21924,2145477695.0128,1535511209903565778.9773,90630,6.6509,0.0025,0.0008
19631,23191,3560,17139,2128247409.2963,1530727944878160446.8735,3561,16.7607,0.0182,0.0069
14021,72038,58017,449,2144454323.1779,1534234230037150931.3792,58018,3.7632,0.0034,0.0009
311,59402,59091,6184,2132953746.2175,1543568990609335023.9604,59092,17.9884,0.0053,0.0001
13157,44194,31037,20283,2142138909.1375,1536450908390775416.464,31038,7.9547,0.0032,0.0011
28458,103675,75217,26246,2147581773.2977,1522879804638951686.5124,75218,9.9263,0.0025,0.0029
7165,11321,4156,23651,2132634207.3712,1546273729587684858.1406,4157,8.301,0.0113,0.0051
9606,100748,91142,16817,2150932904.3949,1535001017569698958.3942,91143,6.2681,0.0013,0.0026
5614,88291,82677,25874,2142280775.4138,1522591714607892376.0544,82678,35.8126,0.0047,0.003
20836,99187,78351,12246,2137077227.6511,1526190363681429464.6233,78352,19.3952,0.0054,0.0013
16987,103449,86462,14752,2147964449.3326,1542759946854119114.7175,86463,8.2638,0.0021,0.0023
1613,82079,80466,20593,2149476647.2895,1541043201302765265.2445,80467,7.465,0.0012,0.0022
25556,63501,37945,15509,2139553188.9529,1534963025199082219.2933,37946,10.561,0.0061,0.0008
13114,108063,94949,29648,2146964308.5061,1531241004185314112.6757,94950,6.0727,0.0019,0.0018
2113,63861,61748,12064,2155207039.4293,1551431331400129021.2474,61749,11.6018,0.0017,0.0054
5884,81745,75861,7149,2154990415.9283,1532504194502368546.4875,75862,19.7965,0.0008,0.0034
11287,66146,54859,16640,2148101474.4315,1531625767568227978.3682,54860,5.3781,0.002,0.003
2869,38590,35721,32355,2153168710.2392,1535867729997803919.6577,35722,6.0505,0.0008,0.0033
26353,83620,57267,5267,2149479617.7594,1546280041832278628.8226,57268,8.8793,0.0025,0.0029
29839,30031,192,2727,2160166167.5026,1437986509402971514.9443,193,3.9268,0.0358,0.039
30670,92286,61616,21063,2141061364.2619,1536708999845006339.5469,61617,4.9622,0.0037,0.0005
25287,72106,46819,17501,2166264428.6909,1534277413231797611.3203,46820,26.2754,0.0009,0.0075
27157,35085,7928,15802,2143024558.2254,1552715986282572637.2408,7929,6.8296,0.0067,0.0034
22202,45121,22919,1211,2143519888.2965,1538146205685434316.4393,22920,9.5135,0.0067,0.0016
13426,75760,62334,1849,2144432013.9713,1543003430400955791.9509,62335,32.8944,0.0035,0.0015
28588,87866,59278,17927,2133985745.5705,1537207825620505613.7753,59279,13.771,0.0051,0.0006
11656,21784,10128,31123,2165556997.9926,1539420757784726174.6779,10129,10.7928,0.0011,0.0094
18574,27029,8455,14455,2176848647.3127,1536275299018290546.6898,8456,10.1704,0.0006,0.0157
26656,44703,18047,13138,2153326989.9681,1544655711799983133.733,18048,8.3924,0.0029,0.0059
1575,97102,95527,12668,2144893462.378,1538515343121885252.745,95528,5.0024,0.0021,0.0006
25009,112532,87523,24962,2154439889.921,1538153665043364189.6369,87524,7.7533,0.0004,0.0032
30729,88103,57374,18726,2150200738.532,1543799761092885109.7369,57375,8.1617,0.0018,0.0026
10576,98891,88315,24806,2152032576.6214,1546392381710775169.3287,88316,16.7583,0.0015,0.0031
15068,57139,42071,4934,2160027102.3986,1535323669605017481.8277,42072,8.7606,0.000,0.0053
32723,52053,19330,19697,2149678050.3871,1529217516580743288.4093,19331,6.9829,0.0037,0.0043
3660,100972,97312,18784,2144657315.6631,1541136718651811057.1412,97313,7.4987,0.0022,0.0012
679,913,234,23120,2210428219.7362,1460253598369368418.5091,235,9.5195,0.0213,0.0519
6340,68522,62182,7681,2148330526.6501,1531153310344187704.923,62183,12.5103,0.0021,0.0029
7260,15851,8591,7351,2139503113.1425,1514003469181247654.7218,8592,11.1975,0.008,0.0047
27774,87843,60069,727,2158328191.4737,1543582267066907058.0342,60070,15.1473,0.0004,0.0048
18310,112594,94284,1376,2136927523.2579,1537445964634514009.3108,94285,17.4218,0.0044,0.000
3088,11679,8591,6453,2152887339.3399,1554289613622554340.8389,8592,9.8388,0.0075,0.0085
15687,97558,81871,23849,2161004350.784,1532792264261997699.1135,81872,17.3713,0.0005,0.0055
20816,94860,74044,797,2155545394.8888,1529000815840256956.575,74045,25.1681,0.0008,0.0044
12037,61003,48966,20246,2144311693.9016,1539192628154368334.3442,48967,3.8729,0.0029,0.0013
1300,30554,29254,2806,2149605691.964,1535081217416778245.0014,29255,18.8342,0.0019,0.003
27684,109663,81979,29360,2149877715.7307,1533402831138042722.7241,81980,4.006,0.0012,0.0023
11440,71364,59924,32748,2143213859.6565,1541703773169270855.4141,59925,4.5175,0.0033,0.0016
15759,72532,56773,6290,2142946931.4155,1537867021267971805.2598,56774,6.8248,0.0026,0.0011
15531,66862,51331,8178,2141059182.1165,1528156232258555823.5396,51332,8.9458,0.0046,0.001
2764,87614,84850,7590,2149826019.9817,1538104748190023702.2032,84851,6.4183,0.0007,0.0022
10620,34210,23590,16115,2163765308.8493,1531926918136761084.1088,23591,14.8125,0.0005,0.0095
30243,127287,97044,8945,2147741688.3164,1532952282727630371.3284,97045,0.7515,0.0016,0.0015
15519,59555,44036,15900,2140255218.6232,1534886645666652257.462,44037,23.2816,0.0053,0.0036
18260,81280,63020,7984,2144932274.9551,1543708645823743413.4556,63021,7.2914,0.0028,0.0015
24328,26164,1836,14366,2154512293.975,1523346623900980525.0892,1837,10.1018,0.0186,0.0103
29931,92769,62838,16443,2147348870.4147,1547512304791669652.2868,62839,11.8396,0.0033,0.0026
7985,61668,53683,9943,2158740739.0041,1537626325157951600.9469,53684,12.2586,0.0003,0.0049
6508,7611,1103,15025,2148948348.3406,1631261038446881369.6594,1104,12.3053,0.025,0.0266
62,40296,40234,17434,2146958369.2044,1532761676175648063.4786,40235,3.0429,0.0018,0.0025
16937,79666,62729,13230,2152818119.6541,1528748117849057627.3073,62730,23.9554,0.0024,0.0056
5253,92801,87548,21220,2143835378.7452,1538471904522531222.6784,87549,9.8191,0.0018,0.0007
8307,86473,78166,10790,2154018569.4473,1544369922142716908.1736,78167,5.1745,0.0005,0.0037
22568,33785,11217,19244,2110603515.8644,1526391859465706907.7849,11218,17.0138,0.0163,0.0001
26576,37782,11206,14319,2147822494.4506,1526819632328219955.102,11207,7.1793,0.0055,0.005
25193,40258,15065,11394,2140106393.7124,1528624823783387577.2356,15066,2.8671,0.0065,0.0024
13139,48016,34877,14034,2160037234.0399,1534679069988404546.7345,34878,8.6375,0.0008,0.0061
24753,54427,29674,19037,2148015148.2658,1552279161092576386.2161,29675,26.1123,0.007,0.0049
29573,124279,94706,27384,2148339862.2663,1532035047066031404.4195,94707,4.6944,0.0016,0.0024
1529,20388,18859,27666,2147816617.601,1520880312729401609.1717,18860,13.7944,0.0056,0.0051
11884,44940,33056,1240,2133282965.8217,1534602833016786844.4975,33057,10.5672,0.0065,0.0011
13135,76772,63637,9718,2148931275.3346,1532384238380794208.3784,63638,8.6447,0.0016,0.0026
29075,91008,61933,2298,2150196464.9769,1543379399110136682.3343,61934,10.0365,0.002,0.0031
5096,49315,44219,9630,2146623891.6617,1546061638422787819.1995,44220,17.3656,0.0031,0.0029
19673,41593,21920,31878,2158341894.8749,1536211732654023366.5149,21921,3.7826,0.000,0.0055
7461,84961,77500,10509,2145873860.8867,1531797283921744715.5017,77501,5.0698,0.0023,0.0013
18151,40709,22558,4955,2134452809.6342,1551535925222246597.505,22559,8.9129,0.0078,0.0007
26677,77244,50567,7276,2129681345.2089,1540249198402290862.4687,50568,14.7247,0.008,0.000
16639,87240,70601,18812,2149778543.9067,1543370146429990020.1649,70602,12.5765,0.0016,0.0025
14772,72852,58080,10390,2156898967.6172,1541447253223658286.9968,58081,7.4929,0.0003,0.0048
13724,111459,97735,23462,2147710960.6721,1531706211189877589.0344,97736,17.7236,0.0022,0.0022
8709,35034,26325,18807,2142310555.2323,1542787921149150418.8361,26326,5.3062,0.0043,0.0013
23692,35737,12045,17400,2151873043.9695,1547861223877040622.5532,12046,5.1812,0.0044,0.0067
218,74848,74630,5733,2148220316.3549,1532412709362318200.5857,74631,11.7295,0.0016,0.0026
5609,20638,15029,6423,2135477254.3301,1535464957045447738.951,15030,6.7821,0.0074,0.0021
30593,69117,38524,1939,2162614988.0205,1520990907177817440.4699,38525,17.0407,0.0013,0.0067
2466,8549,6083,3837,2136678225.5342,1544917546262067399.6821,6084,9.9485,0.0113,0.0032
16632,53985,37353,12188,2153568777.5697,1535898616929152534.7712,37354,1.728,0.001,0.0033
25061,83876,58815,13090,2150878703.7894,1541229265118165823.0977,58816,4.7525,0.0009,0.0032
23506,55632,32126,27,2164804542.7554,1524790331245875312.118,32127,17.4903,0.0005,0.009
3759,32858,29099,8822,2158683432.8287,1530574773325863015.9381,29100,11.7211,0.0009,0.0071
7344,51253,43909,13322,2126890676.286,1522770956538884084.0046,43910,23.8101,0.0105,0.0008
13378,111868,98490,9829,2144261458.9869,1535576895376712414.1549,98491,1.9958,0.0026,0.0003
31540,97667,66127,23745,2136928200.8467,1539065306959713896.7441,66128,8.5077,0.0039,0.000
24727,105183,80456,7576,2143685713.4495,1547207492849663100.7968,80457,9.6253,0.0031,0.0018
7902,78368,70466,11357,2153824431.5307,1538479697032714654.0554,70467,13.2127,0.0005,0.0046
26040,120396,94356,28129,2145369163.1272,1539784786863609933.9826,94357,5.7424,0.0017,0.0009
8628,11620,2992,427,2139817401.7117,1528564384853796736.54,2993,6.8866,0.0094,0.0054
21695,33147,11452,6796,2155580255.5167,1540243797240313110.7046,11453,3.2403,0.0026,0.0057
750,29568,28818,2817,2138256662.7898,1539983748246925727.1314,28819,14.7173,0.0081,0.0009
10315,61113,50798,31834,2142419402.4264,1533077943044977360.6817,50799,7.8859,0.0032,0.0005
15232,20156,4924,5345,2155572152.9834,1526804262524619133.7723,4925,9.5751,0.005,0.0129
27224,93285,66061,31354,2140939151.0337,1534523408385973710.4745,66062,11.9631,0.0038,0.0004
13981,76614,62633,19295,2132972638.1653,1537109823350160653.9173,62634,19.4955,0.0057,0.000
4435,18738,14303,14533,2131472342.6051,1524182034259772004.3172,14304,11.2194,0.0088,0.0012
24939,83109,58170,25834,2140405538.2994,1539294886339876230.6044,58171,8.7583,0.0045,0.0006
29917,102477,72560,2187,2147586894.9905,1533652332642887939.357,72561,3.5016,0.002,0.0016
11304,75324,64020,8105,2128564545.6212,1535182625417840881.1529,64021,24.3073,0.0073,0.000
18785,33751,14966,19103,2136921318.5417,1541104995932682052.9733,14967,3.8478,0.0071,0.0012
25392,43502,18110,4805,2141270316.4228,1535742513378560764.2872,18111,4.101,0.0047,0.0015
1174,24571,23397,26811,2162733602.974,1543204068613294574.04,23398,17.9613,0.0003,0.0091
29791,119661,89870,22084,2149218050.9808,1533162290751931082.2417,89871,8.0812,0.0014,0.0025
22939,31087,8148,8208,2164421295.7616,1508301524684723139.1606,8149,15.3711,0.0065,0.0136
6020,39485,33465,1114,2156292622.327,1547752074133681014.8909,33466,6.0096,0.0004,0.005
20557,32328,11771,17108,2176151524.9332,1551572358776882946.6879,11772,23.8943,0.0006,0.0118
16120,64120,48000,15712,2150649914.5984,1531761209552191499.7277,48001,4.2257,0.0011,0.0024
9022,58565,49543,24660,2141187973.1173,1536392022413864485.9053,49544,3.1717,0.0037,0.0009
22238,59130,36892,25240,2146769750.8103,1535137601081299739.6779,36893,3.4531,0.0022,0.002
7619,16274,8655,9493,2130617337.3632,1543914292842876880.8893,8656,12.3285,0.0084,0.001
23199,80384,57185,6490,2150641538.7563,1531905292152668523.1731,57186,9.4356,0.0014,0.004
11420,62802,51382,21261,2140497474.0676,1535762144056015413.0479,51383,11.0677,0.0043,0.0006
11014,12491,1477,16633,2122937533.7544,1537458783467641404.3856,1478,16.7047,0.030,0.0091
24562,25429,867,23794,2154440639.9793,1524962122370121770.5641,868,5.8204,0.014,0.0249
28426,127578,99152,16499,2148863997.8278,1540054815958951622.0942,99153,8.7536,0.0016,0.0019
2803,24132,21329,10924,2148976764.9014,1532674015357202716.2636,21330,4.4602,0.0019,0.0028
8718,94787,86069,26360,2155146545.5947,1532824197658863960.6049,86070,6.2712,0.0005,0.0036
26763,46843,20080,6878,2109500128.2624,1547995866400575573.7421,20081,30.1526,0.0168,0.0006
1383,41589,40206,27568,2144221909.4949,1531723457108045409.8437,40207,15.2557,0.0038,0.0027
15222,72901,57679,30412,2137472710.2784,1531042860955120595.4394,57680,6.0099,0.0044,0.0001
28246,93074,64828,10973,2156554691.3542,1541454321454315823.2928,64829,4.6595,0.0006,0.0041
21190,45163,23973,8112,2144619208.3843,1543872866667511131.0179,23974,6.0597,0.0032,0.0019
14104,100440,86336,17530,2150180049.7519,1544288429303702574.2726,86337,8.3189,0.0013,0.0023
17901,61808,43907,26837,2147273368.4183,1518881711371157039.1116,43908,16.5846,0.0036,0.0038
16658,93397,76739,14570,2134068445.9917,1526787741743369273.8498,76740,20.4853,0.0082,0.0006
10839,96599,85760,22353,2151272602.1671,1540010637325897469.8066,85761,4.5596,0.0007,0.0028
15119,26945,11826,11882,2135013311.7382,1518691430423252587.8437,11827,5.3447,0.0078,0.0026
31591,46307,14716,22262,2142294738.2199,1535233523564199387.5985,14717,9.4654,0.0048,0.0031
24824,59599,34775,212,2166213224.9051,1526454527021690584.7468,34776,31.4072,0.000,0.0082
15424,86985,71561,12880,2140743299.1905,1533117463021447521.9511,71562,8.7135,0.0038,0.0002
28397,101986,73589,23559,2147619426.2156,1538229159787155100.8242,73590,6.5688,0.0022,0.0018
28330,74964,46634,7594,2159521959.2894,1539252896530749705.7112,46635,11.3305,0,0.0057
19749,82566,62817,21840,2138253603.1814,1540618869026790208.7985,62818,13.0045,0.0036,0.000
12047,52534,40487,19323,2160795975.1846,1539442945167534022.2968,40488,8.9543,0.0002,0.0054
12866,92596,79730,22959,2147862396.347,1539542842939605694.2435,79731,1.8595,0.001,0.0014
7239,94766,87527,9013,2142508048.4644,1540873580342429957.1636,87528,13.8717,0.0034,0.0014
14962,96294,81332,26133,2157168141.1985,1531840547405001427.646,81333,11.8137,0.0002,0.0043
15574,34666,19092,13867,2169630922.5176,1535114778225333638.6952,19093,15.1341,0.0018,0.011
5128,96816,91688,22834,2152945188.2994,1528841513012222467.4736,91689,12.9072,0.0009,0.0037
4127,46928,42801,14163,2147581056.9246,1545898637599150526.2925,42802,5.843,0.0029,0.0025
25424,87010,61586,26128,2141534369.576,1538369136364705975.2609,61587,8.1391,0.0044,0.0004
30024,46251,16227,32324,2123782912.1399,1526720715277317213.1405,16228,14.0038,0.0095,0.0007
28242,109062,80820,937,2151854844.364,1538942666827085187.4925,80821,6.8265,0.0008,0.0028
2991,100797,97806,15441,2140547742.1133,1535779004347904012.0639,97807,11.4326,0.0034,0.000
13420,108543,95123,22460,2140921389.3055,1533093679613843715.1524,95124,11.0612,0.0034,0.0008
21406,97874,76468,23314,2144062387.1304,1538280951231351084.2245,76469,7.6072,0.0028,0.0012
21417,56997,35580,12444,2137747731.8737,1544587014378382175.2895,35581,14.0249,0.0069,0.0011
924,13259,12335,9501,2145960603.7879,1542140710973456454.136,12336,4.0704,0.0048,0.0043
27685,72381,44696,16201,2159427887.305,1534562998724304096.6449,44697,12.1568,0.0002,0.0052
8341,66959,58618,19817,2147593971.1538,1538252072142462735.5163,58619,6.3264,0.0016,0.0017
23088,56937,33849,23134,2150831872.3411,1541796925925763640.3989,33850,7.6458,0.0021,0.0031
31758,104175,72417,15372,2152570354.9727,1537525150321938092.6583,72418,5.6659,0.0004,0.0033
26085,76028,49943,31195,2147834964.9942,1532361100190878872.846,49944,4.1576,0.0023,0.0019
22338,28905,6567,19485,2153246471.8873,1538160586156511563.1231,6568,13.9106,0.006,0.0144
18888,88448,69560,6790,2147104945.1555,1534679589204185843.8776,69561,4.4232,0.0015,0.0013
32620,56447,23827,12310,2146762067.4899,1536475443852468707.7443,23828,3.3213,0.0024,0.0016
18115,109120,91005,333,2153936918.2921,1532207479781155969.214,91006,10.6994,0.0009,0.0033
12338,80145,67807,30564,2159912805.2065,1539463766123310343.1133,67808,16.0617,0.0004,0.006
30746,69153,38407,4894,2146541758.0386,1537877996595130777.9436,38408,8.1211,0.0021,0.0025
20722,98787,78065,26655,2149961615.815,1544122104580294698.6697,78066,11.0936,0.0012,0.0032
3104,32274,29170,25023,2137545616.3161,1528972310642278805.7503,29171,4.3236,0.0057,0.000
2751,83499,80748,17546,2149134864.6771,1543142521395553366.5021,80749,6.9402,0.0014,0.0022
25441,84075,58634,12405,2149126580.6983,1547903316868658481.7214,58635,10.2757,0.0028,0.0027
32700,96460,63760,13748,2147054022.9638,1532713953262180648.6038,63761,7.9519,0.002,0.0019
31602,127691,96089,17530,2153496534.3795,1539722806628258454.8004,96090,5.9747,0.0006,0.0027
501,66208,65707,11551,2146721606.197,1541101527119079458.9271,65708,10.9673,0.0024,0.0016
29914,75474,45560,16791,2145714147.2224,1534350730537228460.7035,45561,6.5343,0.002,0.0019
30810,36912,6102,995,2179798988.2268,1535872150329663170.5879,6103,10.4611,0.002,0.013
21531,55288,33757,316,2163063121.9178,1541270823234202851.2478,33758,9.398,0.0009,0.0076
15745,17389,1644,2813,2127012618.1204,1535028254054042877.8542,1645,4.3577,0.0118,0.0038
16485,90644,74159,18088,2143847478.231,1541847806448460676.0324,74160,2.8424,0.0023,0.0007
29492,79893,50401,5288,2145748118.1328,1537395885100029881.2888,50402,4.5767,0.0021,0.0012
19941,23194,3253,17457,2185045147.2345,1584188311457492057.5182,3254,23.1995,0.0088,0.0227
5327,51507,46180,18129,2149224264.5648,1551513917853965603.1918,46181,7.5998,0.0026,0.0036
5537,100733,95196,8337,2145243901.5577,1529650274454129618.9933,95197,6.2451,0.0024,0.0015
20714,60022,39308,4301,2143624623.8244,1535114887180533196.4819,39309,3.372,0.0032,0.0012
13335,32167,18832,1246,2146394808.0393,1537929170621694336.0452,18833,4.4258,0.0029,0.0033
20250,116878,96628,295,2146659956.6292,1528675628807192653.3552,96629,6.675,0.0026,0.0019
17847,54397,36550,17867,2152275435.6844,1534935728347496710.3053,36551,8.303,0.0016,0.0037
21389,95982,74593,31810,2142221754.2962,1545195944187761753.0837,74594,7.4808,0.0035,0.0007
1395,11338,9943,5785,2117833660.6038,1544769757091586186.3108,9944,11.0343,0.0117,0.0001
28969,39801,10832,25909,2170399294.305,1567346240019093009.0287,10833,19.1135,0.0026,0.0124
7173,93138,85965,18403,2145479976.3338,1550662056885513216.6932,85966,15.669,0.0034,0.0025
13601,37052,23451,21012,2150396696.0536,1539749400327317438.8185,23452,2.4685,0.0016,0.0031
25174,49485,24311,10282,2128386855.1551,1536064207860773608.9958,24312,17.8126,0.0101,0.0007
4703,22285,17582,25549,2170013327.6441,1543578730863623847.2991,17583,13.5792,0.0012,0.0143
18243,78018,59775,9411,2140946241.7013,1546101173404924499.3315,59776,6.9542,0.0037,0.0008
18198,68809,50611,15916,2157252284.7519,1542871497367832199.8685,50612,12.6003,0.0002,0.0053
32627,52559,19932,11113,2137998601.6596,1544103438221766203.8886,19933,5.8125,0.0075,0.0043
14603,30660,16057,22278,2157054621.4258,1527721931166648956.2485,16058,2.4072,0.0023,0.0066
26573,32011,5438,1579,2139821258.5249,1535306218334494744.9024,5439,20.7859,0.0168,0.0045
4104,7967,3863,22023,2168623580.382,1535237059606636156.9628,3864,4.3051,0.0019,0.0118
582,64804,64222,26754,2136735025.4971,1532554906126363557.0714,64223,6.2211,0.0042,0.0002
324,98170,97846,13754,2146520615.2787,1534547058102233809.8709,97847,11.2105,0.0025,0.0014
25,71449,71424,10810,2152593429.1542,1532402053037929586.1458,71425,3.2569,0.0003,0.0031
30242,91092,60850,20763,2136347643.201,1552827369329217379.8291,60851,16.249,0.0058,0.0025
29118,61512,32394,18849,2135368466.9743,1537943335488906300.3728,32395,7.1968,0.0054,0.0007
16734,48081,31347,13845,2148990852.0464,1537004129532908978.4818,31348,4.572,0.0019,0.0028
17320,97594,80274,8835,2143400539.1097,1540560971714996683.6941,80275,11.2282,0.002,0.0007
3178,69828,66650,13756,2140105911.7388,1541025658238606704.4282,66651,11.255,0.0042,0.0004
10212,66254,56042,8248,2145550589.7156,1541441204168542313.4283,56043,10.7404,0.0038,0.0025
1191,60805,59614,7782,2149972142.2542,1536515871736672952.8537,59615,10.454,0.0019,0.0027
24152,103608,79456,4724,2152346958.0774,1539477584985499224.6166,79457,6.2559,0.0005,0.0024
8148,96298,88150,28451,2150039096.839,1539879183368867556.6572,88151,7.0136,0.0007,0.002
9177,39185,30008,21503,2150982336.6195,1537950175742113566.5657,30009,3.7355,0.0015,0.003
25475,84292,58817,2132,2151526462.7263,1534892190375640998.8282,58818,2.925,0.0005,0.0024
27928,64036,36108,29733,2158032125.9985,1532858006745216836.2498,36109,9.0945,0.0001,0.0045
19428,30609,11181,12169,2135614308.8039,1545690685359039796.4909,11182,11.5942,0.0098,0.0026
29594,94186,64592,18083,2144483813.7789,1536930302158830917.8997,64593,7.5198,0.0032,0.0014
14847,51640,36793,19950,2118475903.3479,1541873948844722646.2887,36794,39.1356,0.0128,0.000
3059,88651,85592,21355,2145239160.9172,1541164469223569274.1641,85593,6.8705,0.0019,0.0011
13771,54102,40331,17227,2132804484.3283,1546432761602379623.3792,40332,20.4729,0.006,0.0001
18862,24769,5907,27622,2163889854.6984,1549605696316539111.3339,5908,12.8485,0.0032,0.0113
8267,79016,70749,17300,2154607989.6673,1532331910277819260.3545,70750,18.4325,0.0003,0.0038
23443,38622,15179,15416,2141772365.442,1545724769778065225.6991,15180,2.8243,0.0047,0.0024
20991,70868,49877,31768,2150177702.9843,1534857331831748210.7605,49878,7.8756,0.001,0.0029
21546,91337,69791,23606,2157739829.666,1530854814860901788.1858,69792,13.6415,0.0008,0.0061
14926,27395,12469,3848,2172804873.7056,1542371033810919065.1976,12470,9.458,0.0005,0.0109
12208,38520,26312,26782,2150012267.46,1537734202360360335.4198,26313,1.8523,0.0018,0.0032
1939,14439,12500,30428,2149240245.4726,1536413646570236154.4943,12501,7.318,0.0035,0.0045
16173,87938,71765,23942,2150327953.885,1547246905401525141.5288,71766,9.6015,0.002,0.0043
21116,21585,469,9996,2072795551.9085,1464131563666083614.8576,470,11.1487,0.0524,0.0188
24944,58055,33111,7942,2136517139.2497,1545153832621328578.5812,33112,7.3525,0.005,0.0007
3690,76445,72755,4520,2139593829.7167,1535711136086880043.4275,72756,7.5416,0.0031,0.0003
30423,109489,79066,17882,2142594954.6375,1538253192663230741.9686,79067,19.598,0.0034,0.0012
3342,85874,82532,20008,2154254059.2743,1538637482737077476.8213,82533,13.0324,0.0006,0.0045
17116,76028,58912,8253,2140158122.485,1532581110005130585.9362,58913,12.944,0.0039,0.0001
23991,46181,22190,14044,2138419633.0487,1555013749282869701.8504,22191,22.482,0.0075,0.0047
32450,70825,38375,5967,2146138249.4917,1538937582067211615.3669,38376,4.1719,0.003,0.0027
30264,67500,37236,11796,2139929967.1441,1534858129437669389.4259,37237,5.1054,0.0041,0.0006
26153,35894,9741,19922,2151973477.6125,1517118893036134643.2363,9742,13.4033,0.0058,0.0077
13908,83166,69258,1083,2140165693.8252,1532788536008099555.7565,69259,9.7737,0.0038,0.0008
4682,6905,2223,28729,2190508856.9532,1510096427058562225.8359,2224,6.1971,0.0051,0.0205
19870,113608,93738,24079,2152801700.0559,1534084589013832973.4797,93739,15.6449,0.0004,0.0029
25013,41605,16592,25672,2133443765.2904,1533156735536186572.9417,16593,4.5862,0.0089,0.0021
28129,31223,3094,8162,2143895189.0979,1527870810719249944.8831,3095,17.5139,0.0118,0.0117
20128,116317,96189,15086,2154136633.6448,1536716394794880276.558,96190,7.9772,0.0001,0.0032
15209,20457,5248,12665,2158285794.3399,1515559392447634299.3,5249,11.2684,0.0056,0.0116
19014,114534,95520,22727,2145188840.0772,1541183061661028407.4766,95521,5.3555,0.0024,0.0014
14343,43719,29376,4764,2142913273.8569,1536478551451416750.5256,29377,7.4258,0.0037,0.0008
722,50799,50077,28083,2137493539.2226,1531351995072897957.1319,50078,9.2176,0.0058,0.0005
20285,21733,1448,2285,2199036180.8323,1552922399615259787.1389,1449,4.4801,0.0016,0.022
21876,106918,85042,27367,2152781388.7014,1538740867797532061.8756,85043,9.8355,0.0002,0.003
12752,49374,36622,8821,2135814184.5412,1537594747501101556.3386,36623,11.9771,0.0076,0.0005
25483,40885,15402,3162,2148459781.9866,1549947784659886087.6439,15403,6.4376,0.0051,0.0056
13562,24275,10713,17055,2151291215.0546,1550132084656339483.8631,10714,5.2253,0.005,0.0059
10519,19216,8697,20834,2149646831.2705,1522585308100619182.39,8698,5.0566,0.008,0.0071
6179,100646,94467,24614,2150500042.7169,1534980553276201694.6735,94468,3.5182,0.0007,0.0023
4465,99239,94774,21618,2147787316.5291,1534293285191988108.9075,94775,8.4532,0.0014,0.0017
22469,120796,98327,25897,2150135357.5363,1538400304880397751.4419,98328,2.6746,0.0006,0.0016
16616,79145,62529,30020,2145220827.9958,1536381705048502960.6509,62530,2.9305,0.0025,0.0008
1640,20051,18411,17015,2140750420.6423,1535921315175411585.3714,18412,5.3626,0.0067,0.0016
21252,100540,79288,31403,2138024224.8906,1542004391043282624.3755,79289,16.7133,0.0052,0.0006
4450,66213,61763,2941,2159209606.3828,1539356611160077627.6135,61764,7.9216,0.0003,0.0054
26621,33693,7072,19244,2089464190.0607,1521612544790249771.6769,7073,19.2299,0.0264,0.0002
27400,95916,68516,2225,2150550300.3732,1531424324322131962.8552,68517,8.8861,0.0013,0.0036
17326,31416,14090,32459,2128855452.8799,1535888887429459403.8057,14091,4.1526,0.0079,0.0002
5967,84254,78287,30938,2150242883.6443,1540836465850908031.7375,78288,2.2845,0.0008,0.0021
29811,89641,59830,25340,2155108355.3825,1539911179392395490.2437,59831,5.2893,0.0006,0.0043
15789,67810,52021,130,2149621641.4142,1535353034411267600.1664,52022,8.3441,0.0013,0.0022
7826,8348,522,23891,2206599929.6099,1647966226714865717.236,523,13.6747,0.0127,0.0444
8334,100542,92208,3868,2161122297.5292,1537231919088029699.0787,92209,28.4207,0.0003,0.0077
5671,82331,76660,7317,2137485025.408,1539787123268360180.5749,76661,12.3612,0.0051,0.0005
9511,101530,92019,26359,2139942386.0836,1539264775661882966.3601,92020,11.0491,0.0032,0.0001
2294,5689,3395,1900,2161344279.8439,1541607635360917982.8997,3396,3.5939,0.0039,0.009
32205,124291,92086,18795,2143725705.5209,1532873405771878883.5656,92087,10.9664,0.0026,0.0006
19977,59313,39336,26646,2134910208.7581,1533816959054510946.7367,39337,7.9208,0.0051,0.0002
9442,24409,14967,5681,2152757498.9046,1540560981513415186.09,14968,4.1639,0.0016,0.0041
9742,76652,66910,8640,2142994105.0232,1520731107749858720.0025,66911,19.5598,0.0045,0.0028
3726,42600,38874,16367,2146386338.1949,1537228397809007450.5361,38875,5.0592,0.0037,0.0025
10212,82128,71916,8499,2149388659.2914,1539626665479661598.6098,71917,5.0877,0.0012,0.0027
22292,66680,44388,7192,2148404238.7418,1536683546547684157.9998,44389,8.3123,0.0021,0.0024
9728,71321,61593,6243,2154163215.994,1536946725963909862.1154,61594,6.9999,0.0011,0.0042
12804,94445,81641,28767,2151481506.6816,1543749722636608668.9012,81642,5.7652,0.0012,0.0023
6874,99568,92694,266,2153127080.0991,1528040222058022915.1446,92695,21.2439,0.0008,0.0037
29724,68500,38776,4263,2143499982.9302,1546546936040186245.8793,38777,9.7898,0.0045,0.0027
27574,45616,18042,19381,2168003100.2656,1537538410921283085.6537,18043,8.3238,0.000,0.0084
13252,54758,41506,21523,2148262455.7186,1546106080293435479.4097,41507,5.9744,0.0036,0.0035
31127,121730,90603,30669,2143164363.971,1542914583484385048.9046,90604,5.3781,0.0032,0.0012
32176,113686,81510,19311,2151374255.0175,1540673420334230719.9581,81511,4.2202,0.0007,0.0026
15239,102379,87140,31227,2156399179.8656,1536158142524597955.6921,87141,7.1473,0.0001,0.0036
2751,11896,9145,17855,2142716631.1554,1559256555836490127.2023,9146,8.4642,0.0063,0.007
17777,103586,85809,12917,2148267144.9645,1536620446769758624.6616,85810,4.595,0.0012,0.0023
19288,47739,28451,15388,2150397525.1241,1530275238242554960.9187,28452,9.3958,0.0024,0.0044
8132,43683,35551,10415,2153399158.6773,1529882233542790847.0367,35552,6.6443,0.0012,0.004
13271,26251,12980,8626,2162762114.1575,1533453704228848208.5855,12981,8.0708,0.000,0.0064
2858,7069,4211,13089,2122823807.8552,1526127490783226283.2559,4212,3.5392,0.0168,0.0024
28698,83731,55033,181,2137054181.9063,1523587655320196340.0388,55034,23.3535,0.0068,0.001
12636,41223,28587,17624,2146092717.6492,1523938710894299541.4285,28588,7.4858,0.0046,0.0029
27152,76948,49796,5347,2159672613.1579,1541902456738619602.3252,49797,11.8649,0.0011,0.0059
26043,90149,64106,10967,2148211293.958,1545599945842529072.4956,64107,5.8589,0.0022,0.0022
18960,105059,86099,2193,2159118222.8242,1534525152229903984.1192,86100,22.0089,0.0002,0.0058
17800,61932,44132,14010,2147293993.6352,1534506810490185583.7381,44133,6.2298,0.0025,0.0028
6534,65361,58827,28728,2150714790.0544,1531596367816863601.2404,58828,5.3844,0.0014,0.0031
5636,72569,66933,8390,2145424584.7881,1539826027420483958.6824,66934,14.4415,0.0032,0.0023
29896,42200,12304,7945,2133361141.5315,1541866312492630570.7095,12305,7.8319,0.0072,0.0009
24379,108274,83895,26059,2154872007.0694,1535171635230871427.3965,83896,19.3952,0.0008,0.0054
19367,106214,86847,25879,2141341331.0048,1541660594411956195.2281,86848,16.3175,0.0039,0.0008
27339,69661,42322,32640,2160569227.1824,1537836583233772391.9208,42323,12.6098,0.0003,0.0058
27245,80702,53457,18531,2136058260.645,1532448712215686603.3271,53458,9.952,0.0064,0.0003
984,38783,37799,11753,2133615072.5679,1524344265348661373.0071,37800,10.8852,0.0075,0.0012
27782,68226,40444,31674,2136809459.2437,1536379345137751996.9892,40445,7.2323,0.0047,0.0007
5148,26565,21417,26631,2153193211.117,1533734330015517350.869,21418,8.5904,0.0019,0.0047
23448,76277,52829,792,2145880354.1921,1529181710517558473.8571,52830,2.8149,0.0028,0.0022
16387,110408,94021,22835,2147463139.2915,1530578622986456932.7032,94022,6.371,0.0016,0.0018
32278,132108,99830,30822,2146182087.749,1542493487296724042.9091,99831,10.2716,0.0024,0.002
10004,54851,44847,14628,2146683592.743,1523803858670923292.0158,44848,6.1491,0.0033,0.0028
5820,84283,78463,15711,2143717996.0318,1537725420137319146.5708,78464,2.8862,0.0025,0.0005
26485,107788,81303,31850,2149577436.9435,1548442268613606397.5589,81304,17.864,0.0027,0.0034
13758,24529,10771,29699,2161005889.6604,1552784023937184861.2165,10772,8.072,0.0022,0.0093
9243,77052,67809,15150,2140734890.8633,1527697311320986525.4837,67810,9.9616,0.0037,0.0011
7419,49373,41954,19279,2138034466.7619,1551107533211066792.2309,41955,16.077,0.0054,0.0008
32011,68898,36887,32141,2147715580.7709,1535845611973521184.3213,36888,5.6421,0.0023,0.0021
2708,88890,86182,9724,2145175247.5541,1533892420649484117.9927,86183,17.7805,0.0023,0.002
7557,19592,12035,18557,2146626719.7685,1547550928846596257.0925,12036,5.8656,0.0044,0.0033
14336,104301,89965,19172,2137658973.7326,1530613134436562253.2502,89966,12.4586,0.005,0.0002
29614,30924,1310,30432,2085645484.7605,1497627027991411003.2409,1311,17.9723,0.0332,0.0007
5579,37679,32100,28188,2152034256.361,1546955081128719479.0967,32101,5.4177,0.0018,0.0038
16588,103151,86563,22110,2158064473.2108,1538373605119221113.2275,86564,7.1027,0.0001,0.004
22383,22577,194,5984,2133528638.0821,1503337676627936714.5676,195,9.2569,0.0425,0.0385
25002,105491,80489,13088,2154213789.4122,1540839589965993745.7109,80490,12.5158,0.0008,0.0039
22060,60043,37983,13532,2130277406.2363,1524249674239277150.9547,37984,16.684,0.0077,0.0013
1739,6901,5162,9715,2166436128.5723,1540955949718051982.7669,5163,3.9408,0.0032,0.0128
7019,91428,84409,27609,2153907629.5134,1540309181321088864.5604,84410,4.2506,0.0001,0.003
4554,20997,16443,9150,2168140189.9938,1555316734879317133.1572,16444,12.8853,0.003,0.0096
11460,74581,63121,13458,2139144823.0933,1541468264693460098.5913,63122,7.8804,0.004,0.0007
11762,14787,3025,12242,2182319551.7512,1575208819501408821.5841,3026,6.6724,0.0021,0.0195
10596,25376,14780,1532,2141702944.8821,1540592340093698784.32,14781,5.4716,0.0038,0.0018
13910,54452,40542,850,2139683578.2703,1528555984034462173.3525,40543,13.1914,0.0049,0.0009
18115,54491,36376,32451,2128798981.5571,1551571510170743586.1962,36377,20.0063,0.0102,0.0009
26106,90644,64538,23516,2137875899.8203,1541761347530942827.9588,64539,11.0675,0.0045,0.0009
26265,125023,98758,1692,2151784908.2961,1551431428338154462.2529,98759,20.1632,0.0024,0.0037
11530,21937,10407,16656,2131454433.7844,1541959150887130030.8763,10408,3.8359,0.0082,0.0011
16181,34381,18200,2227,2143840505.5927,1537911839589883264.3395,18201,11.3632,0.0036,0.0019
23028,79837,56809,31922,2149429102.8524,1538693164968464405.3714,56810,6.0084,0.0015,0.0019
17579,48265,30686,1653,2157253151.752,1534349615909234223.6992,30687,10.050,0.0005,0.0052
10585,29607,19022,27553,2160279846.5777,1542438763670600286.7402,19023,11.5097,0.0015,0.0077
21127,40962,19835,16389,2169919325.8287,1540447272338482497.0405,19836,9.0136,0.0002,0.0083
16144,101328,85184,341,2142343126.3403,1539406976526187213.8641,85185,2.8359,0.0027,0.0006
13139,22839,9700,25166,2166746479.447,1527461750188276912.3748,9701,16.893,0.001,0.0093
9327,56676,47349,12635,2146738709.0424,1540395460346296262.4749,47350,2.1186,0.003,0.0016
2298,95512,93214,4273,2149034628.7177,1539483904250837427.4966,93215,5.9712,0.0011,0.0019
6197,7544,1347,28275,2149502741.8027,1538453349295608225.6243,1348,4.9147,0.0088,0.0115
5393,88854,83461,18928,2147337150.6431,1542690838829392439.1674,83462,6.2666,0.0013,0.0018
22304,67206,44902,19259,2155604996.8394,1540440801439123793.7915,44903,7.6013,0.0007,0.0038
22096,92813,70717,31193,2142051972.9198,1538619337571150941.6086,70718,15.9943,0.0027,0.0003
25970,116355,90385,27840,2157950134.9045,1544918839715500020.9579,90386,20.7974,0.000,0.005
25132,73316,48184,28935,2140791195.0259,1534029391828412302.2437,48185,4.6708,0.0033,0.0002
12293,29448,17155,28195,2146659673.5975,1531747063466624652.3492,17156,11.2739,0.0034,0.0036
29756,114994,85238,17938,2135099649.2856,1528773499748424236.7721,85239,22.4196,0.0057,0.0011
28523,97274,68751,11214,2131491988.2712,1536127242590113560.9133,68752,23.6401,0.0059,0.0001
1123,42814,41691,9639,2136581650.2819,1540866612237668145.3542,41692,12.3185,0.0073,0.0015
10529,94590,84061,4755,2148326515.9674,1533179306400520200.2623,84062,2.6475,0.0013,0.0015
13936,104706,90770,19139,2149264203.9946,1533687914987570144.6603,90771,4.2222,0.0011,0.0017
4743,70368,65625,31454,2154089059.614,1529737345334351468.9134,65626,14.0175,0.0005,0.0044
22647,34098,11451,18535,2135929617.3289,1554796296801715707.3314,11452,6.1211,0.0075,0.0041
8236,102720,94484,17867,2156451442.7314,1525971872003310980.9825,94485,25.8952,0.0005,0.0047
16580,54033,37453,16571,2144172380.7362,1533293169794423452.4275,37454,5.2023,0.0026,0.0015
22518,117191,94673,915,2158401203.752,1542580883664096426.1242,94674,15.179,0.0002,0.0048
31640,73334,41694,2850,2151116684.4423,1526250536730489902.9204,41695,15.3744,0.0028,0.0049
2795,100500,97705,5548,2141365196.7863,1538881390772137686.6652,97706,5.9903,0.0025,0.0001
30414,62564,32150,7037,2142733672.1293,1545503797861351953.9229,32151,4.5824,0.0039,0.0022
23619,53192,29573,24163,2131918510.9925,1530738673952074128.0368,29574,13.3206,0.0093,0.0016
23341,34772,11431,16975,2183605599.598,1534302794856175657.3783,11432,16.0362,0.0003,0.013
3198,92238,89040,28799,2144219963.2741,1530099315481053617.1053,89041,10.676,0.0026,0.0014
27304,28503,1199,4490,2082659466.9133,1581129366882484930.8925,1200,9.2954,0.0357,0.0105
18640,87883,69243,32124,2150573837.044,1527933774769889268.3754,69244,7.9328,0.0022,0.0029
5444,50964,45520,155,2147650698.6415,1550399920584573044.0083,45521,11.9715,0.0031,0.0031
29816,80503,50687,14204,2146906053.197,1527974679500856632.8248,50688,5.4039,0.0023,0.0023
21296,76786,55490,7555,2155023281.1721,1544110575374069420.5636,55491,6.064,0.0002,0.0049
19139,50478,31339,5964,2140708324.0792,1532004002589023617.3256,31340,12.6369,0.0062,0.003
19855,45302,25447,12940,2114601223.7043,1526295407903000436.4799,25448,27.2315,0.015,0.000
18837,24655,5818,11615,2177513022.8814,1504289353921117125.214,5819,18.332,0.0015,0.0156
21850,63368,41518,20530,2154330278.8789,1528150857565894535.559,41519,10.7604,0.0009,0.0043
20225,84690,64465,28025,2141118861.6556,1542549432816341952.6914,64466,6.7129,0.0036,0.0007
29651,110411,80760,31768,2147776630.8906,1541738418184765457.9959,80761,6.2522,0.0017,0.0018
19220,61067,41847,26352,2155300881.9187,1532030368451565760.7427,41848,6.8541,0.001,0.0039
28536,118205,89669,20296,2134711738.2411,1540751670628516708.7904,89670,18.834,0.0053,0.0004
23150,103120,79970,2505,2159891227.7446,1535695634097901147.1524,79971,13.984,0.0002,0.0046
13485,14737,1252,9977,2150666290.2793,1471071691116386119.9363,1253,10.0235,0.0176,0.0212
31276,102181,70905,26,2148097219.5131,1537333875865673840.0567,70906,8.6875,0.0014,0.0016
21761,96588,74827,23527,2160622594.1084,1531174128723374838.3231,74828,21.1443,0.0005,0.0067
24133,102702,78569,23197,2139851768.1884,1528181510362171704.0257,78570,13.4939,0.0042,0.0002
8816,83962,75146,9401,2147869216.2678,1542472841628310550.9207,75147,2.2216,0.0019,0.0024
9000,40599,31599,23949,2150865329.7734,1530290696527909194.6249,31600,4.1318,0.0025,0.0039
29670,55452,25782,13708,2130596757.7635,1542198915048124052.0467,25783,21.9251,0.0077,0.0009
11207,54288,43081,29824,2124505688.9843,1521742411326332556.9758,43082,30.3669,0.0109,0.0005
9927,26788,16861,9831,2122606155.7339,1530442691079116099.6355,16862,15.2242,0.0103,0.0013
3367,51354,47987,15237,2148852904.6796,1548965433822341994.6664,47988,8.2401,0.0035,0.0037
29295,74905,45610,31750,2150457076.8129,1531504145107306279.8302,45611,5.4407,0.001,0.0026
3275,64698,61423,16727,2154823143.3593,1533835336440120015.6535,61424,4.6983,0.0004,0.0042
23751,41778,18027,21595,2134836357.2431,1526073301489317052.9477,18028,4.1563,0.0061,0.0013
31349,59500,28151,13797,2153062924.8538,1539340748405658491.8631,28152,17.287,0.0021,0.0051
2614,93955,91341,32068,2143809106.9821,1542358855198281118.1996,91342,11.3691,0.003,0.0006
11933,56331,44398,29385,2128540197.5102,1529850386853090734.1798,44399,17.3468,0.0068,0.000
4600,42503,37903,32528,2145252444.6921,1549872842176738402.0531,37904,11.2338,0.0041,0.0024
7164,69748,62584,23326,2146493875.9086,1535009905980814148.9738,62585,5.0051,0.0017,0.0011
21528,45925,24397,6634,2165129045.7894,1533557409446197985.6934,24398,14.1355,0.0004,0.0072
31401,32936,1535,16558,2231782488.1667,1505827266879758380.4722,1536,11.9406,0.000,0.0375
4668,89511,84843,24132,2150625569.8857,1537480339690557652.9288,84844,5.3409,0.0012,0.0019
26717,70329,43612,1376,2144313852.3275,1537609359200781613.4171,43613,5.5175,0.003,0.0014
9107,93519,84412,17051,2154748235.2935,1544890922917270129.0626,84413,10.8122,0.0008,0.0043
9544,97572,88028,23103,2150389532.3857,1540989012464289698.246,88029,7.4341,0.0011,0.0024
7048,37023,29975,7058,2159855248.638,1531514554763606435.1696,29976,7.7029,0.0007,0.0059
18073,95228,77155,8246,2143016563.1832,1536035439160417055.0613,77156,3.1939,0.0036,0.0005
26398,78423,52025,8605,2149473805.0991,1549157596370024578.2101,52026,15.8154,0.0022,0.0039
725,95247,94522,3855,2149270861.2455,1533621572975194930.9295,94523,6.9238,0.0014,0.0023
30695,53279,22584,14464,2132838062.7652,1544098510656532036.942,22585,4.759,0.0066,0.0014
9141,71629,62488,25729,2152856497.6835,1530846372655955424.9628,62489,20.5014,0.0015,0.0052
693,92900,92207,30596,2148506053.6562,1536524262299170897.6117,92208,4.1794,0.0009,0.0016
7638,87007,79369,2811,2145586590.6361,1539208366394821862.6125,79370,11.8458,0.0019,0.0014
4502,54827,50325,24056,2133872492.3385,1537495100238183205.9655,50326,10.9885,0.0058,0.0006
26009,83797,57788,17955,2146674542.7514,1550048189206851779.0863,57789,7.3199,0.0032,0.003
28072,71704,43632,1001,2153412105.3771,1532566791329330327.3649,43633,4.0829,0.0005,0.0029
2137,67655,65518,12309,2151447727.7141,1534764899438955527.9877,65519,16.283,0.0018,0.0051
21736,110736,89000,2715,2146620552.2759,1544967630121065895.665,89001,8.3308,0.0022,0.0023
1758,32871,31113,1704,2129857876.6768,1551659127913473431.3374,31114,33.5574,0.0075,0.0004
9107,63281,54174,11240,2149659705.3108,1543134333893572538.8122,54175,4.0363,0.0017,0.003
25445,48104,22659,14551,2159587094.5051,1546908565199460646.0214,22660,12.9305,0.0018,0.0064
21684,31473,9789,7948,2136329397.0502,1525314607573900499.3269,9790,6.9294,0.0066,0.0018
5090,71126,66036,8771,2138272419.4766,1539651652107455923.1575,66037,9.0584,0.0046,0.000
13434,108483,95049,2796,2152049661.0255,1534004645701808875.749,95050,11.8053,0.0004,0.0022
26732,75127,48395,11275,2152104276.812,1547457809174009312.387,48396,4.9879,0.0017,0.0042
15767,87825,72058,19583,2152032971.1047,1542750849930314786.0676,72059,4.8646,0.001,0.0028
29802,115924,86122,13041,2159482300.1537,1527439768154723287.0959,86123,28.1983,0.0005,0.0061
17841,72484,54643,11790,2148978351.569,1527407765635390817.9785,54644,9.3387,0.0025,0.0028
26211,94315,68104,8865,2143069981.3912,1530831811210074217.5692,68105,13.2658,0.0038,0.0019
18322,91365,73043,30128,2164398701.0495,1537387029987534646.1932,73044,21.2511,0.0001,0.0056
6909,51858,44949,30350,2152773318.7933,1536434043927572922.5619,44950,7.4568,0.0012,0.0047
3151,80917,77766,24084,2150098994.5469,1542525838659348242.2638,77767,6.3381,0.0016,0.0034
12650,65908,53258,17799,2148705288.0676,1541114306173265371.5429,53259,2.647,0.0018,0.0026
16828,19961,3133,31242,2163754141.0214,1520437517912099183.601,3134,22.5689,0.0064,0.0259
25427,101556,76129,3024,2151032070.1036,1535115019505685244.6341,76130,4.7039,0.0007,0.0028
20727,109249,88522,13784,2152524525.7015,1535121559648476125.5647,88523,4.6205,0.0004,0.0025
9113,60549,51436,18502,2138763891.8527,1536706761911338885.5811,51437,9.6907,0.005,0.0007
6632,60799,54167,9347,2145023015.9983,1540027324235367639.3424,54168,7.2636,0.0023,0.0023
21304,42050,20746,11520,2146642531.2633,1532219530797694420.938,20747,6.3979,0.0052,0.0026
6588,100402,93814,14131,2151257687.6967,1540469517431318780.9554,93815,6.6325,0.0005,0.0027
6844,83566,76722,19073,2148114208.3046,1528924061900731651.4348,76723,11.1504,0.0018,0.0026
6269,24079,17810,27468,2145134065.3512,1519967148682987056.3492,17811,2.4117,0.0058,0.0041
30149,50230,20081,6125,2136535495.5307,1527875830893779251,20082,11.0942,0.0052,0.0017
31642,84440,52798,808,2152822027.8898,1544616437430185880.4018,52799,7.7876,0.0012,0.0046
5041,83431,78390,8696,2144517369.8497,1536125208601262695.1161,78391,11.3618,0.0044,0.0014
20810,39342,18532,6178,2135919620.4964,1544364294301050159.5873,18533,8.7311,0.0066,0.0007
3170,46167,42997,11175,2152539248.0147,1539217038496788220.2998,42998,4.9807,0.0012,0.0029
6865,22671,15806,24170,2166475613.0316,1525868840437196927.8932,15807,16.8313,0.0013,0.0123
12853,39885,27032,26109,2137890011.5534,1524440371811259931.5314,27033,22.1111,0.008,0.0031
6110,101837,95727,13730,2154564915.6103,1537812094322792733.9427,95728,8.829,0.0002,0.0039
25942,125673,99731,14178,2140398873.0042,1543297236542531309.8222,99732,15.2259,0.0032,0.0008
21795,52700,30905,3179,2140137846.9336,1530650137652430080.0615,30906,16.1961,0.0059,0.002
8533,28507,19974,32645,2116081443.1174,1533068583643482965.3233,19975,26.8905,0.0169,0.0005
9363,86925,77562,29331,2141861859.6729,1534410528312971790.4407,77563,8.853,0.0026,0.0009
18673,94277,75604,27181,2152711957.7449,1527492926085701796.5918,75605,13.0837,0.0018,0.0035
30281,77381,47100,1138,2158905698.1137,1534432949206845023.4276,47101,8.7973,0.0014,0.0083
637,51282,50645,1175,2146874041.852,1543263617850169603.9489,50646,4.9896,0.0025,0.002
10268,110193,99925,5684,2155304532.1127,1542670698279269532.724,99926,10.1833,0.0001,0.0036
2198,87911,85713,1155,2148413298.229,1533542669474863472.1472,85714,4.7556,0.0012,0.0018
29518,73846,44328,16792,2152745745.6157,1523991507704461118.5319,44329,9.7548,0.0032,0.005
16378,82412,66034,23564,2153716720.6161,1537502127737605837.47,66035,3.5451,0.0004,0.0037
30356,72133,41777,18900,2150404625.9744,1523883574486198942.2537,41778,10.963,0.0026,0.0037
8927,25532,16605,7529,2119881620.9587,1568995626437386075.8364,16606,40.7405,0.014,0.0008
3245,94051,90806,705,2147480749.2469,1535061921681683600.8811,90807,6.2996,0.0014,0.0016
7682,103091,95409,27330,2137825284.9541,1541573663997308399.8945,95410,13.2304,0.0041,0.0001
7867,18771,10904,25051,2140448509.1066,1547038450903597502.9334,10905,4.9518,0.0067,0.0025
17133,94753,77620,12780,2143647770.9979,1531676057875528770.2283,77621,3.8015,0.0021,0.0008
18643,49742,31099,24866,2150280332.0358,1527844335965906813.9053,31100,4.1646,0.0027,0.0037
15428,90551,75123,17569,2148722910.0653,1537569704716311022.0031,75124,9.6739,0.0013,0.003
28152,108831,80679,4074,2149166802.5882,1538842122772123202.2576,80680,12.9434,0.0016,0.0023
989,96921,95932,28979,2147609844.3108,1543642324804386195.8654,95933,10.5608,0.0025,0.0021
6444,46301,39857,29287,2167996805.938,1521845545959898889.0069,39858,20.6293,0.0003,0.0096
29264,90003,60739,10633,2142855770.9074,1545414185878315486.3082,60740,11.5787,0.0039,0.0014
11414,57843,46429,2442,2136342277.6834,1522576914803442054.9056,46430,9.3543,0.0055,0.001
199,73899,73700,16901,2144885871.7683,1542573129821172095.0554,73701,8.8501,0.0025,0.0014
11064,60088,49024,6457,2128001584.0939,1539804618755715069.3774,49025,25.6873,0.0088,0.000
9149,74513,65364,8488,2147793878.7374,1538144920453944244.2509,65365,18.078,0.0033,0.003
4942,94873,89931,13254,2158582301.4241,1538392012596418210.4617,89932,10.791,0.0003,0.0047
17559,86064,68505,20205,2152823502.0782,1541691421111152802.5809,68506,3.6092,0.0004,0.0032
24501,79617,55116,8896,2135562676.0269,1531310928590783131.8543,55117,10.6121,0.0058,0.0003
11194,104318,93124,28380,2151818763.1532,1534597295640152093.844,93125,6.1947,0.0004,0.0023
25200,84040,58840,25383,2138340924.0734,1532716371328705822.2748,58841,17.2097,0.0056,0.0013
23616,82877,59261,18845,2164623826.8834,1529175124863520757.1515,59262,22.4083,0.0004,0.0084
14091,40929,26838,27474,2146783155.1568,1537028583615021620.8615,26839,6.1543,0.0026,0.0022
11222,22726,11504,7037,2152193652.5894,1541153879763955406.8266,11505,9.9952,0.0026,0.005
28226,63524,35298,22355,2153064446.5914,1533662726048006143.0351,35299,2.5642,0.0013,0.0035
13315,52496,39181,23233,2144866114.9169,1551769333133431487.005,39182,12.4145,0.0042,0.0028
23863,75330,51467,8576,2144735811.9826,1540454976883904572.2316,51468,5.8045,0.003,0.0016
30892,52110,21218,8612,2160710115.3407,1549728570532527584.3873,21219,12.4868,0.0013,0.0075
14728,26619,11891,26330,2144176178.5192,1550040710878760232.4007,11892,8.2309,0.0058,0.0034
13024,84962,71938,26229,2132395501.222,1534030193523664112.726,71939,18.2627,0.0059,0.0007
12170,74788,62618,15953,2144479520.0468,1544002118901266129.2807,62619,20.8802,0.0032,0.0023
1137,33296,32159,25062,2146123950.4393,1533113111608169129.6503,32160,6.8272,0.0031,0.0025
3658,75857,72199,15474,2154646106.0254,1530744780639510700.8475,72200,34.2886,0.0003,0.0036
9328,77781,68453,4878,2151778487.8605,1543051021516417032.5087,68454,9.4517,0.0018,0.0035
9598,107913,98315,17677,2139696186.8073,1537301532546791272.7551,98316,13.7852,0.0045,0.0006
1416,69318,67902,32366,2154437724.6778,1534725894621195316.2132,67903,6.0008,0.0006,0.0036
5218,71517,66299,19786,2148943309.2397,1548669966803816359.0174,66300,12.177,0.0022,0.0029
31529,35826,4297,31776,2185243694.2148,1530077046890367074.465,4298,10.5888,0.0018,0.0191
19628,40412,20784,32508,2140956889.693,1558049770108568236.9996,20785,11.6334,0.007,0.0047
28647,97510,68863,24412,2156528691.4926,1541384064371902400.8299,68864,16.6027,0.0005,0.0063
13502,19842,6340,23887,2169160501.1312,1525289734977066224.5742,6341,8.1216,0.0004,0.0103
12665,55880,43215,23073,2157223414.2679,1546605448374500532.1609,43216,6.159,0.0017,0.0049
22075,34923,12848,5202,2162171999.03,1520131180245623540.2936,12849,5.6205,0.0017,0.0096
21616,27279,5663,21688,2174446017.6017,1541710035305257896.6577,5664,7.8848,0.0011,0.016
17794,81953,64159,7905,2150455999.483,1524986359001172308.5779,64160,11.4848,0.0019,0.0037
4603,52602,47999,18714,2132226632.5933,1547802954122385579.0173,48000,19.5666,0.0063,0.0011
5057,85668,80611,15075,2153570278.0235,1543526185885855052.5457,80612,13.4508,0.0009,0.0045
19383,73107,53724,9738,2162297214.7914,1527425283297907236.3653,53725,19.5119,0.0001,0.0062
9957,103080,93123,19813,2148721407.3512,1535887882615878669.8056,93124,7.5932,0.0017,0.0019
20157,32703,12546,8961,2163237715.0717,1541375162473566156.8386,12547,12.4257,0.0002,0.0077
15816,98103,82287,29212,2150839504.935,1546550004411265744.3729,82288,7.0203,0.0012,0.0037
23924,108320,84396,3417,2146367480.649,1537742577493225949.6151,84397,8.9857,0.0026,0.0011
29433,80004,50571,262,2135007331.6182,1551396332918122858.1566,50572,20.4492,0.0078,0.0014
24221,33122,8901,20861,2102442962.3641,1554612848836198501.2032,8902,34.7326,0.0174,0.0001
4746,41806,37060,21965,2135254534.5751,1532275841218655578.9183,37061,26.3997,0.0068,0.0013
24530,39683,15153,2831,2130937054.8187,1573542644867111542.6353,15154,23.4797,0.0111,0.0035
13207,86221,73014,22738,2142409842.7957,1547540064540099393.0507,73015,11.0328,0.0041,0.0013
5253,9150,3897,30094,2090235868.5005,1549300432135642784.2977,3898,12.815,0.021,0.0004
28036,41620,13584,17703,2111853244.0173,1523879434088513186.698,13585,27.7202,0.0158,0.003
11771,49903,38132,30539,2158876008.5871,1535465767201382841.8043,38133,5.1811,0.0004,0.0052
14934,58234,43300,10546,2147643722.7976,1544970315651908959.1346,43301,8.4451,0.0026,0.0023
17191,27005,9814,1351,2176101382.8989,1524763505961125082.3344,9815,11.6499,0.0012,0.0116
18981,44849,25868,24598,2153962998.2661,1530517460073379750.5332,25869,3.3646,0.0015,0.0038
3936,20057,16121,15560,2151115655.0465,1534625697425880260.8497,16122,3.2198,0.0018,0.0039
6594,94352,87758,25187,2150141138.2899,1533571489031637133.002,87759,9.1055,0.0008,0.0026
8600,47219,38619,20527,2146562538.9061,1539301493077744183.0637,38620,5.8419,0.0017,0.0019
24347,38818,14471,12111,2149508795.7698,1527797697094703099.0772,14472,3.4277,0.0025,0.004
11232,58341,47109,18473,2141229292.7448,1543732708684072554.9991,47110,11.4252,0.0042,0.001
9288,34671,25383,14054,2155741628.4089,1536185968747961967.7252,25384,22.0962,0.0035,0.0062
1624,33856,32232,6776,2158592162.3272,1537754222861585068.1435,32233,5.5642,0.0002,0.0056
30044,124688,94644,7667,2140521487.943,1537250321409942253.0386,94645,6.1233,0.0029,0.0001
25741,60035,34294,4799,2162961619.5172,1533373357546408174.6375,34295,8.3955,0.0007,0.0069
27920,48382,20462,32208,2145003308.8895,1536973023478320409.1299,20463,4.2387,0.0073,0.003
5009,8615,3606,28934,2144855739.6213,1531837400877899393.7307,3607,5.4675,0.0066,0.0056
30223,50902,20679,7063,2147983125.3507,1556599116501122537.4726,20680,11.4313,0.0035,0.0053
11133,49750,38617,16693,2161930809.8046,1532248367612920282.1357,38618,14.0441,0.000,0.0057
16085,28536,12451,19092,2116232909.6375,1551118296139861390.3654,12452,22.6647,0.0149,0.0001
2615,29700,27085,28197,2153216192.9026,1539157459330758920.2858,27086,5.3173,0.0014,0.0041
29838,110068,80230,24538,2153378881.1031,1535292648514574123.0908,80231,13.5938,0.0003,0.0026
12406,36335,23929,22027,2121213010.1469,1535807583699518841.2906,23930,17.9874,0.0104,0.0002
10511,72808,62297,21370,2149666901.1629,1536973002388680149.2278,62298,8.8256,0.0019,0.0028
14890,57669,42779,21042,2145352277.5013,1547681844393273433.3357,42780,6.7679,0.0035,0.0021
7180,47078,39898,4453,2140719215.5731,1541159065454179736.0284,39899,3.8422,0.0045,0.0019
15068,22415,7347,2644,2156511496.0553,1576152581573409431.8012,7348,14.3211,0.0079,0.0097
11999,81108,69109,1493,2141316207.3251,1532828259286735006.8545,69110,22.7638,0.0053,0.0013
11993,106114,94121,31517,2142174210.2902,1543042409790542979.2455,94122,5.5584,0.0038,0.0008
23435,49918,26483,19568,2157075270.5252,1522550379550799301.2355,26484,13.7526,0.0011,0.0074
30525,85389,54864,3850,2135202115.5826,1544833434370279244.0497,54865,16.9624,0.0064,0.0001
13566,37405,23839,18048,2157225858.7805,1524345371818393936.1431,23840,6.9632,0.0015,0.0058
15053,60610,45557,16438,2156542187.1837,1547567724248048956.7405,45558,15.2353,0.0015,0.0054
27192,98319,71127,20630,2141221637.4404,1533081675749379214.6016,71128,13.2904,0.0031,0.0011
28557,64518,35961,27294,2153691647.9739,1539171216600867451.0386,35962,4.1721,0.001,0.0036
24050,100525,76475,27068,2145909135.2801,1529563461417702172.4654,76476,10.1415,0.0027,0.0023
24054,53356,29302,28658,2140088398.5041,1553782523216031584.4855,29303,22.5927,0.0054,0.0028
15959,25988,10029,1850,2103894044.9616,1557139621041708736.7952,10030,23.2406,0.0179,0.0006
7922,46779,38857,26716,2154269586.6796,1536690386958255831.0651,38858,2.6637,0.0003,0.0033
12153,23862,11709,21283,2113804891.8341,1528745414686986256.1404,11710,12.2671,0.0163,0.0005
27944,99676,71732,4101,2154670398.1009,1537164882098507358.791,71733,7.4555,0.0002,0.0033
27817,74529,46712,882,2146482904.036,1535605373009354290.0173,46713,9.1687,0.0019,0.0018
1490,56235,54745,17837,2152747927.8034,1537162999557708310.9832,54746,17.0063,0.0012,0.0035
7414,21284,13870,668,2132615604.9182,1552880201258245064.5144,13871,17.2086,0.0096,0.0022
6306,73928,67622,963,2139242654.0282,1526068493475132844.2627,67623,20.1227,0.0051,0.002
5810,28900,23090,10130,2144783675.5533,1546666590675011448.9729,23091,10.2287,0.0043,0.0025
32744,84498,51754,14024,2145779850.2393,1530165754977660465.6966,51755,13.3002,0.0031,0.0018
12557,88508,75951,29042,2146724703.4229,1533661398991991838.6569,75952,13.3991,0.0034,0.002
9005,71972,62967,12371,2137472381.3427,1541513955186312534.6913,62968,8.9383,0.0044,0.0006
27148,29554,2406,123,2198546008.5484,1550824336362429646.8634,2407,6.7795,0.0017,0.0232
26511,69620,43109,112,2152286905.0923,1528826182682122141.1401,43110,3.742,0.002,0.0035
1467,66428,64961,21632,2145463595.0969,1535253461721427126.7699,64962,2.7832,0.002,0.0009
28090,116150,88060,6762,2147062167.1387,1537266080929023972.5338,88061,5.4069,0.002,0.0012
19621,64889,45268,5488,2154102142.6173,1543882919320115397.75,45269,5.3668,0.0008,0.0051
8225,67076,58851,1551,2165643103.9081,1533799938996523405.9225,58852,20.5359,0.0004,0.0073
5993,22596,16603,3307,2165398582.0767,1524654829705187526.1795,16604,15.2651,0.0007,0.0081
27829,39410,11581,1152,2137052485.2845,1547496706843761399.1595,11582,3.4821,0.008,0.003
13814,87406,73592,31121,2150897517.9605,1538961037726094174.0767,73593,9.6573,0.0008,0.0034
26368,85720,59352,20763,2134247011.4837,1557354294496340699.7919,59353,24.2928,0.0072,0.0028
6199,89514,83315,24833,2137109766.6681,1540917284783677599.198,83316,28.2005,0.0046,0.0002
16733,106023,89290,1515,2149217249.2459,1540772163139779696.2064,89291,17.6384,0.002,0.0025
10593,76488,65895,17083,2158708907.8739,1534248084888358325.272,65896,12.574,0.0001,0.0044
21538,94618,73080,16509,2152604385.0326,1541827360265549092.1527,73081,6.1941,0.0011,0.0029
31881,116600,84719,12898,2150783763.696,1539232839585621842.7049,84720,2.9789,0.0006,0.0029
29479,101183,71704,11324,2150382240.0857,1540411981319965759.3375,71705,6.8789,0.001,0.0024
20883,119355,98472,24503,2143725634.184,1538064770785102761.4796,98473,5.588,0.0025,0.0007
7501,36326,28825,29012,2132541661.1953,1559102750033199529.1017,28826,13.5583,0.0079,0.0033
2870,66736,63866,8988,2149027957.6239,1548649680346058282.1403,63867,7.8361,0.0024,0.0033
10546,58345,47799,28633,2154180122.2049,1536533036847515095.0538,47800,6.6018,0.0007,0.0033
23960,65338,41378,21833,2151286050.0799,1536284707260696818.3564,41379,3.8715,0.0013,0.004
28998,91380,62382,2071,2151650124.975,1544780391615896107.1505,62383,8.5767,0.0017,0.0039
18281,78056,59775,4713,2149407574.3009,1537005947963177967.9084,59776,5.9427,0.0019,0.0024
32665,35100,2435,24606,2180907366.945,1490312531118552970.8287,2436,10.1573,0.0071,0.0208
28989,65785,36796,2350,2154426648.9656,1544617572987962968.9341,36797,8.2471,0.0011,0.0053
21314,89940,68626,22697,2143453349.2863,1548736948395467167.094,68627,14.067,0.0048,0.0029
1082,32448,31366,17294,2137270149.4994,1541841726606000037.2291,31367,12.0898,0.0066,0.0019
17456,91625,74169,1654,2148811477.1984,1542070931262482579.4281,74170,5.7782,0.0019,0.0018
21924,23039,1115,12764,2289239818.095,1499196465266565847.2867,1116,22.7229,0.001,0.0607
15310,43910,28600,11134,2152747281.1968,1532705953022761920.5111,28601,6.2456,0.0014,0.0032
6481,78235,71754,20773,2159521785.521,1537211261890330232.8645,71755,15.0913,0.0004,0.0053
11061,82816,71755,24080,2146965335.4098,1540391664961391070.6534,71756,2.7047,0.0015,0.0014
11054,86089,75035,914,2148220253.6692,1536807232760152960.1956,75036,4.2973,0.0012,0.0013
15204,43432,28228,18581,2133591043.8994,1528607969721029069.2473,28229,8.7634,0.0059,0.0006
27164,79701,52537,11962,2144364195.7576,1529039617621137397.7142,52538,12.5261,0.0042,0.0034
26555,61564,35009,22367,2145839491.0327,1532872561945953939.8591,35010,5.9174,0.0019,0.002
17604,55703,38099,30800,2144992405.2529,1536079113772616534.0361,38100,11.0559,0.0029,0.0018
8096,30556,22460,5929,2135424682.5902,1550374960516038623.8664,22461,12.9213,0.0071,0.0025
22363,77714,55351,14574,2144273657.4844,1545638747650507422.588,55352,13.7464,0.0038,0.0016
19736,27315,7579,11184,2125380925.653,1544921520443367853.1247,7580,13.753,0.0158,0.0017
3464,71010,67546,14272,2143798545.7329,1537210916933031218.479,67547,5.6754,0.0027,0.0008
28175,102773,74598,20073,2147679899.1372,1532661752808830356.375,74599,8.0054,0.0016,0.0015
1115,16368,15253,12477,2157667417.8973,1524029559825935322.4782,15254,2.9085,0.0029,0.0064
4549,10788,6239,19460,2128333137.8282,1545860532142638856.2038,6240,4.7214,0.0104,0.0023
29265,108351,79086,21175,2152285986.54,1543407275101439311.1947,79087,9.0747,0.001,0.003
2542,82704,80162,15587,2132523630.1497,1539667280167688948.5738,80163,20.4774,0.0061,0.000
11832,54573,42741,12462,2152385667.351,1535691375846946490.3453,42742,7.4966,0.001,0.0033
14288,111725,97437,30112,2142092340.5032,1534906098835814279.7975,97438,6.0946,0.0026,0.0002
10962,14526,3564,1917,2162616272.8603,1557403757969673145.3914,3565,19.4425,0.0117,0.015
25153,65131,39978,28635,2142678369.8499,1533763881468902564.9474,39979,5.2053,0.0031,0.0007
20526,79537,59011,20191,2144165827.0167,1529617034409048216.7043,59012,7.6787,0.0031,0.0018
26206,96947,70741,24856,2149516083.2156,1542540286204410076.9554,70742,11.1128,0.0017,0.003
4534,15226,10692,25899,2152695001.1579,1553388570266190158.9372,10693,12.667,0.0053,0.0064
6399,29379,22980,22660,2143424637.6275,1549071583994211763.7985,22981,3.9226,0.0046,0.002
6686,9177,2491,30101,2121135888.1581,1498023031070519543.7944,2492,12.7623,0.0198,0.0058
17550,106930,89380,4403,2150454641.8543,1535012794341434789.3336,89381,2.9928,0.0007,0.0018
136,74832,74696,1921,2149424281.7421,1547085399961394438.9126,74697,9.7443,0.002,0.0026
24309,39389,15080,26446,2153654170.0946,1527568158457142588.5826,15081,13.6208,0.005,0.0115
2994,4542,1548,31017,2115612334.8786,1517646108558035938.636,1549,5.3379,0.0184,0.0074
15285,27188,11903,2920,2143639469.2849,1535581755135688437.9672,11904,4.140,0.0046,0.0023
10845,64676,53831,4281,2140983938.5447,1540046893776443314.2502,53832,15.9722,0.0052,0.0007
14118,24647,10529,23374,2153534379.2797,1552154323727704129.4691,10530,5.4232,0.0044,0.007
4493,7413,2920,25432,2200533062.4454,1536334127029098736.1703,2921,10.5861,0,0.0266
28443,89483,61040,2869,2147606579.498,1538386062979410841.4655,61041,6.2323,0.0021,0.002
29997,92320,62323,1677,2142899456.4617,1542351450912485375.7842,62324,4.7205,0.0029,0.0005
28134,37180,9046,23113,2122822074.4753,1559086081253055518.9566,9047,18.6723,0.0132,0.002
7305,33033,25728,5517,2147669334.3681,1523434129873216884.7579,25729,5.4536,0.0035,0.0041
31898,115806,83908,8287,2148364494.8063,1532781700219367766.1554,83909,3.934,0.0015,0.0025
1476,86632,85156,15014,2141875967.2549,1532608387608700756.0391,85157,7.662,0.0027,0.0006
13554,107028,93474,19830,2152245990.4083,1533694825902916777.8104,93475,5.8603,0.0008,0.0033
21255,112318,91063,14747,2154462293.6161,1534959817035258894.0004,91064,10.1654,0.0007,0.0046
12117,19959,7842,7201,2130082987.1464,1549002496318713844.0666,7843,5.7413,0.0104,0.0042
32316,113917,81601,18202,2145294462.3064,1540491219997273971.5531,81602,15.9315,0.0029,0.0017
22153,31240,9087,26830,2158454224.6549,1522839223920372766.6626,9088,5.521,0.0053,0.0104
26956,50353,23397,18508,2153404029.7084,1518106958814639967.8889,23398,16.4549,0.0051,0.0059
19096,42213,23117,26989,2133917581.4194,1531320675806141376.4878,23118,13.0849,0.0072,0.0012
6216,17166,10950,19636,2133518500.6305,1526555531896076028.1349,10951,5.2457,0.0078,0.001
31480,82664,51184,27691,2137069923.6986,1538956897229342495.8856,51185,6.0086,0.0046,0.0005
20493,98542,78049,15494,2156140453.7914,1532563006799336989.2203,78050,10.6081,0.001,0.0049
17574,80867,63293,17186,2147333665.8816,1526546296077140965.7815,63294,7.9713,0.0031,0.0023
12137,75479,63342,15319,2151382554.207,1534046469145437162.6991,63343,10.4523,0.0014,0.0042
28050,73065,45015,11191,2143363768.5403,1531210126973936803.5466,45016,5.8369,0.0031,0.0014
6434,7461,1027,10272,2145322241.072,1570697540801500914.8139,1028,10.3499,0.0117,0.0112
4415,6343,1928,5693,2081582430.0041,1573207696523493849.7646,1929,19.9099,0.0301,0.0008
7136,72225,65089,23153,2149019440.7267,1534610562691752295.8725,65090,5.519,0.0014,0.0024
30036,117372,87336,7667,2139278497.9676,1538532784604106634.9301,87337,6.0503,0.0034,0.000
192,52377,52185,2186,2127150741.0581,1537310830371390688.0154,52186,19.2178,0.0075,0.0002
29409,89274,59865,14509,2139362299.9715,1534712978022724290.5838,59866,8.5572,0.0043,0.0003
2732,23832,21100,26314,2147830987.6303,1542195252485623405.671,21101,2.5948,0.0042,0.004
9022,84517,75495,30677,2152568733.5492,1542016069638477115.9858,75496,5.941,0.0008,0.0031
6975,25305,18330,1610,2146117602.4695,1551014875266337566.1215,18331,10.7199,0.0063,0.0051
15003,67333,52330,22051,2139597146.6304,1526411542089232762.6409,52331,11.4699,0.0046,0.0007
19178,88303,69125,3276,2152147859.0925,1532064983488749037.0644,69126,6.0059,0.0008,0.0035
29789,128050,98261,11108,2152738268.905,1538592612696735935.4951,98262,12.1862,0.0012,0.003
29652,98075,68423,12578,2154813673.4661,1526633717192518089.2782,68424,20.1703,0.0018,0.005
28009,33033,5024,10748,2133412811.7021,1553474913681535570.7421,5025,9.3641,0.0115,0.0035
3345,44474,41129,32138,2149018065.8653,1523261029914888899.1433,41130,13.1864,0.0032,0.0034
16403,98250,81847,27973,2155608830.381,1539488040716983786.9968,81848,7.3428,0.0001,0.0038
29622,41947,12325,21387,2130301755.6996,1547139425915674684.5869,12326,8.9137,0.0082,0.0015
8842,76032,67190,16983,2149042695.255,1531826027594505886.9101,67191,3.1392,0.0014,0.0021
5371,69198,63827,5841,2138020565.6199,1532110081606991561.7956,63828,12.6013,0.0047,0.0003
5141,53233,48092,7673,2159848894.3385,1541846219051136788.4624,48093,8.8871,0.0001,0.0053
8054,90905,82851,9537,2147837620.7372,1542047468933980573.2923,82852,3.2516,0.0015,0.0016
28021,77946,49925,22036,2144732830.671,1530131972566671517.1398,49926,3.4586,0.0025,0.0017
28433,70797,42364,6988,2140328090.729,1544400589241240446.7533,42365,10.1614,0.0051,0.0012
17147,44034,26887,9126,2149091190.6425,1548712550907633021.8789,26888,13.6789,0.0036,0.005
8624,16976,8352,19859,2127364391.0493,1526360073445591167.4038,8353,12.3556,0.0104,0.0001
11367,68180,56813,17896,2150556908.0587,1540938047606757280.6992,56814,4.9549,0.0008,0.0028
20757,58758,38001,1798,2152915593.5644,1544306326548146053.4569,38002,6.8538,0.0014,0.0048
20840,56975,36135,14642,2137802535.5992,1532810752150947054.1538,36136,22.7125,0.0073,0.0023
9832,82468,72636,7628,2149618755.6881,1540037517127984359.6031,72637,7.3932,0.0012,0.0018
31633,54571,22938,9058,2159346268.5774,1540263282936503058.2416,22939,5.5376,0.0005,0.0063
14446,88753,74307,905,2152019806.7377,1539629049636743627.8845,74308,4.0201,0.0002,0.0027
16952,87168,70216,12161,2154742208.3083,1537529516552822692.9021,70217,7.7836,0.0001,0.003
32647,51241,18594,15285,2159002099.9747,1554838264037247917.2843,18595,7.4296,0.001,0.0068
11256,77930,66674,31679,2145528698.4265,1532481834110046107.432,66675,7.4765,0.0028,0.0017
2676,93690,91014,27964,2149049316.7486,1532940958568500871.9281,91015,4.6483,0.0015,0.0017
10236,22606,12370,13286,2110604685.7412,1539999834568215092.8866,12371,13.4701,0.0152,0.0002
31502,86532,55030,11981,2143900345.7907,1537875663153147852.6262,55031,15.4719,0.0023,0.0016
20225,89553,69328,3539,2141519087.4803,1546896919063582541.6084,69329,17.5562,0.0038,0.0008
25763,41537,15774,15983,2164294578.2231,1532663484682012101.5682,15775,10.3916,0.0019,0.0093
7665,16767,9102,32420,2139741768.6042,1543152252368607068.8499,9103,4.8846,0.006,0.0038
30763,69891,39128,28778,2142467293.0209,1532461589565241044.5236,39129,5.989,0.0051,0.0017
31576,77522,45946,8998,2133791239.6752,1537142229035522621.4017,45947,13.1807,0.0057,0.0008
12580,52229,39649,3951,2145455427.1938,1537516462275247732.8637,39650,2.8661,0.0019,0.0014
32335,107176,74841,6412,2151256044.8544,1530144310399405431.9916,74842,10.7029,0.0014,0.0032
4451,33077,28626,6817,2175762100.5359,1530910047078601598.9586,28627,18.3017,0.0005,0.011
28657,60277,31620,26415,2145535106.4071,1559404107686575762.4469,31621,14.8284,0.0051,0.0045
28648,113822,85174,10221,2153834360.0013,1542897633342800728.2027,85175,6.486,0.000,0.0029
28766,86820,58054,751,2153005724.4201,1532358863018273451.247,58055,5.3432,0.0004,0.0034
17807,89094,71287,27199,2138388269.1402,1539845823716563031.9794,71288,13.3083,0.0058,0.0002
28121,59867,31746,777,2131836939.1995,1539568797088414268.7064,31747,10.4447,0.008,0.0007
30831,130278,99447,7019,2139654734.2402,1545089955616332639.809,99448,17.6317,0.0047,0.0004
24960,85617,60657,24518,2138085391.5695,1526217497568181315.9796,60658,13.3637,0.0051,0.0013
4688,67934,63246,28502,2155419166.7361,1541614279101262429.308,63247,6.6116,0.0006,0.0039
17153,52477,35324,5486,2139240242.4321,1531795416424372397.0256,35325,6.9678,0.0048,0.0007
17820,48961,31141,22525,2146732302.3043,1526474495476177810.3204,31142,8.7468,0.0036,0.0036
31221,99211,67990,27884,2143048875.6093,1541921385505619334.7018,67991,12.1543,0.0048,0.0016
19661,78032,58371,17693,2146022082.9762,1535883022023699589.8458,58372,2.8897,0.0017,0.0011
20028,96976,76948,25248,2148475509.7138,1529090964404549153.0768,76949,12.8683,0.0023,0.0034
20294,56169,35875,19256,2150001622.4792,1531725094153832909.5111,35876,3.3286,0.0016,0.0031
3013,75177,72164,27942,2149692714.2947,1538121993389244274.13,72165,11.113,0.0014,0.0027
31945,36079,4134,7013,2163634687.8237,1534115585795922746.1713,4135,13.7422,0.0036,0.0135
22620,115376,92756,13139,2140774545.3827,1542421865690219706.546,92757,23.0784,0.004,0.0006
20067,93753,73686,30107,2146772370.1084,1530547155504655534.7378,73687,15.3034,0.0023,0.0024
22445,64353,41908,23906,2134430325.8241,1530038894488649329.4207,41909,10.0048,0.0063,0.001
3913,49248,45335,20434,2149761022.5178,1536334377050863532.1885,45336,2.9822,0.0013,0.0022
15558,33450,17892,9746,2152134032.3995,1545282859926693281.4083,17893,3.5179,0.0018,0.0044
4168,27976,23808,5958,2143903562.3647,1544742923451474927.5457,23809,13.8231,0.0051,0.0033
13629,78168,64539,3886,2146336922.8171,1532903131734049972.5799,64540,5.0815,0.0023,0.0016
28442,42784,14342,12952,2146905807.6278,1513301859354202435.1703,14343,20.6947,0.0063,0.0075
28571,98155,69584,24184,2147143719.5787,1535260927625944597.4835,69585,10.4847,0.0026,0.002
13756,40438,26682,10228,2144545759.363,1530614256112850086.796,26683,8.0053,0.0038,0.0026
13338,36576,23238,28963,2149758654.8049,1541475943152258893.1895,23239,3.1938,0.0017,0.0025
22079,89386,67307,25186,2137543832.8774,1535066685355283106.8066,67308,8.3651,0.0042,0.0006
23581,72500,48919,5421,2134986150.8315,1524750710933119055.9856,48920,13.3793,0.0057,0.0007
31387,130911,99524,12991,2151444238.0605,1535625856720030686.7222,99525,5.9915,0.0007,0.0026
19896,104412,84516,18172,2137359618.3395,1533189321939656914.545,84517,12.1162,0.0042,0.0003
8810,48271,39461,12194,2161549680.9489,1535953005014680991.8162,39462,16.596,0.0001,0.0055
1666,41723,40057,29738,2145005546.408,1529911618154705856.747,40058,10.6106,0.0043,0.0037
6972,12224,5252,16856,2186115080.3834,1561142418870900211.7232,5253,12.1302,0.0029,0.0162
955,99835,98880,7368,2145909752.4644,1534462968128165312.0507,98881,10.4201,0.0022,0.0014
24676,67556,42880,32031,2142111444.3034,1542085289572629169.6062,42881,17.4969,0.0038,0.0014
7589,19358,11769,30697,2150629335.9316,1515633435185045710.8243,11770,9.3535,0.0087,0.0063
6973,61153,54180,1244,2153241085.1528,1531802712469392290.0386,54181,5.8695,0.0006,0.0039
16795,115244,98449,31264,2147473785.7421,1532449955228501267.1013,98450,10.0497,0.002,0.0014
2324,41778,39454,16626,2146462416.7812,1548957091464179165.6419,39455,10.2474,0.0036,0.0032
30942,85616,54674,2637,2151509725.2692,1543665145921672037.3958,54675,7.2525,0.0017,0.004
7398,47472,40074,30462,2141559790.0329,1544392380632787422.7131,40075,6.5988,0.0041,0.0021
21732,112393,90661,3034,2144192738.2775,1531973454200470638.3666,90662,6.0436,0.0026,0.0008
15334,111782,96448,19534,2140534294.6277,1538339451982504119.442,96449,6.8426,0.0032,0.0007
23421,25235,1814,16498,2127896355.9989,1480029701346184443.7025,1815,10.1826,0.0192,0.0078
18992,94926,75934,26541,2139649542.1184,1544533968424692816.6613,75935,12.8402,0.0037,0.0006
21259,68720,47461,14725,2141557053.0864,1531284287716991162.7751,47462,6.9312,0.0037,0.0008
430,1456,1026,5091,2276609174.1831,1576811396405190882.9246,1027,15.5426,0,0.0561
24540,97159,72619,8977,2144021807.6773,1541247493615881596.0021,72620,4.0952,0.0025,0.0007
32433,93525,61092,27409,2152747277.1428,1532872626362902705.3737,61093,6.8526,0.0003,0.003
19766,25279,5513,20469,2131939900.4684,1548396520207520262.2167,5514,4.0699,0.0099,0.0014
7535,23560,16025,8662,2159932850.4934,1542685658836758339.6625,16026,3.7448,0.0007,0.0057
9703,103188,93485,215,2154197090.1359,1530044233222873982.6064,93486,7.5353,0.0006,0.0037
24643,105171,80528,5058,2150001240.9769,1536645439152118787.5008,80529,12.0607,0.0008,0.0019
27420,116813,89393,9650,2156536550.1729,1528472615769279444.1435,89394,16.2742,0.0005,0.0043
3768,35798,32030,29053,2149681054.1605,1537836194144245532.0091,32031,9.0246,0.0015,0.0033
29110,80767,51657,14239,2144510565.2609,1528362025858190019.8116,51658,6.4592,0.0028,0.0017
26644,103706,77062,10312,2143346589.1132,1526277757339658696.2921,77063,25.4321,0.004,0.0023
16491,36908,20417,3517,2145977780.6018,1533166753649669910.838,20418,9.3944,0.0038,0.0053
11805,85190,73385,17194,2147003378.9906,1537967958333486217.1201,73386,11.4948,0.0017,0.0017
11662,58491,46829,29566,2144701451.4248,1532956693565999166.7862,46830,12.1261,0.0038,0.002
2159,60825,58666,25996,2153032789.107,1532524664891826803.0627,58667,15.315,0.0012,0.0054
3837,90335,86498,10108,2146561103.8988,1544698304753621843.4294,86499,4.0638,0.0023,0.0021
5969,89768,83799,30179,2149481586.2368,1534883892372143730.8764,83800,9.9104,0.0012,0.0022
26175,40331,14156,21352,2112800201.9465,1521113066512658112.5921,14157,14.7769,0.0122,0.0001
29428,49850,20422,11361,2155728872.62,1533249871708242385.1378,20423,9.012,0.0016,0.0055
20634,110488,89854,19755,2151083544.0585,1540918764664661759.1654,89855,15.150,0.0018,0.0027
24706,33103,8397,16349,2158769068.8417,1530721716858692394.7574,8398,5.4436,0.0022,0.0061
28406,121897,93491,1150,2136274506.5644,1535455780288046848.0426,93492,11.9653,0.0044,0.0004
8019,84707,76688,24382,2144475288.8036,1536899080471030547.5955,76689,7.2189,0.0026,0.0011
6160,68562,62402,28572,2140266793.973,1535954714329290216.1162,62403,4.9721,0.0041,0.0003
16792,41509,24717,2751,2148762367.3001,1519426726423434347.9545,24718,13.0146,0.004,0.0038
15033,82909,67876,27447,2144131974.4523,1529271827188652248.6551,67877,5.8359,0.0024,0.0011
6620,35464,28844,22455,2140042407.7804,1546741807334052510.1801,28845,14.9059,0.0072,0.002
27309,32423,5114,12562,2191650201.2512,1527880053193733128.9279,5115,15.1626,0.0005,0.0202
17852,59964,42112,26867,2158238256.9527,1538363102982014085.3465,42113,13.7991,0.0003,0.0042
30376,113942,83566,28089,2146308689.7681,1538876120456421002.3542,83567,7.592,0.0021,0.0015
18860,92754,73894,5872,2142871895.1997,1532831687080043563.4677,73895,6.7898,0.0028,0.0011
13138,43397,30259,28999,2140766116.4663,1528967571051367063.6954,30260,15.1993,0.0069,0.0023
4557,90932,86375,31074,2145329508.9665,1542831209761981900.089,86376,6.2631,0.0022,0.0011
16156,93319,77163,2246,2140970068.3864,1537365139217925449.8156,77164,9.2546,0.0037,0.0008
15140,37753,22613,29915,2119251072.3853,1542113791014598900.3264,22614,30.7131,0.0162,0.0012
7088,70879,63791,30237,2155832650.9778,1540830395396463908.4764,63792,16.9359,0.001,0.0044
4935,23851,18916,26717,2152011225.9322,1519125028069737985.0608,18917,16.0263,0.0031,0.006
31585,66135,34550,26014,2136013328.8981,1537381938213683467.6307,34551,5.7875,0.0053,0.000
2964,40905,37941,28844,2143808662.0439,1528934346115268505.0112,37942,6.3136,0.0032,0.0023
24692,66597,41905,14428,2146187144.9692,1539534293671401807.7132,41906,2.1187,0.0023,0.0012
26352,58096,31744,27505,2133705273.4322,1543387235199653826.2043,31745,13.9195,0.0081,0.0009
7606,80808,73202,14414,2156045562.7938,1541750962405084541.8145,73203,17.7608,0.0007,0.0058
22245,58219,35974,9357,2156017578.552,1539984097549571367.2925,35975,17.3671,0.0018,0.0064
24426,123337,98911,31989,2146855523.4683,1546880660272360744.0827,98912,8.9752,0.0025,0.002
40,30263,30223,30488,2145001331.9066,1511032541812548653.3563,30224,17.2157,0.0059,0.0044
1856,80149,78293,6837,2146898008.283,1533395661652525719.1594,78294,5.9478,0.0023,0.002
6958,47846,40888,9216,2146449914.034,1537968771565029209.6989,40889,6.3966,0.0034,0.003
13459,90700,77241,17016,2154715862.6604,1537595415766934845.3714,77242,9.2683,0.0003,0.0038
30316,75066,44750,29438,2138284760.1774,1525077461369107939.1166,44751,4.5091,0.005,0.0005
16211,73578,57367,5287,2146300114.496,1539830193985822647.5992,57368,3.4029,0.002,0.0012
13267,21831,8564,8579,2140728314.2746,1529948301121381727.4499,8565,8.7894,0.0071,0.005
17500,51545,34045,6016,2136640474.2032,1531451281813035067.7361,34046,8.5778,0.0058,0.0014
29544,68864,39320,27578,2142029671.0887,1536926758528214173.1166,39321,6.1525,0.0042,0.0011
9700,22687,12987,22184,2126466071.6811,1558794897641018620.4223,12988,15.243,0.0102,0.0019
23527,23922,395,21477,2158383386.9747,1558063199662496268.863,396,6.7424,0.0167,0.0265
31995,122080,90085,6485,2153052924.4332,1533956312811047456.8525,90086,5.9524,0.0004,0.0028
22005,55661,33656,26414,2150486452.4678,1540161160914122379.876,33657,7.3079,0.002,0.0032
10279,99232,88953,17145,2141216533.087,1538394561769438422.6279,88954,7.1438,0.0026,0.0001
12447,38803,26356,27239,2157501275.6125,1547868389138313368.5683,26357,6.9222,0.0016,0.0048
16113,74515,58402,7256,2153389305.3993,1529687937533862139.3956,58403,12.7659,0.0015,0.0037
4798,22580,17782,9888,2148434745.5487,1548071946856228298.5709,17783,10.7742,0.0044,0.006
9763,93517,83754,1031,2146588708.1753,1540253564933737430.9236,83755,10.7847,0.002,0.0015
9008,31514,22506,32517,2149733929.3272,1518521364652218351.3738,22507,7.6649,0.0046,0.0045
24813,83391,58578,17652,2140001031.6245,1530600800569360832.4413,58579,12.9648,0.0046,0.0006
5684,87606,81922,26279,2157810963.411,1530613501195199389.5394,81923,20.8215,0.0003,0.005
14934,100860,85926,9232,2143679780.9471,1541965737634384758.5483,85927,4.5747,0.0023,0.001
21514,120534,99020,2463,2147294428.7856,1540727577092872717.3779,99021,10.0242,0.0016,0.0012
29970,60716,30746,12587,2152324981.9495,1541687561978038953.5165,30747,16.2979,0.0037,0.0055
12852,84626,71774,15246,2146140087.8252,1539375973610341580.3181,71775,3.6383,0.0014,0.0008
12363,92668,80305,24024,2143859102.7056,1545688135890164596.3513,80306,4.9533,0.003,0.0015
27222,98215,70993,30975,2152363154.819,1540935198629750062.0784,70994,8.1995,0.001,0.0029
25328,70384,45056,10949,2148377699.0668,1530172250454346623.8792,45057,7.8737,0.0027,0.0031
7532,81384,73852,22275,2147277839.1503,1537680655665906318.0857,73853,2.5301,0.0011,0.0013
20623,38914,18291,4280,2138563136.9804,1534287297963432685.209,18292,15.3515,0.0066,0.002
20045,58082,38037,31733,2143527631.6243,1531108771713393258.6733,38038,7.0344,0.0044,0.0022
15862,57021,41159,14854,2146189460.3964,1540872071324835741.1032,41160,11.6278,0.0044,0.0022
14711,101054,86343,26841,2141856924.6241,1543071110153415323.3905,86344,5.825,0.0032,0.0003
7402,48223,40821,2291,2138930196.4512,1535636135546580186.8171,40822,7.737,0.0039,0.0005
22831,97159,74328,24473,2150819180.8476,1533042896527954279.3989,74329,7.0585,0.0017,0.0034
29344,75059,45715,1666,2159233348.572,1546117096018346905.817,45716,11.9825,0.0003,0.0061
4598,48875,44277,30665,2148132508.1151,1543848930223175198.8297,44278,2.9531,0.0023,0.0024
24586,25479,893,1178,2177430801.2092,1549883913045321526.935,894,2.2063,0.0084,0.020
30117,67226,37109,29917,2141090531.7251,1538960178537659404.9544,37110,8.0596,0.0046,0.0017
12014,35752,23738,24296,2147167635.8052,1546491953110520388.5276,23739,23.2933,0.0036,0.0033
9427,70832,61405,19257,2141997585.0716,1534340399670279365.1704,61406,8.3895,0.003,0.0003
22635,24228,1593,2358,2119872044.0496,1577992815411735828.7058,1594,8.8365,0.0195,0.0065
27829,89953,62124,14841,2146053204.1527,1540673090799791143.8379,62125,3.5212,0.0022,0.0023
25466,54063,28597,13312,2132472749.826,1538238132846845834.698,28598,10.0248,0.0061,0.0002
2951,17982,15031,7078,2163261056.8677,1545915272781565896.4282,15032,4.9049,0.0007,0.0076
379,32357,31978,31209,2133248525.7937,1535893194810148510.4614,31979,6.0121,0.0066,0.0007
20656,78139,57483,6851,2147848131.0893,1545159081957072079.9257,57484,15.2916,0.0022,0.0022
9678,44640,34962,15687,2139642613.2268,1543499890874654542.7141,34963,5.8932,0.0041,0.0005
19130,63720,44590,19760,2155800819.3598,1540860043478047024.1179,44591,5.2184,0.0003,0.0044
13029,102547,89518,4005,2153759057.6723,1537634992428245657.0321,89519,6.3103,0.0001,0.0026
25108,71722,46614,20596,2150364768.2496,1541747151246336790.4697,46615,5.6827,0.0013,0.0025
18310,79952,61642,3008,2145157227.5038,1526852697258504848.4685,61643,13.996,0.0033,0.0018
6577,91681,85104,28482,2143041194.9457,1546434077075962072.0994,85105,9.9815,0.0034,0.0016
10754,65384,54630,8471,2148087646.1621,1543307277706430102.8533,54631,1.142,0.0018,0.0026
2998,7163,4165,13640,2095260828.7885,1524419335819273819.0295,4166,10.9489,0.0205,0.0002
21706,53726,32020,21633,2142468250.0303,1531577185335041823.925,32021,5.6961,0.0032,0.0012
13935,61275,47340,22704,2153140966.8099,1535146143426311306.8064,47341,3.486,0.0014,0.0031
13456,66869,53413,5225,2152870899.3257,1532307228574850608.1915,53414,5.0457,0.0007,0.0033
11994,41805,29811,7512,2135173350.3896,1535038542734938171.6355,29812,6.2073,0.0065,0.0002
16153,108702,92549,12669,2155220378.5241,1549998757400134188.271,92550,22.4467,0.0017,0.0049
15244,35771,20527,10052,2126770806.6863,1539404486035629475.552,20528,8.1091,0.0074,0.0003
15347,30946,15599,3682,2143220636.3021,1548900771362569311.178,15600,12.5628,0.0064,0.0033
30987,102375,71388,24220,2156221497.4626,1530567652791352963.9977,71389,9.734,0.0007,0.0046
7235,93269,86034,9145,2146482031.0672,1540192796618721856.054,86035,4.1496,0.0016,0.0017
27799,40810,13011,24569,2159013339.6168,1512805437255188152.5929,13012,16.1722,0.003,0.008
3196,72085,68889,21744,2146015822.879,1537856197391453169.8445,68890,3.1713,0.002,0.0008
3911,50585,46674,23599,2152618722.1038,1527796433805549378.8144,46675,11.4883,0.0021,0.0041
17752,96073,78321,24663,2141492326.4268,1535429507455101305.3885,78322,11.5242,0.0042,0.0008
10088,67970,57882,23873,2150151201.2568,1539785939645600703.1603,57883,2.7525,0.0006,0.0022
2661,75871,73210,18690,2152776740.562,1538959403263353352.0688,73211,10.2344,0.0005,0.0031
26157,101164,75007,16186,2166961925.3908,1537665736985302126.9889,75008,26.1001,0.0001,0.0072
17438,27637,10199,18324,2124637281.8686,1543449672106602605.0757,10200,11.7557,0.0108,0.0012
3615,103277,99662,21573,2146765550.7546,1537498624204184283.8987,99663,7.1926,0.0019,0.001
19990,68534,48544,19447,2151894988.746,1549803974685941069.7926,48545,9.1517,0.0018,0.0039
8574,15389,6815,10178,2126480359.4624,1512914437632255657.5068,6816,7.2995,0.0102,0.0018
2857,16373,13516,31562,2161461787.0053,1516412645819584693.5073,13517,8.3309,0.0027,0.0082
2983,38922,35939,10501,2148476269.5269,1524282484834224352.3063,35940,6.4908,0.0026,0.0031
22476,93089,70613,20473,2148625784.5062,1530504322451410690.8885,70614,3.3498,0.0015,0.0022
8603,99662,91059,30910,2156770154.5699,1540980241113955599.1945,91060,13.4749,0.001,0.0038
18164,81803,63639,1059,2145089101.4412,1535963359042350096.5829,63640,14.8888,0.0041,0.0018
23962,36717,12755,1463,2163934652.2444,1563515150790637219.6231,12756,14.9133,0.0031,0.0106
26020,80675,54655,8196,2140458789.9918,1532713088297340113.6428,54656,6.4826,0.0035,0.0007
6047,11536,5489,32068,2106466172.48,1536063842313829157.0827,5490,10.3394,0.0196,0.0007
6977,10345,3368,1983,2129693991.7008,1555948391069149401.828,3369,7.392,0.0179,0.0059
26973,69268,42295,1229,2139297543.6589,1548788942081711185.9883,42296,18.1432,0.0073,0.0015
803,99698,98895,17843,2139900093.1852,1539490295048381042.6304,98896,9.6945,0.0042,0.0004
18573,39418,20845,26891,2136996137.6844,1531395631812275304.1469,20846,7.7834,0.0054,0.0004
7686,32731,25045,16377,2140264376.384,1551519296367639796.5897,25046,19.3789,0.0063,0.0024
11413,94725,83312,17513,2158965400.9338,1539756735651966902.3158,83313,10.579,0.0001,0.0043
7897,101023,93126,31802,2140487696.8257,1534031369341386271.2835,93127,5.9941,0.0036,0.0005
6071,48089,42018,19459,2137460611.8807,1537057256514390130.529,42019,4.9375,0.0045,0.0001
18,3555,3537,30976,2144748728.2778,1546767851645925062.5393,3538,5.2908,0.0091,0.0071
2983,86302,83319,18219,2146248697.1434,1547747061206883108.4368,83320,8.0482,0.0026,0.0024
1723,26749,25026,1827,2162381515.5305,1534416448400164090.5482,25027,14.8255,0.0003,0.010
13794,101508,87714,16639,2143271050.6578,1533123033403177668.2732,87715,6.0666,0.0035,0.0009
22712,108828,86116,24444,2138764577.735,1537526617926423404.3841,86117,10.3602,0.0038,0.0006
26450,29404,2954,3650,2106802480.535,1512294744476561933.1733,2955,12.2762,0.0186,0.0005
16626,18448,1822,32051,2141630694.8239,1553022542019976603.308,1823,6.7588,0.0131,0.0113
32159,125224,93065,7169,2152582774.9028,1534177131500186343.4166,93066,21.3949,0.0004,0.0027
19380,102889,83509,28885,2137728733.6421,1534722059147275786.6019,83510,9.018,0.0043,0.000
2984,96638,93654,30669,2142901773.7015,1537603847536959203.7908,93655,6.8079,0.0031,0.001
22480,57794,35314,22011,2146585328.8722,1544026498828025832.6826,35315,3.9345,0.0039,0.0039
1647,38025,36378,7408,2142117225.5778,1540246227327004450.5181,36379,5.9675,0.0037,0.0006
9364,97224,87860,18805,2147486214.1924,1543353149495459689.4961,87861,11.6659,0.0025,0.0021
31908,33606,1698,7691,2192379839.1536,1555534014557574591.7981,1699,5.0031,0.0018,0.0231
3562,91934,88372,15401,2148669527.5453,1543023040764404241.1642,88373,6.8531,0.0018,0.0021
18633,68293,49660,8601,2157478955.3996,1534002772337018343.6974,49661,13.8371,0.0003,0.0049
30445,98201,67756,7538,2149405641.9616,1534347771344581621.1915,67757,10.6346,0.0013,0.002
30037,67117,37080,18151,2166820634.4619,1535680113077598366.6281,37081,20.2395,0.000,0.0074
13179,61872,48693,31716,2140865322.0502,1537886724935911990.4342,48694,4.0112,0.0034,0.0004
31900,66668,34768,16391,2147952761.9042,1537587587801128778.5271,34769,1.4587,0.0016,0.002
11596,103835,92239,1114,2155318022.9366,1547582766696827760.3753,92240,14.5189,0.0012,0.004
30927,58181,27254,8276,2134318751.4909,1542014092868973817.3952,27255,7.6143,0.0058,0.0014
12882,48285,35403,32689,2156172783.8663,1547030006313185366.4661,35404,8.8008,0.0019,0.0061
23546,82832,59286,12034,2152555247.6157,1535929801617924138.7566,59287,15.0246,0.0006,0.0052
30400,85839,55439,21794,2158429259.3095,1533642175445528593.4074,55440,14.5795,0.0007,0.0064
19093,26549,7456,19561,2150506550.4222,1547784204252412612.289,7457,7.920,0.0045,0.0063
20135,112676,92541,26184,2149798071.1237,1542333504947638703.4218,92542,12.5066,0.0011,0.0024
14164,30322,16158,18747,2148858514.542,1539929744409884859.7563,16159,20.8712,0.0044,0.0084
1878,100295,98417,30635,2140237876.9003,1537480488953351971.908,98418,8.6008,0.0035,0.0002
22116,88216,66100,76,2148706498.7161,1544985407424200365.8225,66101,6.572,0.0018,0.0024
9153,21852,12699,8827,2163602198.4153,1537482600004406143.0828,12700,12.9553,0.0012,0.0102
4290,82183,77893,32374,2146395148.9276,1541203399520864695.9332,77894,5.8637,0.0019,0.0011
17583,64504,46921,135,2141733362.8138,1536979985795599255.1602,46922,11.1544,0.0058,0.0009
18840,45783,26943,18842,2137379847.348,1544056414291243099.0962,26944,8.0971,0.0055,0.0005
21056,48613,27557,1788,2152095178.0494,1544415569485327207.61,27558,6.7031,0.001,0.0036
13059,86655,73596,18670,2136912865.9959,1536827543240619446.6178,73597,10.9459,0.0045,0.0001
22439,106702,84263,26627,2151705301.4406,1533110227818026938.2218,84264,3.5115,0.0008,0.0027
30588,91129,60541,15571,2151462179.728,1542562968600230197.129,60542,7.337,0.0011,0.0035
29538,42964,13426,22475,2180893262.5109,1548607944933837053.7649,13427,23.0513,0.0021,0.0157
9397,75175,65778,9077,2137007217.8975,1529109740905224423.9489,65779,7.3609,0.005,0.0006
3442,49662,46220,29943,2145146545.1099,1539730412142286846.996,46221,8.8626,0.0036,0.0028
11407,43112,31705,3374,2143036950.0463,1546591410775640180.2791,31706,12.6038,0.0042,0.0024
7691,53527,45836,10021,2154871719.6168,1538707333433561504.6852,45837,7.9676,0.0003,0.0038
3855,40690,36835,24021,2130456635.3771,1538274431763161126.3867,36836,17.2324,0.0091,0.0007
29734,46936,17202,4562,2154960555.3841,1551121594051203865.5488,17203,13.5534,0.0038,0.0066
16325,48948,32623,22553,2134739211.604,1539698882656530066.4481,32624,19.2703,0.0095,0.0012
2718,65649,62931,26308,2148227541.6189,1524700258368633415.2691,62932,14.8799,0.0026,0.0029
8972,27386,18414,2944,2132271184.3018,1556207297724916405.6173,18415,19.3439,0.0093,0.0014
15798,83168,67370,12621,2138230208.403,1531189752707494052.4229,67371,15.3412,0.0054,0.0003
22873,106210,83337,10539,2141529158.2246,1538611555681704628.0008,83338,5.9163,0.0024,0.0001
7282,72042,64760,20291,2133561542.3015,1531195099075143873.0352,64761,12.4211,0.0054,0.0002
28465,68488,40023,21572,2138381995.7946,1538538646546975913.2777,40024,12.7145,0.0041,0.000
23664,122379,98715,29311,2148975576.6231,1546866934290857567.3954,98716,15.8519,0.0026,0.0028
11438,36796,25358,12139,2139935706.1405,1552125895202225295.8423,25359,14.3883,0.0067,0.0033
23254,93940,70686,15776,2136316211.7858,1532213513148507942.6216,70687,8.6363,0.0048,0.000
31896,54893,22997,15600,2157925903.4075,1536086509396110690.4215,22998,4.9353,0.0004,0.0051
28419,66162,37743,19173,2146549977.1889,1548163542092602253.8726,37744,9.1553,0.003,0.0029
23555,101270,77715,6381,2144242579.3903,1547065358727104801.3174,77716,11.1284,0.0027,0.0022
6480,27021,20541,29345,2155483127.9983,1558360389671390788.3152,20542,9.9691,0.0025,0.0063
20175,88821,68646,20221,2149228471.1282,1531998606368401194.8736,68647,2.7189,0.0012,0.0021
7823,78511,70688,29697,2154307226.5941,1545204485429591313.5603,70689,5.3792,0.0012,0.0038
14608,18473,3865,28196,2142022543.322,1518950962592440318.7553,3866,6.8482,0.0094,0.0062
8654,52479,43825,2289,2151628736.7432,1537400443686589442.4057,43826,9.6663,0.001,0.0031
19692,24271,4579,28772,2078188766.3716,1542013098921339031.9881,4580,19.4494,0.0265,0.0003
2724,68239,65515,17321,2157083000.5244,1542402576925005388.3171,65516,8.9022,0.0005,0.0049
10941,23856,12915,728,2134045707.8116,1535885824939034431.3601,12916,7.4375,0.0098,0.0011
30786,71338,40552,27172,2135542745.5057,1535397359814581684.9741,40553,6.0592,0.0054,0.000
8871,80734,71863,22651,2150965657.0456,1536851976449395631.7997,71864,1.7939,0.0008,0.0022
15525,81077,65552,7090,2156895444.311,1546687451959081507.2832,65553,6.3572,0.0002,0.005
5493,85104,79611,2534,2136263186.6888,1540727283093033995.4455,79612,18.4813,0.0052,0.0001
13773,99392,85619,22560,2135883470.013,1534799347669724148.8846,85620,17.7078,0.0054,0.0003
28892,39014,10122,20135,2145062754.5172,1525687423110346055.3652,10123,5.6871,0.0043,0.0038
32279,108670,76391,22639,2150131183.5121,1545646379452881487.9707,76392,8.5653,0.0017,0.0031
1436,45054,43618,26051,2136483706.5435,1535533463718482132.7805,43619,8.7296,0.0054,0.0011
7007,96226,89219,22214,2148367821.9125,1543223909015741711.0687,89220,8.8177,0.0015,0.002
3660,53937,50277,28084,2143770753.4762,1534295342952125592.6808,50278,3.0309,0.0029,0.0009
3508,71259,67751,32014,2150024728.9387,1519665026236012222.4159,67752,29.7403,0.0027,0.0044
22343,28567,6224,16564,2121740238.468,1537473905533528767.965,6225,15.4509,0.0155,0.0021
18268,105320,87052,8202,2152378652.7316,1542801966759434855.8089,87053,10.6926,0.0006,0.003
6478,82149,75671,887,2139083955.633,1537328544652051451.2872,75672,8.9655,0.0041,0.0004
8584,44005,35421,11840,2149095293.7379,1542434954427652400.9549,35422,3.2808,0.0014,0.0026
6866,16774,9908,10625,2144080361.3017,1546535720232447676.0678,9909,8.6067,0.0048,0.0032
6611,36439,29828,15091,2148520825.0557,1546112942279032809.7322,29829,5.8862,0.0036,0.0028
22382,104860,82478,19189,2136321307.9146,1534152110667146777.8637,82479,14.9853,0.0047,0.0003
17511,116507,98996,26314,2145202930.3833,1535812169442958823.8801,98997,14.1685,0.0036,0.0012
215,56491,56276,26117,2143354706.1036,1544318151744544365.107,56277,4.4344,0.0029,0.0025
31801,102607,70806,17857,2145718653.1657,1551004716113828006.8859,70807,16.9369,0.0041,0.003
22877,122596,99719,12960,2139949614.4675,1536179377643085586.761,99720,6.8039,0.0038,0.0004
855,16156,15301,6775,2165673014.5067,1541429417650170015.8138,15302,8.3773,0.002,0.0106
6265,26262,19997,1647,2155835406.0167,1552912409451084296.1115,19998,7.8463,0.0027,0.0081
1968,62876,60908,3481,2144455504.9591,1542930334520029562.8796,60909,12.7544,0.0028,0.0013
22079,87502,65423,2856,2144890177.6761,1537538180461222641.6893,65424,15.818,0.0021,0.0013
5769,12926,7157,17906,2139432307.8783,1526233407480947723.5928,7158,9.8127,0.0077,0.0044
18337,95782,77445,16064,2150530462.9551,1533340041823174184.2131,77446,4.243,0.0008,0.0032
889,25037,24148,7321,2159830764.675,1526280563135085293.0332,24149,8.2885,0.0005,0.0064
12582,54106,41524,1853,2137070019.1144,1533300430056180519.0881,41525,8.5223,0.0054,0.0006
3834,50118,46284,1919,2135153797.5492,1525587850101520714.3294,46285,11.6163,0.0067,0.0006
30792,87337,56545,31884,2142660250.8604,1534172554240906151.7264,56546,12.1854,0.0034,0.0015
2604,42055,39451,1964,2156696962.4926,1544651548998211931.5756,39452,12.5019,0.0009,0.0048
695,39266,38571,2827,2153095928.5972,1537193179505258120.6924,38572,11.1118,0.0016,0.0042
17697,62028,44331,18690,2154026941.1477,1538750309312725569.7069,44332,12.7973,0.0006,0.0037
20481,28520,8039,9818,2143305491.4463,1522583718060659755.0312,8040,8.583,0.006,0.0051
15570,75776,60206,23412,2146630020.806,1530590652497949966.4753,60207,9.8016,0.0028,0.0026
29682,53556,23874,21419,2136783494.0601,1523742461358431015.6334,23875,10.3817,0.0087,0.0022
13717,50918,37201,31443,2140959480.4225,1541691769748874163.0108,37202,11.0275,0.0044,0.0011
2412,84808,82396,22526,2152766848.9565,1535143518411943240.1761,82397,5.5119,0.0002,0.0031
13737,82354,68617,7866,2151487645.1613,1541372775286336069.7601,68618,12.6534,0.0017,0.003
5439,18446,13007,5588,2148842303.6402,1536730054941563706.4886,13008,17.4997,0.0066,0.0038
15499,63963,48464,9834,2138890919.1054,1548500821360424956.8331,48465,18.2412,0.0049,0.0012
12595,44631,32036,18581,2136867650.5785,1527760503213549880.6792,32037,7.9041,0.0052,0.0004
26186,42865,16679,22280,2152858140.3748,1534288488845351414.8833,16680,10.3251,0.0025,0.0075
30530,90744,60214,12811,2144616347.637,1532830841432678142.9579,60215,5.0417,0.0034,0.0012
18448,69662,51214,27185,2149967603.842,1540149740253399948.8001,51215,9.0374,0.0019,0.0029
26834,109502,82668,32470,2135902220.2461,1531728433034493973.1075,82669,11.9837,0.0048,0.0005
27720,67695,39975,17238,2152373517.9631,1551274823242474216.8408,39976,10.3532,0.0033,0.0051
30323,51210,20887,9414,2148886927.1147,1530646768632033518.4968,20888,6.356,0.0028,0.004
26342,34002,7660,18924,2161518531.4755,1548626531715796492.924,7661,7.7891,0.0031,0.0086
31364,64663,33299,11011,2152981802.1112,1545933974204832579.4022,33300,5.4646,0.0014,0.0031
8856,67382,58526,652,2150664047.0793,1532524010493347413.6597,58527,5.327,0.0016,0.0031
25937,124379,98442,21548,2143878604.6179,1540323981345437628.0729,98443,4.7985,0.0021,0.0005
19713,59665,39952,9669,2147797272.5482,1551072562801790726.7168,39953,7.9101,0.003,0.0037
23615,42319,18704,25916,2163022610.8112,1538575903035236204.882,18705,8.3346,0.0009,0.0073
2640,73969,71329,22084,2153074647.9894,1534616437482714694.453,71330,4.5105,0.0005,0.0028
22346,38881,16535,28575,2157391436.755,1538292207949083064.827,16536,4.0909,0.0015,0.0054
23363,68144,44781,23514,2133367744.8715,1522838072871297973.3574,44782,19.2625,0.0076,0.0001
26345,40844,14499,27871,2165467896.8142,1543602471868341350.9085,14500,7.0555,0.0002,0.0099
20667,102321,81654,19220,2151259268.2305,1541501924776852769.1229,81655,11.244,0.0012,0.0031
12564,29882,17318,28613,2166784082.7957,1532753317107453565.2534,17319,9.6214,0,0.0075
8351,72093,63742,27551,2157368955.3471,1538250361023508954.5275,63743,14.4728,0.0008,0.0056
12409,54747,42338,9498,2155496393.7522,1549305880514645164.0306,42339,7.6336,0.0011,0.0053
32694,84400,51706,15460,2159641553.2704,1542995049731972272.71,51707,7.5915,0.000,0.0057
10119,33925,23806,27369,2158687811.3837,1524149400888803312.0482,23807,14.4705,0.0008,0.0064
3680,66808,63128,27350,2159449190.694,1533345879257660117.6662,63129,11.6882,0.0006,0.0063
22513,28209,5696,17501,2149849327.4899,1550791034173495778.4086,5697,11.6338,0.0087,0.0083
31967,81207,49240,15515,2146793167.8292,1539898772302645038.7978,49241,1.1679,0.0016,0.0016
1814,79581,77767,661,2151454044.8795,1532293145197200625.0778,77768,8.3169,0.0008,0.0029
15050,80879,65829,20839,2149859441.4175,1536222410850139125.4009,65830,3.1611,0.0006,0.0021
6364,15276,8912,21458,2147163561.2182,1538848406577032415.3718,8913,2.9863,0.0027,0.0028
18344,112166,93822,3770,2151404896.306,1529603371216714628.9359,93823,8.5808,0.0011,0.0026
4860,41928,37068,3120,2155002435.3946,1528522572591780480.8787,37069,8.5737,0.0024,0.0046
18630,98664,80034,26243,2158713505.3718,1534235486469780572.7626,80035,19.6243,0.0006,0.0059
23627,50263,26636,29940,2152809811.7659,1528100976056975279.0234,26637,4.1872,0.0015,0.0045
5568,56998,51430,4629,2137308474.8674,1550695270548347064.5796,51431,11.3123,0.0061,0.0013
29435,110659,81224,6476,2150923274.5855,1536716874884640876.2576,81225,3.0711,0.0005,0.0022
8919,82806,73887,5873,2157673343.9712,1527964089244548989.5836,73888,14.7646,0.0006,0.0052
23488,79717,56229,15959,2153654614.513,1537840279148169936.5246,56230,14.6858,0.001,0.0036
28137,70401,42264,4926,2149685445.2226,1535762095983687962.2132,42265,3.9304,0.001,0.0023
29924,47871,17947,26981,2140584864.3776,1541891231144890341.7909,17948,7.567,0.0038,0.001
2905,42663,39758,17537,2158022840.3187,1535723496482451186.9578,39759,15.3026,0.0002,0.0071
8541,72675,64134,8475,2159331590.9921,1523362192582491714.6285,64135,19.7665,0.0013,0.0071
17284,115243,97959,13805,2138444135.673,1529140305186641769.8931,97960,15.7508,0.0045,0.0009
2076,66531,64455,1806,2144734649.4531,1536554881669148008.9796,64456,10.7197,0.0035,0.0015
22778,36912,14134,17061,2146932937.2031,1549118155517287153.7904,14135,4.2307,0.005,0.0058
13,933,920,4054,2264461727.8056,1498866759756793280.0979,921,21.9152,0.0022,0.0536
22710,94561,71851,15021,2160266250.1638,1538163392410924566.707,71852,12.1948,0.0004,0.0051
4295,25009,20714,6980,2150544666.8869,1533624972506872666.4973,20715,12.7094,0.0031,0.0041
19603,99363,79760,27578,2139981295.9229,1538431528209468488.6119,79761,4.4046,0.0034,0.0003
11429,81502,70073,25160,2156242729.549,1531924114225497805.267,70074,12.4504,0.0002,0.004
17048,103878,86830,25949,2154408878.6718,1547973758681421427.8483,86831,13.8663,0.0015,0.0055
31414,64762,33348,28136,2137277686.4401,1528370193561463300.4771,33349,21.4856,0.0082,0.002
30816,130131,99315,2285,2145041568.5725,1534053511620787564.4712,99316,4.6246,0.0021,0.001
16012,76307,60295,3019,2146874834.6357,1537199897997877113.0294,60296,9.1514,0.003,0.0015
23523,70242,46719,25404,2131466933.2041,1534744079943633633.2583,46720,14.6213,0.0055,0.0002
17106,108697,91591,12313,2139508679.1798,1530737998905206671.8594,91592,12.500,0.0035,0.0006
22665,35882,13217,19657,2144755027.5,1517572250742799042.0357,13218,18.9949,0.0088,0.0052
17347,28434,11087,31065,2147256507.2056,1518407384291858930.9859,11088,10.4019,0.0046,0.0061
985,30994,30009,25441,2139117445.1283,1535472833514073603.8987,30010,6.073,0.0045,0.0006
9262,84059,74797,4386,2154294788.2927,1540713212291589762.6498,74798,4.433,0.0002,0.0035
7600,59186,51586,21814,2153493315.6839,1537175600144054041.2017,51587,18.6099,0.0009,0.0035
172,29869,29697,29144,2147201063.7085,1547947802195062414.0267,29698,3.9983,0.0033,0.0026
28435,108172,79737,3429,2149285955.9045,1537347808611701983.424,79738,8.849,0.0018,0.0023
13575,46220,32645,6996,2141048886.7213,1539320822424753430.237,32646,6.2507,0.0046,0.0012
19526,95782,76256,23883,2146728844.8768,1536568279888963403.5728,76257,4.621,0.0025,0.0021
11806,99380,87574,27324,2149944052.9429,1539301853300312565.8573,87575,15.0126,0.0018,0.0021
31686,117640,85954,18248,2146049624.14,1541702321944200214.5069,85955,12.7689,0.0029,0.0017
9419,91046,81627,18561,2148913486.7234,1526731380309810464.5638,81628,8.799,0.0022,0.0026
25755,30016,4261,17163,2150410689.5347,1532064191602022771.6144,4262,9.5888,0.0102,0.0087
21614,29358,7744,14737,2142600662.664,1534097068455493849.7603,7745,7.0508,0.0057,0.0033
7651,15916,8265,19666,2140431438.4765,1534634988278163710.5725,8266,12.0612,0.0092,0.0047
10661,62816,52155,21198,2142200231.3173,1537062612768849363.7342,52156,6.5553,0.0024,0.0004
6340,23333,16993,9306,2153158594.9012,1554798565580310836.9382,16994,8.7514,0.0032,0.0061
12514,59789,47275,7486,2135888943.6327,1533969121627476781.9869,47276,10.055,0.0056,0.000
30721,53781,23060,18674,2165372803.7512,1533290240938945419.7785,23061,11.4797,0.0002,0.0065
14624,88687,74063,740,2145357291.7696,1539739118787301319.4795,74064,13.2182,0.0021,0.0015
765,16158,15393,28193,2109037363.1134,1562324198307996074.4809,15394,28.7186,0.0156,0.0004
26986,113283,86297,27196,2149210625.6173,1538492326193050790.1574,86298,17.0179,0.0017,0.0019
20268,67087,46819,11758,2151937702.5254,1545310676843779232.1059,46820,6.2385,0.0013,0.0036
11374,64925,53551,7991,2151357658.5063,1544181862476692179.0008,53552,6.4142,0.0014,0.0032
5265,64384,59119,4779,2142905189.9076,1538818531975730327.1913,59120,12.9797,0.0026,0.0007
19830,78369,58539,14769,2145144562.341,1522454635296041775.2231,58540,12.5757,0.0032,0.0023
23850,46474,22624,11651,2155845203.6932,1538918216737025173.1875,22625,7.2236,0.0018,0.0052
16360,85571,69211,25231,2148285847.5799,1537146805161994091.8943,69212,9.7031,0.0022,0.0025
28138,87328,59190,28530,2145196857.4263,1537465465807985260.5423,59191,12.119,0.0027,0.0015
21340,63159,41819,24158,2138445287.399,1537127234540958765.7468,41820,5.5357,0.0055,0.0007
8087,63513,55426,14146,2143705659.6514,1539954529002271964.0458,55427,9.3142,0.003,0.0011
8656,101017,92361,8032,2145536335.0766,1535259875871138754.5405,92362,7.9883,0.0023,0.0014
7733,25800,18067,28262,2143988526.111,1518391120724314370.9464,18068,13.8836,0.0083,0.0045
6471,40167,33696,19213,2145000910.1419,1531609008596419365.8069,33697,2.8468,0.0036,0.002
25494,79955,54461,18714,2149530903.4549,1544341246891963964.2889,54462,10.4842,0.0015,0.0026
572,43406,42834,24006,2136607152.7581,1552473805614744606.5729,42835,23.1091,0.0061,0.0013
9792,54599,44807,1564,2145407234.7244,1540833468336706403.631,44808,8.5263,0.0021,0.0015
22024,118620,96596,25871,2154334017.7591,1529645603786050271.9879,96597,13.253,0.0007,0.0031
24830,38361,13531,8215,2134512427.3256,1545444344993338393.4623,13532,6.2484,0.0076,0.001
29794,61063,31269,5834,2166596352.782,1534137800969403850.2106,31270,16.0268,0.0008,0.0081
29336,109773,80437,32522,2142303945.6708,1532529044308260300.9736,80438,4.584,0.0034,0.0005
15839,42433,26594,10066,2140891845.3066,1558695576900512330.6356,26595,7.7456,0.0062,0.0033
21027,65333,44306,21317,2150446067.4332,1538970893546774043.7889,44307,2.4409,0.0007,0.0024
2325,4262,1937,700,2156841195.1636,1510699356624362259.6889,1938,17.6072,0.0108,0.0136
13941,91105,77164,31091,2151649191.4838,1530291005729870765.6632,77165,4.876,0.0012,0.0027
5108,23953,18845,11548,2150176565.5652,1541088865292468393.332,18846,8.743,0.0018,0.0034
12119,34072,21953,21419,2169651184.4904,1529197805523962335.1229,21954,18.6885,0,0.0097
18039,85655,67616,950,2155644155.8538,1540687572278972971.0672,67617,9.0325,0.0001,0.0045
26258,100244,73986,7714,2148158294.2844,1549882446582128072.4187,73987,13.254,0.003,0.0025
6914,14044,7130,26121,2134327347.6135,1561485235998103917.8753,7131,7.6091,0.0088,0.0034
3375,12349,8974,14265,2150391768.6341,1538802959119118195.354,8975,3.9327,0.0029,0.0048
456,20090,19634,17985,2158499476.0589,1550991596790549219.4943,19635,7.9419,0.0021,0.0074
10220,33453,23233,10813,2152199702.9396,1539752645461108516.3357,23234,4.9488,0.0016,0.0053
23595,41231,17636,12873,2149738055.5621,1531181893800120566.9572,17637,15.6244,0.0054,0.0048
903,72871,71968,15982,2157795681.1259,1548535848763729176.7446,71969,17.2936,0.0013,0.0063
25751,62244,36493,19089,2138777418.2807,1529296773365738306.7078,36494,5.0545,0.0044,0.0009
9493,77644,68151,20212,2147121800.9563,1534157496194136957.0146,68152,6.6976,0.0023,0.0021
18745,105152,86407,2626,2151883620.983,1533794514194051301.175,86408,7.2958,0.0006,0.0032
4151,42403,38252,26031,2145044994.9982,1537665899820102447.8216,38253,9.4064,0.0038,0.0033
31026,112364,81338,31525,2142817360.6303,1531933638836481847.7056,81339,5.1584,0.0024,0.0007
832,6716,5884,4592,2142265511.2554,1519060144477060102.635,5885,3.7554,0.0081,0.0038
30783,93941,63158,19247,2148805304.7668,1539442416132734850.1718,63159,5.8329,0.0014,0.0022
8163,47226,39063,16566,2160800970.9491,1527642719372914244.6784,39064,15.8693,0.0011,0.0074
8087,37088,29001,10140,2164750945.7336,1538167661723034939.5294,29002,13.3129,0.0004,0.0087
12479,40050,27571,5858,2131465334.7418,1523471338374666215.8072,27572,17.8729,0.0098,0.0015
6673,22843,16170,31873,2127890832.4888,1526066815863569610.1889,16171,10.177,0.0087,0.0012
20220,89453,69233,21474,2151641854.7148,1539481988127933103.3875,69234,20.3988,0.0014,0.0029
18134,57178,39044,19748,2147223055.8127,1520306017401884901.1133,39045,16.2571,0.0035,0.005
8029,105682,97653,21730,2138222064.5028,1539499354815712075.1583,97654,9.8809,0.0035,0.000
31991,130992,99001,23170,2141729505.064,1544479418850222259.2415,99002,7.8498,0.0032,0.0007
19222,99748,80526,20049,2139547221.4465,1537382371288695435.2315,80527,8.9294,0.0042,0.0008
25603,84304,58701,18187,2143671522.6508,1545956412509934778.2979,58702,9.3951,0.0033,0.0016
21240,62631,41391,15032,2146190650.1301,1531072178728066482.4096,41392,8.352,0.005,0.0025
22473,100306,77833,872,2142087879.6015,1536835756824885833.2011,77834,6.0234,0.0032,0.0004
23595,84396,60801,10292,2144076570.2191,1540699992454892750.8025,60802,11.4689,0.0042,0.0017
11888,44756,32868,27242,2150823955.3705,1529085621714273609.4237,32869,5.1375,0.0017,0.0038
12766,32705,19939,11332,2141119966.976,1528484383364572873.6786,19940,4.0412,0.0055,0.0021
29603,38158,8555,6778,2137573335.1007,1532493462023395981.1593,8556,14.148,0.007,0.0019
5125,72064,66939,10499,2158723244.9896,1543272054227454693.5583,66940,11.4508,0.0005,0.0046
10226,51126,40900,20087,2151759170.4275,1529904923621214727.7803,40901,8.4612,0.0026,0.0041
1962,79873,77911,31385,2147146179.2887,1529985495203309127.9936,77912,9.9162,0.0028,0.0024
4137,46076,41939,5102,2147698435.5299,1544493007721041204.9383,41940,12.2377,0.0034,0.0032
18560,44689,26129,26578,2145820332.3836,1527289349805860077.4733,26130,5.9865,0.0035,0.0032
25634,76644,51010,6352,2148352467.6436,1539511953912751966.4537,51011,17.4497,0.0024,0.0023
20098,64456,44358,4853,2143069666.1143,1544223406493413683.1211,44359,5.0459,0.0033,0.0017
12682,72469,59787,10054,2156293921.8486,1530035334906747244.2422,59788,17.4031,0.0003,0.0052
7248,15337,8089,32613,2103026982.2604,1525548425613545864.1157,8090,32.9851,0.0261,0.0001
4351,45192,40841,6967,2156066149.3465,1525761646646075829.3445,40842,11.5521,0.0009,0.0047
5469,69134,63665,13144,2154790784.7077,1539641854751302528.6955,63666,4.6553,0.0005,0.0039
5376,80209,74833,3428,2139771780.4049,1527341038350990857.9344,74834,13.0823,0.0048,0.0008
32027,57092,25065,21057,2152646833.8525,1524979857194481671.9791,25066,8.2123,0.0028,0.0045
31169,107327,76158,13757,2151618051.5597,1538096959729697443.19,76159,9.7267,0.0008,0.0028
24914,94586,69672,10260,2142764170.3654,1545550144502200894.9698,69673,12.2715,0.0034,0.0015
29146,81632,52486,21284,2143031756.2749,1530078843000545247.6553,52487,9.9735,0.0041,0.0021
9266,25930,16664,2435,2157871426.5929,1547819071137699241.9832,16665,6.9884,0.0006,0.006
10372,27467,17095,5979,2122099173.1986,1540335655414839899.4217,17096,24.6767,0.0114,0.0004
11240,79971,68731,19659,2147305213.7274,1554461600090836531.245,68732,21.8985,0.0035,0.0034
31180,118433,87253,6739,2153035420.7064,1532465225047261801.529,87254,7.1984,0.0007,0.0033
3132,60892,57760,30358,2140259556.5115,1544061014259400574.3576,57761,13.8663,0.0038,0.0002
17971,79017,61046,2734,2144427271.0672,1531822548634529020.4051,61047,2.2068,0.0028,0.0012
29404,49150,19746,29126,2157860275.1187,1527579637099056397.1054,19747,5.2587,0.002,0.0058
22032,68244,46212,22096,2148736975.9593,1533843118984141118.5745,46213,7.0302,0.0015,0.0025
18490,86527,68037,10856,2137882464.309,1544233267702612249.7969,68038,12.6176,0.0053,0.0009
14784,24496,9712,14745,2146426332.8835,1524735085954811719.4428,9713,6.1576,0.0055,0.0046
10599,61977,51378,21948,2137970940.2563,1533869400225876439.3715,51379,11.2801,0.005,0.0011
19643,105810,86167,23005,2150764246.6251,1538057299456724525.7272,86168,9.754,0.0013,0.0035
31410,110237,78827,23830,2145431693.9809,1536325367043513122.5668,78828,6.3589,0.0021,0.002
10938,13676,2738,25661,2131220828.46,1536896055797000836.3587,2739,10.0923,0.015,0.0058
2873,51449,48576,28213,2153237594.5795,1534319999388735222.394,48577,10.1999,0.0009,0.0031
981,89172,88191,25743,2142147929.1081,1540412126158286921.2779,88192,11.1047,0.0034,0.0007
17748,96697,78949,27213,2152524960.2382,1535162126821661457.5655,78950,6.5878,0.0001,0.0027
7618,35375,27757,26037,2158404553.2694,1525543143217667740.6747,27758,17.673,0.0009,0.0065
7631,35955,28324,11094,2135585290.2155,1527072436205603203.8484,28325,8.1155,0.0054,0.0003
25074,114266,89192,6393,2155478751.9585,1535499671828757268.5979,89193,25.6718,0.0001,0.0034
10522,90493,79971,10618,2149614738.1029,1538886447639059858.8081,79972,7.6027,0.0014,0.0024
23953,116912,92959,13029,2151916449.268,1526474492721649058.2726,92960,25.9086,0.0019,0.0048
12806,75434,62628,380,2135080458.9011,1530295312129408652.4696,62629,16.3504,0.0054,0.0007
8114,9317,1203,31872,2100764946.7558,1548262255632052172.0483,1204,8.5276,0.0255,0.0039
4280,26355,22075,21661,2135347237.1391,1560905034772047086.6184,22076,22.1051,0.0088,0.0029
12891,110535,97644,9385,2141240177.5336,1525387141211143130.3484,97645,22.9839,0.0041,0.0015
1044,1370,326,26771,2230744592.7584,1560222341795035834.9355,327,5.0148,0.0064,0.0415
27003,114705,87702,16806,2144025037.555,1544058571554741331.4536,87703,19.6147,0.0042,0.002
18347,84541,66194,29672,2149945901.5689,1539643518324047572.4135,66195,7.1038,0.0014,0.0024
14507,19708,5201,6278,2156413365.1386,1525486639317969361.9541,5202,5.9579,0.004,0.0096
10983,100358,89375,18353,2154744610.1466,1537866875593452621.423,89376,6.4746,0.0001,0.0032
21986,76411,54425,14801,2145672090.8147,1539584041455942123.3536,54426,4.5385,0.0029,0.0018
2876,42096,39220,26802,2137037773.3216,1542452674908198512.1954,39221,9.2414,0.005,0.0006
12982,53370,40388,3880,2149858073.7789,1530807018281787769.4759,40389,7.1752,0.0018,0.0029
23392,40795,17403,20131,2166645717.7822,1535060501396107142.0485,17404,8.0692,0.0005,0.008
28909,114085,85176,2151,2149022573.6689,1541425467500892772.0973,85177,18.2235,0.0022,0.0034
31490,75753,44263,274,2137666026.5638,1532902473669474986.1951,44264,10.5691,0.0045,0.000
1650,81812,80162,31852,2158049932.504,1540404004248851348.0051,80163,10.1061,0.0005,0.0044
25817,28851,3034,1770,2106015144.7064,1485826605041151358.0756,3035,23.116,0.0375,0.0093
10301,14213,3912,6952,2160350236.4045,1531524115951169009.3853,3913,5.2837,0.0046,0.0121
9033,95804,86771,18328,2139105495.7922,1543236071502631194.4172,86772,14.0566,0.0037,0.0006
4606,21072,16466,4557,2136959276.5988,1548547013641800608.63,16467,5.0743,0.006,0.0021
22868,28972,6104,30851,2166261636.5862,1525448672642192152.5299,6105,4.2099,0.0023,0.0116
15606,77305,61699,31164,2158769657.3362,1535665867036536753.308,61700,7.9263,0.0002,0.005
825,30164,29339,20222,2162493845.4586,1532338515568412325.4123,29340,7.7263,0.0003,0.0076
23929,90856,66927,28639,2149372732.1656,1542444342752134583.5732,66928,18.6896,0.0016,0.0032
23817,116655,92838,15227,2152600939.4278,1543945681228923588.2965,92839,4.8483,0.0006,0.0029
21132,34204,13072,11916,2147518912.7377,1546175544866978283.9414,13073,9.5992,0.0042,0.0042
4718,95231,90513,20279,2140876623.7858,1537208413201777054.1541,90514,9.9463,0.0033,0.0007
30648,65032,34384,1525,2131336354.3777,1544558963376980732.2451,34385,21.706,0.009,0.0002
13594,94555,80961,30430,2160361456.602,1534918573482284856.66,80962,12.5105,0.0003,0.0058
1840,76606,74766,2015,2144892760.9598,1535650115073176810.5158,74767,6.2501,0.0019,0.0005
26929,50272,23343,14828,2141139967.208,1545343459922420503.9948,23344,3.497,0.0056,0.0024
21907,84579,62672,22465,2145626397.2225,1539401951326500336.8572,62673,1.3011,0.0019,0.0011
26895,107754,80859,31798,2153930766.4213,1539799198617112567.6059,80860,6.2094,0.0004,0.0035
25951,109970,84019,2462,2145267381.4981,1536961169366340735.1907,84020,5.2013,0.0019,0.0009
12512,62969,50457,26793,2145865656.6594,1536750162659134674.1543,50458,3.4229,0.002,0.0015
26355,27295,940,13071,2093227663.0755,1635407603156375624.0528,941,32.2047,0.0331,0.014
23424,115047,91623,28429,2156734853.7068,1547216019581378651.8767,91624,16.0697,0.0009,0.0041
7257,95634,88377,18049,2154453643.4842,1533055015084036312.4795,88378,12.4592,0.0006,0.004
32467,44426,11959,5916,2172571046.8244,1549204052130360313.7387,11960,12.9144,0.0023,0.0126
30882,104257,73375,29191,2140973943.8567,1544049360592324780.9304,73376,10.9533,0.0034,0.0004
27278,72460,45182,19648,2154015403.9325,1540180152961491974.347,45183,11.0119,0.0009,0.0042
5160,50355,45195,3213,2148226348.4804,1534220637964604915.8858,45196,6.4064,0.0016,0.0018
10440,56238,45798,12832,2153852072.3111,1535180016782943369.4404,45799,6.7233,0.0009,0.0037
1478,69220,67742,15301,2145036331.2908,1543839898184967933.1226,67743,6.3276,0.0022,0.0012
14768,30551,15783,10838,2143189957.8497,1530937225568797979.3674,15784,5.3091,0.0047,0.0033
17131,45251,28120,11536,2153628944.4401,1543161687043487668.6741,28121,8.5021,0.0022,0.0038
7807,64442,56635,27767,2143545877.4521,1540850443324953736.532,56636,12.9525,0.0032,0.0013
17643,107656,90013,24528,2145961073.2864,1531156063724771412.1319,90014,17.3964,0.003,0.0019
5836,92797,86961,25725,2144709081.6321,1540376860869981832.6435,86962,7.5656,0.0021,0.0008
30089,74569,44480,17015,2134695347.413,1545136781120629095.8682,44481,27.8614,0.0083,0.0007
20206,67373,47167,17932,2131036328.1893,1542722420254462292.1467,47168,16.6485,0.0068,0.0005
25471,124055,98584,23413,2132958581.5555,1535838178813080017.7071,98585,15.8414,0.0054,0.000
6148,65551,59403,22011,2147824894.2113,1553857285696480712.5887,59404,17.3272,0.0032,0.0031
32382,100174,67792,21547,2149180449.5433,1539413298523358832.8787,67793,3.7411,0.0013,0.0021
11731,19528,7797,10255,2179257158.1294,1513684309017426599.224,7798,13.9617,0.0011,0.0162
8540,41788,33248,25041,2143961236.8384,1530699683405683611.0318,33249,2.6965,0.0034,0.001
7637,21873,14236,25829,2128642399.3167,1544166379386864222.6758,14237,21.9237,0.0138,0.0026
15247,41373,26126,29052,2149393349.9975,1542337979615828609.2996,26127,9.0026,0.0032,0.0043
9557,15858,6301,11006,2159409389.6384,1531811715122677610.1033,6302,17.6423,0.0071,0.0112
22456,97306,74850,17543,2141364801.2777,1526543144304394750.5506,74851,9.5776,0.0037,0.0015
21799,58852,37053,18487,2158288509.9529,1540164507675125075.1517,37054,8.8542,0.0002,0.0051
14533,50378,35845,15872,2137566628.3243,1528112566846482399.2852,35846,5.992,0.0056,0.0005
13154,56312,43158,7944,2146785493.4814,1541104124432244033.3143,43159,8.614,0.0025,0.0026
31129,87803,56674,29231,2149861745.0102,1541954806980415551.5295,56675,7.7539,0.0016,0.0032
5383,66331,60948,11728,2148270235.5423,1531636688061235912.4406,60949,9.391,0.0018,0.0029
32761,58812,26051,30466,2161746763.6624,1552796599953624370.285,26052,38.7597,0.0021,0.0093
459,77508,77049,23049,2154894908.0133,1547764725421479903.8648,77050,6.5771,0.0007,0.0047
12182,24495,12313,31467,2176557895.4165,1525795557004693593.5096,12314,16.9995,0.0001,0.0124
13486,49271,35785,20231,2150828002.5858,1521601535955206101.2906,35786,13.2582,0.003,0.0038
7531,61230,53699,12071,2155996859.4762,1534043079234947943.3498,53700,11.8421,0.0002,0.0046
28584,96654,68070,11483,2134580714.323,1537294295094786184.4296,68071,14.0104,0.0048,0.000
12506,69391,56885,22702,2156894146.0225,1536445562070631241.9604,56886,9.7734,0.000,0.0038
10388,46130,35742,19500,2151634951.2749,1535686119625043050.2878,35743,15.9678,0.0019,0.0051
3300,82080,78780,9647,2158990312.8611,1533042564682736529.0844,78781,18.8546,0.0008,0.0069
23929,92569,68640,29680,2151706119.0887,1540234854635719606.1697,68641,5.0853,0.0006,0.0027
20930,91665,70735,15293,2134687521.5534,1537164132299612874.1847,70736,11.6455,0.0045,0.000
10020,27886,17866,28372,2160397656.5137,1542422230992257412.3495,17867,16.8652,0.0002,0.0082
29469,42361,12892,18775,2141328352.8183,1537572233938091753.26,12893,2.9057,0.0052,0.0026
14653,29583,14930,10179,2142979034.8222,1522159607504172736.5376,14931,3.8013,0.0057,0.0032
10922,39281,28359,18467,2138481576.5071,1549832937196151876.3394,28360,18.7816,0.0065,0.0017
12032,34354,22322,31124,2145566251.7249,1537406267377151432.0455,22323,2.1143,0.0026,0.002
4915,97348,92433,14853,2148522867.6059,1542955679780265481.6728,92434,11.3862,0.0014,0.0022
23646,60792,37146,28866,2125475007.2599,1536650325752197108.9355,37147,15.865,0.0074,0.0003
2218,36520,34302,8340,2146665221.9551,1534332984059817068.0676,34303,6.8612,0.0022,0.0024
3428,69317,65889,21323,2147943155.8871,1535629706636136692.484,65890,2.9742,0.0018,0.0013
32515,95460,62945,15527,2150174863.7588,1547280779789714358.7726,62946,8.4174,0.0016,0.0032
14616,15731,1115,32450,2204168188.5179,1439649958922486733.4217,1116,17.0045,0.0083,0.0342
16998,34113,17115,5016,2131410848.1871,1531923795400924406.2902,17116,8.7455,0.0081,0.0009
15680,23351,7671,3021,2172672387.1309,1536772951076798862.2973,7672,4.6799,0.0007,0.0098
4045,31212,27167,5662,2136705562.0324,1543695846184279362.4236,27168,14.6171,0.0058,0.0006
23078,79440,56362,6145,2145390544.972,1535789887200881196.1141,56363,10.2782,0.0022,0.0019
16086,79833,63747,11665,2144088201.6378,1540482053789518639.4041,63748,8.2043,0.0024,0.0012
15080,73568,58488,32047,2148956962.2531,1532784308119220636.347,58489,6.6675,0.0015,0.0029
19293,97588,78295,405,2140257593.8321,1539517190102419888.0645,78296,11.9915,0.0044,0.0002
31286,90431,59145,6481,2146746900.193,1548216215724815349.6684,59146,4.6052,0.0027,0.0021
20392,94618,74226,19966,2144381039.4418,1529336867438117746.5441,74227,14.8633,0.0031,0.0017
12915,93766,80851,28375,2162710370.6241,1539653069414865877.4751,80852,19.3904,0.0005,0.0061
8856,31999,23143,21388,2131369710.4976,1555409169034289234.7163,23144,24.6693,0.0097,0.0017
18503,36513,18010,22226,2133989711.0715,1530325299216107224.3514,18011,8.5325,0.0068,0.0007
18743,29013,10270,32354,2155174678.7727,1551355890670475650.651,10271,6.9348,0.0036,0.0066
1032,28457,27425,21158,2120097728.376,1529449156214100468.8299,27426,18.0475,0.0108,0.000
15189,28812,13623,26338,2160120735.4871,1539406605107496125.2164,13624,5.0114,0.0004,0.0069
20645,118334,97689,16009,2154756523.0566,1536265890504119166.8264,97690,22.0197,0.0007,0.0053
25378,88617,63239,4830,2154859217.3267,1542632093502605250.2475,63240,9.0254,0.0002,0.0036
26832,33141,6309,21118,2151853367.9729,1549876217757940937.1135,6310,13.4478,0.0072,0.0081
7092,51166,44074,30869,2145339269.0989,1531946241954338862.2558,44075,2.0332,0.0022,0.001
7056,10460,3404,17843,2130337332.9659,1560272271918578123.9795,3405,8.5884,0.0179,0.0068
9321,69472,60151,2254,2147475300.5988,1530202457524475916.6878,60152,3.7679,0.0019,0.0027
24580,24906,326,28235,2087421486.0917,1615362585848769421.3983,327,17.569,0.0636,0.0253
20944,113965,93021,23134,2140340309.2211,1530864106740529315.1308,93022,6.6245,0.0034,0.0008
30091,33105,3014,6895,2172248893.3231,1558817544177078758.4018,3015,12.0452,0.004,0.0156
27861,77246,49385,26504,2139304745.5384,1539240197622521762.8586,49386,14.878,0.0038,0.0004
20615,115992,95377,30212,2149573517.1611,1535137975460259705.4179,95378,5.2662,0.0007,0.0014
22686,120547,97861,7498,2157014673.4478,1541486340043481689.7453,97862,13.5345,0.0003,0.0042
6889,13603,6714,81,2106322574.4931,1534683896928605823.0154,6715,13.6729,0.0162,0.0001
732,97339,96607,25065,2149030996.6706,1532039496543882663.0884,96608,7.2644,0.0011,0.0023
14413,110910,96497,4747,2148646490.6641,1540697051636422909.2676,96498,2.5969,0.0015,0.0016
10837,66764,55927,1268,2141895418.0344,1536452412334142785.495,55928,8.9665,0.0028,0.0011
26840,93083,66243,24898,2137331588.7045,1542308342821125913.2504,66244,13.7056,0.005,0.0002
4135,18857,14722,5093,2138510760.6247,1529744633618426557.7831,14723,5.4266,0.0057,0.0016
19338,36414,17076,4564,2145241249.2413,1538338523968098375.9626,17077,8.131,0.0062,0.003
8201,25154,16953,22298,2137607050.9986,1531564760418860312.8121,16954,5.8382,0.0056,0.0016
7235,33605,26370,10769,2154036816.793,1544734072898970075.8555,26371,13.7704,0.0026,0.0053
285,53863,53578,24704,2158442215.3564,1539341524529778633.3803,53579,5.0532,0.0003,0.005
6143,96793,90650,6922,2144509342.4442,1531601217172917950.8151,90651,8.8525,0.0031,0.0013
225,32423,32198,22963,2153197467.2841,1539767940695241719.1425,32199,7.3042,0.0012,0.0045
15430,87938,72508,13634,2153996980.0483,1530690075484114533.3799,72509,8.0523,0.0014,0.0034
21387,103659,82272,27220,2150366397.8917,1534809195333709316.3568,82273,4.9141,0.0006,0.0021
2114,82760,80646,29651,2153392004.4953,1543132834936925249.5701,80647,13.8791,0.0009,0.0031
25493,119311,93818,3931,2160987732.708,1532774540838889135.1773,93819,16.3872,0.0002,0.0054
21404,103901,82497,20297,2135533556.6361,1533906501486449085.3776,82498,13.7453,0.0065,0.0002
28529,111994,83465,6983,2147670272.3663,1533131927473721552.7143,83466,7.5072,0.0022,0.0023
32400,116061,83661,31118,2157685554.1724,1532665182024578494.3734,83662,17.3708,0.0005,0.0046
9176,40441,31265,29120,2138899773.7662,1539963024086240999.0029,31266,8.354,0.0064,0.0011
15465,52701,37236,19146,2132514469.9842,1539136347905565912.871,37237,17.2931,0.0082,0.0002
21558,98814,77256,27069,2141709791.5283,1544153836580904982.2809,77257,10.3203,0.0037,0.0011
19943,26757,6814,18505,2155239989.0117,1560564111402830886.0735,6815,10.3831,0.0063,0.0128
19784,103220,83436,29997,2153975384.5122,1538797034842503751.2725,83437,5.9215,0.000,0.003
10378,59756,49378,13421,2141115877.864,1534225627014296466.0665,49379,23.3838,0.0042,0.0011
12174,69692,57518,12691,2151292300.0777,1532424735200791071.0439,57519,14.5585,0.0013,0.0034
27186,61268,34082,12544,2134958004.612,1555241142279965710.027,34083,22.6447,0.0067,0.0012
9455,96963,87508,6862,2141340810.1317,1535359280267798091.4846,87509,6.3172,0.0036,0.0002
8784,16735,7951,26373,2133861078.3692,1558502551832530215.0478,7952,16.3116,0.0091,0.006
9721,37701,27980,12075,2154202841.4162,1518255959414990252.6483,27981,14.9822,0.0032,0.0051
25571,83037,57466,8624,2150482067.043,1531848993536843004.589,57467,7.0323,0.0012,0.0024
31431,58174,26743,19496,2150466943.4898,1546750079295295346.6262,26744,4.4718,0.0022,0.004
31769,75724,43955,27680,2163421204.5722,1537421004476155089.7649,43956,17.7252,0.0004,0.0078
18945,45093,26148,16790,2148585634.7981,1530762255575433493.426,26149,3.0434,0.0025,0.003
6357,96537,90180,1107,2144215990.0562,1533329166744023354.2591,90181,12.040,0.0023,0.0008
14589,27988,13399,5840,2155796880.4158,1536695834669018814.1814,13400,5.995,0.0012,0.0062
21534,49261,27727,17904,2162423656.5825,1532066172684620258.6108,27728,13.545,0.0006,0.0084
27720,109514,81794,15732,2134011909.2754,1531263890391329054.4793,81795,13.3085,0.005,0.000
21857,52907,31050,4209,2156251538.6795,1541161904262256494.6313,31051,8.4773,0.0006,0.0063
2260,25257,22997,22973,2159925043.3478,1542043234220895337.014,22998,8.4975,0.0003,0.007
14672,39326,24654,4492,2149373380.7546,1541550915541538496.6486,24655,3.6205,0.0024,0.0043
21480,70300,48820,28531,2141754086.0065,1545120310837524001.2585,48821,15.576,0.0049,0.0018
6866,101579,94713,3830,2136465166.2902,1533592036143377123.5199,94714,11.7593,0.0055,0.000
3541,14097,10556,22856,2150255117.6843,1536811419213537936.6611,10557,7.6992,0.0041,0.0058
24504,64808,40304,30069,2151840996.3257,1537857193370723314.6586,40305,6.9669,0.0014,0.0028
6905,41688,34783,11663,2140073697.7999,1533047221542888882.2079,34784,8.3764,0.0052,0.0008
15922,115344,99422,27484,2149528411.3536,1539257152034607848.5086,99423,4.6974,0.0012,0.0018
9248,86840,77592,21542,2152770754.6754,1526869755886760078.954,77593,9.608,0.0014,0.0036
24949,90486,65537,31742,2154354720.7647,1542820613333898211.5617,65538,10.3609,0.0013,0.0035
1246,48508,47262,24272,2150733525.5064,1526528073003940857.9075,47263,10.6537,0.0021,0.0047
25709,47837,22128,31042,2156508939.6729,1529175862621127159.9755,22129,10.3728,0.001,0.0057
3166,37401,34235,16664,2135157361.4381,1528510926678214655.7141,34236,7.6078,0.0059,0.0001
22568,68491,45923,26092,2160987828.8184,1532832320989692591.6364,45924,19.7331,0.0003,0.0054
4360,21379,17019,19998,2154484494.2798,1535340502129531045.1103,17020,3.5688,0.0024,0.0052
21124,94595,73471,9781,2143157800.6777,1537978229782051795.748,73472,2.3059,0.0021,0.0003
1611,51414,49803,20107,2146256171.3182,1532637225784729963.0076,49804,5.4918,0.002,0.0015
26250,87467,61217,5033,2145980254.0613,1539068092100022075.6318,61218,6.765,0.002,0.002
2366,55822,53456,3545,2154558685.6651,1544463465797693880.5493,53457,6.7429,0.0005,0.0044
16470,49916,33446,9206,2138430284.441,1540424565446003709.347,33447,9.3991,0.005,0.0007
16619,63211,46592,18691,2129071209.6527,1534057950647894180.4384,46593,13.4885,0.0072,0.0003
14922,96971,82049,10729,2152785128.4521,1546838430475836400.9652,82050,16.8035,0.0016,0.0041
14557,24493,9936,1142,2167377579.9264,1553538107039205104.0945,9937,8.6334,0.0006,0.0104
32013,76605,44592,143,2153098948.6471,1533383790944321931.41,44593,5.1323,0.0012,0.0029
26389,49204,22815,27105,2146090408.9362,1542185489647927350.1088,22816,9.7026,0.0033,0.0044
24346,56873,32527,21922,2162978652.7061,1545838566389741986.3349,32528,11.7508,0.0012,0.0088
19862,33775,13913,26140,2139224227.964,1536608056587717751.285,13914,8.8411,0.0058,0.0015
24846,92965,68119,7762,2151984241.1911,1536541699444399629.2496,68120,6.8094,0.0005,0.003
22906,61641,38735,31487,2156105969.0374,1530921054706600570.6415,38736,7.5365,0.0009,0.0043
21721,35390,13669,11040,2164736420.9616,1537828768749917432.9026,13670,7.571,0.0001,0.0081
26748,72816,46068,18825,2150300788.0452,1536928669859231381.5705,46069,4.3391,0.0013,0.0032
25431,91214,65783,9469,2142747131.1347,1547524753719007087.67,65784,14.4488,0.0035,0.0019
12971,92295,79324,6923,2148707349.749,1537280550946500125.1071,79325,5.1608,0.0014,0.002
9170,109162,99992,19900,2141933769.7552,1532545530600362239.402,99993,5.6942,0.0027,0.0006
7501,82096,74595,22087,2144521387.4644,1538811218656623058.2091,74596,5.9332,0.0028,0.0007
1348,24815,23467,29759,2160634385.4455,1534882321754258546.1403,23468,16.9473,0.000,0.0063
30595,33144,2549,896,2179338052.9918,1502734693578143645.7564,2550,6.7009,0.0044,0.0199
31370,64152,32782,8961,2142303552.2989,1529576647218464182.993,32783,6.0948,0.0034,0.0019
26940,43040,16100,11241,2165846725.1564,1528581055508544631.8296,16101,9.3009,0.000,0.0094
3635,5258,1623,1761,2141387228.1897,1485367307683984838.8483,1624,11.6073,0.0163,0.0183
22189,25210,3021,11885,2120833511.185,1546256884914143487.5247,3022,6.6793,0.016,0.0034
9811,14779,4968,12901,2165920578.1876,1520920168257000993.6529,4969,7.1371,0.0045,0.0153
20527,80511,59984,31939,2129380130.733,1540686967124243257.8145,59985,20.1018,0.0089,0.000
4955,84155,79200,25281,2148299956.0387,1534572169969823388.1358,79201,1.6995,0.001,0.0013
17201,61707,44506,8494,2155531397.0352,1542857968972322052.4286,44507,4.8197,0.0003,0.0041
1925,87264,85339,21767,2151558176.0338,1529263954111342624.3045,85340,10.1116,0.0018,0.0029
31462,78530,47068,14715,2148267530.4281,1540881904431467243.0171,47069,7.611,0.0025,0.0025
428,17898,17470,7014,2144822288.0318,1535633916708304307.6452,17471,10.5267,0.0037,0.0046
29815,72287,42472,2891,2146539809.1772,1528359599916199582.7683,42473,11.5501,0.0025,0.0031
12665,87203,74538,23731,2153019698.9397,1536690011444337449.9916,74539,8.0931,0.0008,0.0032
2232,43314,41082,9385,2141038353.0411,1531543632516147940.5015,41083,7.3263,0.0044,0.0009
3187,32955,29768,6876,2157520609.4094,1526296074653740896.311,29769,9.8572,0.0007,0.0071
5680,102448,96768,29841,2143986516.2093,1542331660943582447.9016,96769,4.0243,0.0023,0.0006
14040,44052,30012,31667,2160241217.826,1535696693040744477.7429,30013,7.407,0.0008,0.0058
21025,102634,81609,4682,2154194114.1158,1537994120119577885.857,81610,5.4717,0.0006,0.0036
29312,91803,62491,23701,2150218506.9038,1541435902103219052.1856,62492,8.4543,0.0011,0.0027
32156,49029,16873,24043,2169288427.5135,1550656050661703670.6684,16874,9.1556,0.0009,0.0098
9704,18006,8302,25285,2123409031.2713,1550628292559917554.4526,8303,7.5152,0.0115,0.0002
7488,51944,44456,11555,2143694796.1023,1536955868922432814.5321,44457,14.7934,0.0036,0.0015
5912,43947,38035,31319,2159805319.581,1545412534460841848.4336,38036,6.1679,0.000,0.0054
15409,30131,14722,24021,2117859023.8664,1544452562042613938.78,14723,15.857,0.0137,0.000
10118,35758,25640,1792,2159547770.7765,1533358598257171719.7871,25641,28.8575,0.0013,0.0105
23499,23970,471,18359,2213662251.9068,1519770282555273084.7286,472,5.6322,0.0096,0.041
1662,81250,79588,4087,2143862642.8078,1538121377855040684.2751,79589,10.7868,0.0038,0.0013
31357,115148,83791,21851,2135028093.0749,1541550750431416939.3999,83792,20.4142,0.0051,0.0006
6498,86230,79732,3615,2151543359.4455,1537367655061246276.5498,79733,12.8627,0.001,0.0041
19729,47046,27317,19342,2138047446.1287,1522253327082074367.5586,27318,6.6564,0.0062,0.0011
9175,35349,26174,21297,2129016219.2542,1534459413638853653.771,26175,8.6071,0.0079,0.000
21255,41840,20585,10903,2149790122.8786,1557655923773719458.3883,20586,8.0563,0.0041,0.0054
20261,56973,36712,22806,2153185240.3425,1534575887130785231.7033,36713,4.8272,0.0007,0.0034
26893,49267,22374,12275,2139274310.4422,1523796652989871851.2112,22375,7.1032,0.0063,0.0025
15658,75888,60230,20316,2144159348.8771,1529322877346786940.4609,60231,8.214,0.0038,0.0016
20989,53060,32071,29875,2140790525.6053,1544501601234006319.4213,32072,6.2308,0.0053,0.0016
17572,51757,34185,4177,2135155541.2658,1537875586569027410.6719,34186,14.7739,0.0094,0.0012
4531,11995,7464,14048,2150776680.8347,1545311963115592903.1518,7465,9.6516,0.0056,0.0061
23749,89443,65694,14915,2146855102.6951,1536855320558883134.2285,65695,5.3209,0.0018,0.0017
13746,48155,34409,30919,2138588827.4434,1529172782689384964.0291,34410,9.1284,0.0059,0.0014
4604,6346,1742,4059,2158183836.1239,1533930751545647025.7792,1743,5.215,0.0105,0.015
13279,98548,85269,11559,2152928661.2622,1543428275271092065.3399,85270,5.0545,0.0002,0.0034
4360,68357,63997,19059,2156490386.5437,1530452559064577012.2534,63998,9.1093,0.001,0.0045
31237,63466,32229,8906,2143882165.7078,1532985777418254317.3588,32230,8.4867,0.0044,0.002
15479,114662,99183,20316,2144264427.219,1533670996813231848.2556,99184,6.2565,0.0023,0.0009
31868,101396,69528,28712,2141344200.8668,1545904470988076435.8498,69529,13.4239,0.0048,0.001
2281,80804,78523,17194,2144784666.151,1539498509895653496.7632,78524,12.790,0.0028,0.0013
21537,61420,39883,29372,2146180623.4115,1534045921993193612.1395,39884,14.1246,0.0044,0.0025
13252,36305,23053,18852,2146346627.5226,1528493387323506240.0746,23054,5.3225,0.0026,0.0024
27929,71623,43694,18052,2135160088.269,1540841319774290460.8285,43695,9.8278,0.0061,0.0001
22353,60839,38486,9365,2150009742.8808,1541501649418116238.2279,38487,14.034,0.0025,0.0029
25762,63870,38108,30679,2157897944.0215,1528187264305060053.4848,38109,9.6306,0.0004,0.0054
952,28352,27400,32556,2142812158.2859,1537748721487422913.4578,27401,6.1732,0.0046,0.0021
25602,84708,59106,27412,2149939226.3862,1532507380607098755.5412,59107,5.3785,0.0015,0.0024
11393,50106,38713,4409,2126023395.133,1552907210625686231.2103,38714,40.9117,0.0111,0.0008
4753,82993,78240,15121,2134717506.9309,1538730941504792382.7092,78241,22.2121,0.0062,0.0004
1566,76882,75316,18720,2156015254.2877,1532779242421702255.5773,75317,8.8034,0.0011,0.0042
29587,90982,61395,24315,2146987244.9766,1532868360387363480.9331,61396,4.579,0.0024,0.0017
21203,26135,4932,15454,2140285363.1289,1527631522385674471.9408,4933,5.164,0.0103,0.0039
31492,43586,12094,24809,2148795576.6047,1541097686121025449.8888,12095,6.3319,0.0031,0.0051
13176,90551,77375,16018,2151382344.916,1543071592861998055.8197,77376,7.0382,0.0012,0.0031
9982,100274,90292,14037,2153056600.034,1536962097610369745.0026,90293,4.7366,0.0002,0.0033
11754,106063,94309,578,2142865941.0513,1537868691836635496.3134,94310,9.3738,0.0024,0.0004
30867,108951,78084,17229,2142718865.5076,1538024912241982634.5279,78085,6.3349,0.0025,0.0007
4739,67799,63060,5450,2155956818.4714,1533693740065110884.883,63061,5.574,0.0002,0.0037
25612,97490,71878,7443,2153906898.5186,1538272538101004265.0432,71879,10.7209,0.0001,0.0032
808,18726,17918,22254,2172287661.9067,1543591272857341460.2754,17919,24.2462,0.0025,0.0124
31863,49523,17660,4911,2160661491.6044,1526424890688434236.0298,17661,3.8512,0.0007,0.0077
7321,91114,83793,20733,2139457637.2004,1535529656158842362.0768,83794,7.2761,0.0034,0.0002
19351,105775,86424,25079,2138265055.5453,1534749676210523788.8213,86425,11.2586,0.0042,0.0002
28740,128633,99893,11404,2155973409.2516,1528390204422598777.4367,99894,11.753,0.0008,0.0043
30601,105187,74586,8240,2151035710.8554,1535711697451417972.7864,74587,3.8539,0.0008,0.0023
24195,108555,84360,13749,2154301597.9147,1530142877079186052.7036,84361,6.6933,0.0008,0.0033
16250,36970,20720,102,2157728050.4351,1537702146780861366.2154,20721,7.0156,0.0005,0.0063
21676,111950,90274,11982,2141430470.3363,1536280001006580164.3383,90275,9.3224,0.0028,0.0002
2309,70183,67874,19427,2146817046.3344,1538001812458830822.2831,67875,11.7768,0.0035,0.0021
21169,59327,38158,12306,2136969537.6807,1533923595127849775.5498,38159,29.1183,0.0059,0.0019
10401,64556,54155,4418,2140348500.7951,1537560281546843989.954,54156,10.8437,0.0034,0.0002
11127,21206,10079,20082,2142045300.9667,1518238102410023829.3052,10080,11.0446,0.0068,0.0045
22865,105713,82848,9007,2141025325.731,1540328697408357184.2075,82849,6.8676,0.004,0.0002
12214,111432,99218,1379,2158397743.9309,1540739237647360839.7218,99219,11.5434,0.000,0.004
686,94283,93597,9869,2140731893.3738,1537115990029824681.173,93598,8.1037,0.003,0.000
4999,80803,75804,22149,2146618631.0638,1547038553153690132.218,75805,9.4981,0.0025,0.0017
26428,56427,29999,20178,2137841437.2429,1550309722378291736.6213,30000,11.0873,0.0067,0.0019
28116,61651,33535,6971,2153469850.5382,1547784874232202566.4088,33536,7.9316,0.0011,0.0048
29758,52237,22479,23510,2139311632.4053,1556433199989631693.7108,22480,16.2931,0.0079,0.0037
25224,74158,48934,11072,2134704643.0016,1534579376124286516.2647,48935,12.5974,0.0062,0.000
7503,42738,35235,32642,2156169455.2537,1533783723116527269.9813,35236,9.5143,0.0007,0.0038
23583,53039,29456,10330,2143298662.9058,1549911047636408228.9398,29457,16.0871,0.0058,0.0034
22953,72050,49097,13001,2159978873.2987,1534429709387923614.636,49098,9.0684,0.000,0.0049
24008,55963,31955,17056,2160560140.8839,1542423415186978096.8886,31956,14.7054,0.0006,0.0064
14378,15178,800,28996,2155338159.1411,1574600257280275625.869,801,13.4153,0.021,0.0213
25620,45104,19484,1956,2158004740.3179,1543906444596624792.0237,19485,3.5786,0.0013,0.0063
22442,94144,71702,11096,2153458940.2264,1534662379447843569.2803,71703,5.0876,0.0006,0.003
18548,68444,49896,21880,2139616740.1336,1543032934234270952.4339,49897,9.2517,0.006,0.0016
28839,92006,63167,7869,2156669433.7209,1530988323790391327.5649,63168,16.5619,0.001,0.0067
19851,87661,67810,5813,2158308752.5674,1538277641017307778.5982,67811,8.981,0.000,0.0043
6034,62758,56724,5403,2136561426.5838,1532229478195398607.0523,56725,19.3116,0.007,0.0014
18777,64403,45626,16009,2150275077.0907,1534288784169829614.7831,45627,16.5602,0.0015,0.0041
19569,67854,48285,13824,2167808317.9178,1542498908037341987.1207,48286,22.4685,0.0008,0.0094
2997,99520,96523,27625,2141901851.047,1535194647315490770.9468,96524,16.2804,0.0046,0.0008
14424,108233,93809,28167,2131154768.0515,1530129935170855878.444,93810,24.5728,0.0074,0.0001
16831,73152,56321,7278,2149921327.1828,1534512558750139817.9283,56322,4.9482,0.0012,0.0031
5995,41846,35851,15421,2156250543.159,1543341388147425318.8221,35852,5.4841,0.0007,0.0042
9095,32561,23466,17124,2141109729.1292,1530425643992743624.9629,23467,2.8314,0.0049,0.0019
25597,71818,46221,17825,2148038089.3061,1547749869438622070.6885,46222,8.7234,0.0028,0.003
27914,67176,39262,29882,2144538248.4212,1537132208795183427.9202,39263,9.3229,0.0052,0.0023
9937,88902,78965,13822,2139740077.8867,1536363855845208648.5919,78966,6.854,0.0037,0.0002
3748,30544,26796,24406,2153156054.0514,1544762832045389913.584,26797,12.3846,0.0022,0.0079
12535,75755,63220,25119,2148534814.2456,1546572744210583677.3577,63221,4.6334,0.0018,0.0025
4009,38686,34677,27019,2141868762.643,1545772884897298888.8565,34678,15.576,0.0044,0.0017
26338,58219,31881,8104,2137269775.8498,1521979185381091032.7126,31882,10.7486,0.0061,0.0009
5216,74407,69191,30101,2138721395.4984,1531845871046544894.3675,69192,7.011,0.0042,0.000
22849,75513,52664,31725,2147101521.6122,1540241204674079939.1944,52665,4.941,0.0023,0.0014
10529,89235,78706,22533,2145244937.7979,1539492734096695995.2995,78707,12.3655,0.0026,0.0018
25510,36058,10548,30861,2150254117.4146,1542375717413815301.1747,10549,10.3508,0.0046,0.0051
4169,50954,46785,21278,2154578776.7391,1530634698946591424.9859,46786,7.4158,0.001,0.0043
2909,20404,17495,23388,2143485904.0222,1537525041132118763.5804,17496,8.6416,0.004,0.0031
8221,47786,39565,10215,2149002602.0173,1534957110709694355.9986,39566,4.6879,0.0016,0.0029
27421,37719,10298,1385,2127535355.4272,1540187868939285039.5108,10299,9.1414,0.0119,0.0005
24950,121897,96947,14468,2147234411.7918,1537861739205257861.7211,96948,2.731,0.0021,0.002
5131,6691,1560,4832,2117206010.0903,1566972601966252689.9681,1561,8.6187,0.0237,0.0083
1625,56394,54769,4768,2157289472.842,1538006671144770038.6044,54770,9.469,0.0007,0.0042
31254,68616,37362,26317,2157802653.9361,1540488887763867458.0138,37363,12.1429,0.0011,0.0046
21572,58297,36725,27761,2132686268.7744,1541882836465618887.0794,36726,13.2136,0.0068,0.0004
15524,44530,29006,21473,2148711145.6532,1546884313980876272.8651,29007,6.663,0.0029,0.0032
7327,94191,86864,23980,2146277002.3632,1536484351669062454.5869,86865,3.7238,0.0014,0.0006
25964,114158,88194,19832,2148454191.6819,1544399885480167178.3185,88195,11.5233,0.0021,0.0022
22861,55003,32142,32307,2151918680.8095,1536652823983113499.9488,32143,7.0472,0.0011,0.0038
5686,102366,96680,30525,2142949152.2779,1533948711783549955.838,96681,9.462,0.003,0.0002
29822,51808,21986,17402,2132211460.1276,1520958468121763360.8592,21987,8.523,0.0081,0.0013
8328,38734,30406,25305,2153050781.5473,1544309768923917798.9804,30407,4.7136,0.0014,0.0041
20876,64638,43762,6306,2140574037.3566,1533989926613842742.2681,43763,11.4456,0.0041,0.001
29498,128945,99447,9098,2140054436.678,1542444711356607897.0474,99448,13.1198,0.0034,0.0001
26178,108557,82379,14336,2141591940.7213,1545831496132659643.8686,82380,7.496,0.0035,0.0009
20889,98669,77780,22308,2150409631.2175,1542463179883890916.6249,77781,6.7667,0.0012,0.0029
15137,33340,18203,9553,2151453948.0687,1550630470572357493.6528,18204,6.0147,0.0033,0.0059
8836,11853,3017,21527,2118623686.9261,1515866003131043271.2407,3018,7.1091,0.0184,0.002
22462,77566,55104,11837,2158571384.2828,1538145720537962177.2853,55105,13.3838,0.000,0.0053
24620,65088,40468,15291,2153354199.0227,1537755099509816569.5618,40469,4.4536,0.0003,0.0029
10792,55067,44275,22454,2147050170.4459,1536765253757070422.6922,44276,5.0615,0.0014,0.0014
18249,43161,24912,17954,2137325072.3441,1546909091746826761.1478,24913,13.9815,0.0075,0.0015
9030,15129,6099,2841,2126938130.7459,1553565333590493254.6335,6100,9.6776,0.0102,0.0011
28142,67042,38900,22480,2150830678.9778,1539730592911422287.7053,38901,5.5633,0.0017,0.0029
20658,47858,27200,30322,2153195985.4228,1549242766022037489.0621,27201,3.7909,0.002,0.0047
29386,47227,17841,32409,2146576715.5356,1563367707330927153.0881,17842,17.9308,0.0056,0.005
5282,50433,45151,17240,2152169637.354,1532836273099444525.5313,45152,7.1887,0.0008,0.003
32121,120004,87883,24235,2150116234.6203,1547340831832051675.97,87884,10.891,0.0018,0.0029
26963,47920,20957,6364,2129974964.1945,1547578874394448314.2471,20958,10.6021,0.0084,0.0006
17105,108716,91611,31750,2150613420.4643,1534969300231533945.082,91612,8.2915,0.0004,0.0022
7403,45194,37791,15716,2167943360.9107,1533870469949738387.0932,37792,14.7852,0.0003,0.0088
14316,56298,41982,5710,2143926229.1012,1546257525309226814.6178,41983,6.8404,0.0034,0.0026
10243,85703,75460,11475,2148997246.7176,1547785282964981184.0422,75461,13.8151,0.0023,0.0031
7072,19197,12125,20558,2135692552.8518,1546076426677448574.4619,12126,8.2005,0.0077,0.001
31474,89780,58306,27663,2154369472.3639,1529932329705024284.1876,58307,11.9153,0.002,0.0049
7301,75182,67881,15721,2146624266.4848,1530404948097492742.4216,67882,4.1364,0.0024,0.0019
25392,77738,52346,3782,2135636533.8547,1541518757719112004.2022,52347,10.1688,0.0061,0.0001
2245,77605,75360,6467,2145398936.4674,1543625024027643733.128,75361,11.6946,0.0035,0.0016
14303,42873,28570,13104,2168378624.6591,1549632640724710460.511,28571,11.5311,0.0001,0.008
27327,69313,41986,16234,2146512499.587,1524473051716519740.4428,41987,13.4108,0.0036,0.004
27349,74817,47468,31524,2140791392.6771,1534291193726146114.1317,47469,8.3674,0.0044,0.0013
8782,55166,46384,31631,2148591473.5016,1534420920514764889.111,46385,9.4936,0.0018,0.0027
16423,74668,58245,3172,2144271667.4914,1538156507009032586.1667,58246,5.9055,0.0024,0.0006
9766,81702,71936,12687,2152083204.1122,1538499928077784098.6869,71937,10.6393,0.0008,0.0027
21142,26731,5589,6982,2145940989.4635,1538910914928359651.9431,5590,7.7952,0.0077,0.0062
16681,100998,84317,2551,2144253146.1287,1536316181956558681.7108,84318,8.2168,0.0029,0.001
30821,69451,38630,378,2153034259.1985,1541484827919030068.4304,38631,8.2912,0.0016,0.0034
14372,76365,61993,1411,2145381850.3774,1531180584455147626.0649,61994,9.864,0.0035,0.0015
31590,97532,65942,14927,2141564960.5403,1545755080981744025.6137,65943,16.8446,0.0033,0.0009
25455,57853,32398,22750,2155997400.9728,1517709337093107189.415,32399,21.250,0.003,0.007
2520,25655,23135,8195,2161630923.8347,1524068075559760248.7687,23136,20.8342,0.0003,0.0076
20771,98137,77366,7960,2130456165.8297,1542733338377589367.2424,77367,19.0876,0.0063,0.0002
10933,26499,15566,11618,2156769101.2525,1542993541901957148.2525,15567,8.7384,0.0025,0.0078
12644,109841,97197,16616,2147731500.5134,1538695943310848921.2736,97198,7.8614,0.0021,0.003
1947,15802,13855,32139,2163484352.6732,1545639528897125091.5895,13856,6.8459,0.0034,0.0084
20653,114766,94113,22868,2147888587.7324,1541546876412888544.8045,94114,2.2334,0.0012,0.0015
26063,93155,67092,13195,2157485914.621,1531585125604905854.0588,67093,21.0194,0.0003,0.0049
9453,85932,76479,3602,2146711929.0883,1534028906449077796.6914,76480,5.0885,0.0029,0.002
25798,81149,55351,10628,2144818276.9939,1535571707838659842.1453,55352,5.0737,0.0021,0.0013
14972,62208,47236,31616,2141323607.0825,1534660399523585960.4939,47237,2.9852,0.003,0.0002
21044,22725,1681,1938,2159496804.6605,1552273505881345227.5667,1682,7.4276,0.0078,0.0132
20082,34582,14500,19710,2120387372.8399,1552148030035922483.1479,14501,14.5276,0.0116,0.0006
27326,83758,56432,13266,2139439455.5585,1538702892894230159.9641,56433,10.1159,0.005,0.000
26571,36562,9991,27946,2149456127.8955,1528425318126844557.6997,9992,8.5656,0.004,0.0055
7449,45885,38436,10342,2145653221.8706,1529533689712340932.867,38437,6.4732,0.0029,0.0018
30292,46575,16283,24364,2150909955.1423,1512163957925385969.8362,16284,16.1994,0.0039,0.0058
5059,37101,32042,8141,2161144159.1042,1538179899051815309.562,32043,12.8015,0.0004,0.0062
10279,87218,76939,23283,2137285331.1531,1532972398078609432.6359,76940,11.5178,0.005,0.000
11213,49508,38295,32042,2153527275.9675,1543908173079404517.5969,38296,4.4006,0.001,0.0041
29711,39556,9845,13335,2157479397.017,1537701183809343032.2621,9846,9.232,0.0022,0.0085
9098,56678,47580,5686,2150865472.9062,1520885972949256673.2362,47581,15.7775,0.0028,0.005
29109,80408,51299,31229,2141374793.6159,1535475897169881550.3094,51300,4.7449,0.0033,0.0008
11315,75515,64200,31590,2144524098.4361,1541390937707396320.4408,64201,7.6681,0.0024,0.0008
14086,43675,29589,6598,2151421323.7682,1525159231634803449.0693,29590,3.6094,0.0036,0.0045
18128,83394,65266,8056,2156891739.4647,1548363389106468220.7379,65267,12.541,0.0012,0.0053
7890,47819,39929,7497,2149720953.9175,1547401788125993858.868,39930,4.9219,0.0025,0.0037
29148,110618,81470,32064,2154214624.9454,1538537640672412589.5832,81471,10.0906,0.0007,0.0039
19105,42542,23437,21576,2146060688.0047,1547214032245885073.1563,23438,10.1219,0.0036,0.0034
7758,70596,62838,27993,2147935732.9967,1535020355913117529.9926,62839,7.4118,0.0019,0.0023
19120,54352,35232,6527,2141785455.0926,1510959513760101937.3965,35233,17.3729,0.0071,0.0044
9511,50107,40596,27821,2127291503.5068,1546342242894652029.2903,40597,19.2787,0.0074,0.0001
11847,85581,73734,1007,2145917905.6915,1532030704141622271.6564,73735,3.4936,0.0018,0.0013
4036,72746,68710,15660,2149086112.1766,1547432579647384483.1351,68711,13.0315,0.0027,0.0025
18116,107733,89617,5100,2149846467.3587,1537809985735749297.6447,89618,2.3456,0.0007,0.0023
17448,54599,37151,28838,2150340839.3553,1547428126580472986.9956,37152,14.8408,0.0024,0.0045
25742,47936,22194,24888,2153640615.1071,1524480342089671977.807,22195,7.250,0.0021,0.0045
28334,79247,50913,10676,2147524286.7628,1533242616003124243.4269,50914,8.756,0.0029,0.0028
16743,34475,17732,6702,2155199214.8705,1533660049190214986.6394,17733,12.8734,0.0021,0.0082
2956,12392,9436,14928,2165042740.3253,1530939078108300656.2271,9437,9.8269,0.0025,0.0088
6794,86535,79741,6337,2138899683.3026,1539480413297738903.1164,79742,9.0602,0.0051,0.0008
21590,60309,38719,7140,2139668712.4983,1527967487248739962.7674,38720,9.4854,0.0056,0.0014
18393,77017,58624,17396,2147743302.0863,1540974213015111031.0302,58625,8.6329,0.0022,0.0028
3830,90376,86546,21824,2147598193.9823,1535287988824782303.9731,86547,2.9779,0.0013,0.002
14524,60975,46451,5217,2146226369.5775,1550856381092245612.9561,46452,5.6329,0.0034,0.0026
11737,108867,97130,16947,2151350006.1062,1538624044797139778.9248,97131,5.8384,0.0005,0.0026
17730,76351,58621,13303,2151658713.3596,1535417636787303120.4434,58622,5.5894,0.0009,0.0037
18335,61892,43557,20356,2149468187.3478,1552042921600403804.9895,43558,12.0199,0.0026,0.0043
6641,82379,75738,18483,2137152110.6219,1527333547373383873.199,75739,14.475,0.0048,0.001
10878,101413,90535,3778,2147556879.8308,1541544131718112615.3958,90536,6.3411,0.002,0.0025
3536,34504,30968,8894,2162844155.7651,1525305030884641423.5992,30969,12.9707,0.0011,0.0083
15742,102813,87071,18986,2146347004.1189,1537818342200576940.6079,87072,3.0062,0.0014,0.0008
23429,119118,95689,12215,2144738145.1783,1544344902628295296.0843,95690,20.1063,0.003,0.0013
17914,22759,4845,17210,2196300559.7889,1569252850681469469.9965,4846,17.5181,0.0012,0.0213
22528,45084,22556,7991,2144836317.2476,1545054180285835137.8547,22557,4.5433,0.004,0.0021
8037,41195,33158,17799,2144527483.6784,1533485058527019059.4806,33159,0.9612,0.003,0.0021
22160,74682,52522,20449,2146499564.5767,1526709680720910349.6956,52523,7.6274,0.0027,0.0028
26562,31163,4601,14042,2118520026.8603,1587872853080382982.2093,4602,16.5588,0.0173,0.0049
28292,81618,53326,19075,2155049833.5925,1531174646016793796.5026,53327,7.656,0.0018,0.0054
10999,67813,56814,5311,2143284288.6705,1536994604891324928.838,56815,7.8407,0.0025,0.0011
25385,87758,62373,18041,2132269072.46,1548803397452836078.3893,62374,27.2644,0.0066,0.0004
21572,33571,11999,588,2121906535.2333,1551864058995211297.4109,12000,27.5294,0.0181,0.003
31804,119042,87238,6076,2138593221.7177,1546734340427512376.6337,87239,17.6307,0.0049,0.0017
22159,74505,52346,1608,2157269082.2893,1542265150267301153.1529,52347,7.1375,0.0003,0.0054
12681,76924,64243,28952,2149498289.5926,1529571289136591286.7339,64244,9.0367,0.0015,0.0026
4307,67499,63192,27428,2141207591.0973,1535322088519570540.4531,63193,11.3211,0.0036,0.0007
16353,64778,48425,962,2145912775.2249,1536056496139648677.2493,48426,7.7467,0.0034,0.0022
32056,125712,93656,1314,2157154870.3692,1537160905916513724.4276,93657,14.5632,0.0001,0.004
14573,29665,15092,1239,2119910863.9879,1509497618915319069.0095,15093,21.4955,0.0147,0.0022
1534,87919,86385,10363,2146862913.2706,1536903060948857475.56,86386,6.6763,0.0016,0.002
27399,99823,72424,16058,2155160701.5735,1534367273922851753.048,72425,5.4271,0.0002,0.0036
31533,58057,26524,29296,2158036757.127,1533548340621882646.1318,26525,2.8847,0.0011,0.0049
19143,69157,50014,6758,2153521580.1482,1540955255875346808.6493,50015,6.1091,0.001,0.0041
30608,100645,70037,13836,2155528782.8942,1531473060455991353.8161,70038,21.9535,0.0004,0.0052
7240,67619,60379,28542,2136212249.3952,1529720558526761524.9105,60380,11.4058,0.0057,0.0007
30397,110271,79874,12688,2139257445.6435,1532969825093290219.2959,79875,24.503,0.0045,0.0001
7346,84618,77272,3787,2149296107.6974,1529941405629855658.0489,77273,19.1737,0.0021,0.0035
22268,103571,81303,3189,2147173375.2121,1540745157863415891.8143,81304,4.2602,0.0017,0.0013
32613,58187,25574,5709,2141038189.9076,1540073842326840582.0656,25575,6.212,0.0044,0.0015
23109,80153,57044,3181,2155515289.3949,1540717933594592962.6875,57045,7.1254,0.0007,0.0041
31247,109473,78226,5459,2158229267.5472,1545290630015746152.3464,78227,9.7579,0.0002,0.0053
16172,54569,38397,2577,2136935877.4931,1537292196632724191.5114,38398,8.6833,0.0045,0.000
7579,10661,3082,27056,2148706325.8326,1564789888466184560.6473,3083,3.4381,0.0072,0.0075
20274,57104,36830,13233,2158101694.8887,1544517032534544605.1389,36831,7.3666,0.0005,0.0053
20408,64459,44051,27885,2133515645.285,1530752907542724827.0184,44052,25.6489,0.0066,0.0002
23228,36068,12840,11866,2153956089.1966,1511699743555959816.68,12841,15.3225,0.0063,0.0112
27421,111128,83707,1721,2153110938.3484,1533380612767702447.2149,83708,8.8764,0.0003,0.0036
30945,53288,22343,17331,2146049488.5956,1542195088542027283.3597,22344,4.0479,0.0032,0.0022
17354,104328,86974,17688,2142385946.3646,1530757210331162211.3099,86975,10.4213,0.0033,0.001
21862,109849,87987,23819,2151683449.3578,1531436787958520199.1,87988,4.6295,0.0007,0.0032
19258,106590,87332,70,2157875469.3768,1536990118352890821.6276,87333,12.9916,0.0002,0.004
5614,90601,84987,27900,2145234595.1126,1539139873977383062.8652,84988,5.1812,0.002,0.001
12772,85648,72876,12745,2136451444.1017,1534394604246586693.1218,72877,11.812,0.0045,0.000
15680,84083,68403,23366,2152938195.1887,1536739774108537051.8815,68404,4.5065,0.0001,0.0025
5568,36252,30684,4580,2143970964.576,1533942165507094589.1338,30685,7.968,0.0062,0.0017
25382,75602,50220,28738,2145540989.9965,1538612838816609159.4311,50221,6.5072,0.0021,0.0021
21955,64246,42291,13785,2152008415.5174,1535902531243258455.7155,42292,3.3713,0.0008,0.0036
29346,35430,6084,16433,2149491270.035,1551394291210471062.3296,6085,4.5778,0.0055,0.0055
6406,22688,16282,13261,2169114858.7472,1532874368768706574.15,16283,11.6452,0,0.0095
12677,54623,41946,18825,2150784106.6781,1527738698330131068.6193,41947,11.3306,0.0022,0.0042
28840,76737,47897,26896,2126957226.146,1545843995511636269.3313,47898,25.7037,0.0098,0.0001
21541,32226,10685,1556,2151745074.7734,1533529705237290342.5217,10686,8.8604,0.004,0.0061
11623,14174,2551,7594,2175881362.7665,1572977438068003080.9094,2552,3.1927,0.0034,0.0164
19431,46187,26756,26959,2155467348.3517,1539546592723084397.3927,26757,16.3822,0.0016,0.005
30417,83221,52804,25586,2158560731.0845,1544788356085480583.2429,52805,15.3102,0.0004,0.0057
27093,119176,92083,20617,2149931687.5865,1536566548940154571.8992,92084,2.2031,0.0007,0.0021
32102,114585,82483,27543,2147835658.4163,1535625198665335633.5549,82484,8.1784,0.0016,0.0015
15980,30806,14826,21224,2129135638.6834,1542754411117524945.6219,14827,5.415,0.0092,0.0011
22928,41949,19021,12640,2156116770.8031,1554475715488748560.367,19022,16.5678,0.0043,0.006
13808,102804,88996,29378,2136725162.627,1533262605851041744.1237,88997,12.6883,0.0046,0.0001
30817,99934,69117,21738,2150790967.0242,1540667139549735392.5404,69118,5.1329,0.0011,0.0025
29260,108816,79556,8750,2145939078.2926,1526719429160688642.1581,79557,9.5957,0.0025,0.0021
8116,21646,13530,7726,2126890591.6651,1559629463097980381.1555,13531,13.7751,0.0118,0.0009
467,80750,80283,26345,2141485434.4519,1532507332715497383.8606,80284,3.1719,0.0031,0.0006
30743,33999,3256,19361,2190539739.9797,1551938929929907542.4792,3257,12.8341,0.0029,0.0242
28014,115310,87296,11391,2144863239.8813,1531265971780262983.7403,87297,8.4288,0.0039,0.0018
26238,113247,87009,5237,2152929821.4015,1538803800854698219.7119,87010,2.3962,0.0001,0.0035
21181,27253,6072,10020,2174685227.8464,1531935247240417794.3681,6073,5.1164,0.0005,0.0126
1671,79698,78027,22570,2142062543.131,1539257571175957012.8085,78028,3.5918,0.0026,0.0002
30411,85526,55115,24031,2152187885.5379,1528191598557422432.8821,55116,8.7824,0.0014,0.0039
32282,114676,82394,8218,2153942106.3569,1538008561261288421.3855,82395,8.9729,0.0006,0.0039
16320,74338,58018,8841,2136849620.0536,1533578318981528382.2404,58019,9.4288,0.0058,0.001
2126,58599,56473,5893,2135977343.6386,1537568193579671687.2178,56474,8.6589,0.0054,0.0004
31520,72103,40583,18178,2166215841.8607,1546064714702648329.7718,40584,18.7744,0.000,0.0076
921,92846,91925,30806,2146693570.5936,1549054004013222453.5681,91926,22.5536,0.0033,0.0023
32651,44198,11547,7277,2135296528.2703,1528125647196566084.0999,11548,11.4186,0.0089,0.0012
1038,51765,50727,3547,2151135248.0252,1532213513871998734.1947,50728,8.5853,0.0011,0.0032
30733,64989,34256,24014,2152199185.3482,1534113940641706216.2907,34257,5.1391,0.0008,0.0029
14942,29256,14314,16411,2167015326.8154,1541279206460187853.272,14315,4.865,0.0004,0.0076
18793,26437,7644,26696,2159725480.0462,1528382323155015331.7074,7645,9.1644,0.0022,0.0088
28257,59499,31242,22201,2134496178.1404,1539315626570576561.8755,31243,7.7187,0.0058,0.000
25763,117419,91656,15242,2159595818.0266,1533662991728704766.2572,91657,15.3603,0.0004,0.0054
15870,67234,51364,18246,2144362182.3701,1538400255616852901.6642,51365,5.3412,0.0033,0.0012
26734,81791,55057,25533,2150605674.4639,1531090506789803900.9301,55058,8.6742,0.0016,0.003
27147,46303,19156,14968,2140173103.4856,1545364480370281771.3678,19157,38.3105,0.0067,0.0023
16433,28356,11923,32501,2139385240.3105,1536428429408394654.7129,11924,3.0554,0.0083,0.0018
17314,89116,71802,825,2149975300.8723,1534442138082620789.0408,71803,10.8055,0.0019,0.0026
19030,36873,17843,6917,2138372663.8134,1534369546429397024.5692,17844,13.8217,0.0076,0.0018
2125,33613,31488,15151,2152909436.3442,1540797590362012013.5426,31489,13.1726,0.0018,0.0037
20638,89049,68411,23057,2144891028.1589,1538163554416043666.3528,68412,2.707,0.0023,0.0009
21405,35244,13839,3340,2134896076.3023,1528258231288696531.7404,13840,17.4849,0.0122,0.0019
18674,51084,32410,17958,2135841640.7766,1539052658318301812.6775,32411,6.5568,0.0052,0.0003
4763,64371,59608,21238,2141907767.2224,1531373768282811696.9163,59609,9.0371,0.0046,0.0015
25256,38523,13267,10827,2143791950.8542,1528095259525323181.1691,13268,6.4386,0.0049,0.0039
16985,46331,29346,8048,2162921358.0454,1530431876363403664.6532,29347,7.6288,0.0007,0.0071
9143,79491,70348,28825,2142442407.759,1536207195334025982.6621,70349,4.8267,0.0022,0.0002
6102,19468,13366,2333,2121716472.1184,1541856843112682449.8467,13367,14.7977,0.0119,0.0007
2559,102016,99457,32297,2150918587.3629,1540695993533324563.8638,99458,7.7751,0.0007,0.0019
30236,110080,79844,25643,2150685325.1868,1530508656078714663.5864,79845,17.7651,0.0019,0.0033
32368,61433,29065,3684,2143370179.7645,1550156064762066967.0238,29066,4.8099,0.0044,0.0022
27988,121277,93289,21155,2138700178.8948,1542226871220183118.6252,93290,15.2802,0.0058,0.0013
29052,40596,11544,12661,2158897283.4592,1540922963412030389.9868,11545,1.466,0.0009,0.0074
15377,54813,39436,17437,2146378380.2084,1535128852171779025.2948,39437,4.5705,0.0031,0.0016
1199,20249,19050,9172,2128690937.891,1523549702360222243.2385,19051,11.2238,0.0074,0.0001
27727,62595,34868,28559,2157745878.5346,1543409710282123545.4562,34869,8.2692,0.0002,0.0052
15169,70875,55706,19829,2135387694.5476,1530450672521645093.8759,55707,15.5597,0.0055,0.0004
25075,34615,9540,28152,2156498349.6482,1519887780510661821.9455,9541,14.1613,0.0057,0.0114
29747,46346,16599,5532,2134782614.3925,1539624083108605256.1782,16600,7.1407,0.0053,0.0006
26829,92957,66128,3258,2158366317.6591,1539751213987409310.3749,66129,11.3363,0.0005,0.0048
13792,86574,72782,19862,2145804603.6926,1543626704923795555.597,72783,8.3151,0.0025,0.002
28909,107223,78314,7694,2163177387.536,1533161719960802184.1759,78315,17.2904,0.0003,0.0072
615,67570,66955,21686,2147395949.4981,1542168047478161465.3904,66956,22.984,0.0026,0.0013
10300,35140,24840,6656,2173028262.4547,1546800458603908014.4996,24841,15.7158,0.0002,0.0105
12180,96717,84537,28716,2141107319.1843,1536786540559923418.158,84538,5.7128,0.0032,0.0001
9711,92472,82761,17193,2151189154.5784,1537637911019870483.1861,82762,6.8189,0.0008,0.0025
23852,44770,20918,18784,2133864425.3871,1554472400162701322.5378,20919,11.5335,0.0098,0.001
26412,82206,55794,20449,2147891175.6057,1522998309580711645.7796,55795,7.3871,0.003,0.0035
30785,68871,38086,15116,2141078394.8711,1538644670029276019.4433,38087,8.6725,0.0038,0.0009
13639,54704,41065,5697,2151519458.5708,1536271094901309727.4207,41066,4.8204,0.0014,0.0029
13559,41265,27706,25002,2149738380.235,1533891733270180944.1594,27707,12.1953,0.0023,0.0044
15020,46177,31157,13626,2163756259.2088,1527595504848758354.4895,31158,13.0289,0.0001,0.0075
20717,37879,17162,19853,2111252391.8157,1526919758565826934.3517,17163,29.9613,0.0148,0.0004
3254,71044,67790,13592,2143783205.0344,1533582762248353688.172,67791,3.7069,0.0028,0.0008
5983,52660,46677,11404,2151977640.9552,1534213875173690070.3679,46678,4.3145,0.0005,0.0034
24240,57390,33150,14963,2149142394.6264,1521344874690745374.5447,33151,14.8432,0.0053,0.0058
31076,90201,59125,19761,2148414232.5193,1539905530778261878.6565,59126,17.5698,0.0031,0.0035
6703,17905,11202,23609,2176840988.2982,1534896369482731426.0434,11203,8.0408,0.001,0.0112
23586,56241,32655,4140,2145673194.2183,1535814842484545449.0481,32656,11.5714,0.0037,0.0029
4034,56436,52402,17550,2143270881.3768,1540207197836970856.9662,52403,5.6104,0.0032,0.0014
28738,112661,83923,8272,2142701736.6788,1540273424622455790.8425,83924,3.9021,0.0034,0.001
7274,16006,8732,18796,2127608494.496,1524389218883661137.2345,8733,7.3928,0.0136,0.0015
7331,80965,73634,13093,2145179946.0069,1534100577941183276.2951,73635,8.8246,0.0032,0.0013
27437,69919,42482,10531,2154125866.4698,1531152277630836813.0543,42483,10.4133,0.001,0.0045
24495,104104,79609,668,2142683455.6814,1533492823874219910.9388,79610,6.3511,0.0029,0.0006
9219,72256,63037,29623,2137589073.5023,1532386096485859104.9449,63038,5.8967,0.0049,0.0003
19233,46264,27031,6510,2160290065.5959,1544021824243295976.0638,27032,10.6998,0.000,0.007
20867,103914,83047,4832,2149427307.0682,1542358342053203987.859,83048,6.8283,0.0017,0.0029
21919,68608,46689,24670,2141854425.8543,1536443586635532970.7095,46690,4.670,0.0032,0.0008
1445,30510,29065,22438,2130571537.1642,1538320900100013402.6656,29066,12.7648,0.0081,0.0008
8572,86516,77944,508,2149656978.1678,1546003604300503611.0827,77945,17.4291,0.0018,0.0029
2703,91354,88651,20935,2142294726.8039,1527558942144908364.6697,88652,18.0746,0.0037,0.0014
6834,14047,7213,15246,2108358644.935,1553327726920352814.8634,7214,15.2795,0.016,0.0001
3303,84366,81063,20796,2131997164.7543,1541406629960342004.5431,81064,26.5982,0.0074,0.0003
1649,98873,97224,9659,2141650035.4422,1534307581413919687.4699,97225,5.2854,0.0031,0.0005
20946,97373,76427,23758,2152420279.7801,1543943671246795262.8596,76428,5.6005,0.0007,0.0036
6246,48922,42676,2235,2125141054.3147,1541160113842279991.8006,42677,25.1688,0.0095,0.0005
25121,73380,48259,11970,2140049346.729,1533369306042488770.8955,48260,3.5239,0.0034,0.0005
28405,35404,6999,16626,2128193295.0817,1527090443053168889.4853,7000,7.298,0.009,0.001
10137,79567,69430,1810,2149138460.6,1535864620105417947.6753,69431,1.9971,0.0012,0.0021
23031,33106,10075,1343,2123455107.789,1547046462446325794.5349,10076,6.1903,0.0107,0.0005
6203,46074,39871,3300,2143982335.5867,1543814968785040064.8396,39872,12.2296,0.0052,0.0025
171,40070,39899,9091,2144156485.2051,1530815798950780078.5412,39900,16.6217,0.0036,0.002
17482,25458,7976,1891,2113141830.7097,1519617481185650294.7458,7977,15.2175,0.0204,0.0023
6046,76650,70604,17855,2152425829.5183,1542775204568804919.1558,70605,7.9652,0.0016,0.0037
17047,40792,23745,5544,2171522413.9575,1538067249078938831.3027,23746,12.0053,0.0002,0.0088
29212,67946,38734,19988,2156098321.1155,1547393707054261524.4507,38735,11.8649,0.0009,0.0052
17215,111563,94348,12418,2143127987.9419,1540546886584657473.5169,94349,5.3957,0.0034,0.0012
18450,55095,36645,29266,2160213171.6519,1527615716420346858.9613,36646,17.1696,0.0011,0.0067
16022,80582,64560,6493,2147695408.802,1540283059003233078.4163,64561,10.6519,0.0023,0.0019
26620,46523,19903,8715,2135182144.3167,1526647333628409503.7888,19904,6.5257,0.0076,0.0012
9477,101726,92249,5904,2150017895.1933,1538956543291235140.3463,92250,10.4997,0.0011,0.0029
23930,84795,60865,5443,2143375055.6724,1534283592398673126.9335,60866,8.0877,0.0036,0.0012
12281,105023,92742,14200,2149143273.6517,1540579774105681471.4822,92743,1.2944,0.0009,0.0017
24939,62226,37287,29517,2135849367.0228,1526561378614093995.6319,37288,11.4023,0.0056,0.0019
26071,93659,67588,18323,2164054427.9423,1543679396898039226.9955,67589,17.1336,0.0001,0.0073
18378,76110,57732,25719,2161410480.696,1541700778018483604.5246,57733,18.3552,0.0001,0.0072
27106,29287,2181,4708,2102307278.0261,1570121566643273313.0951,2182,6.989,0.0233,0.009
8920,59454,50534,27624,2146692537.9035,1539030247731745507.5165,50535,5.6562,0.0025,0.0018
7400,27209,19809,29754,2131286934.7695,1531634794295970097.2826,19810,7.9227,0.0077,0.0008
23864,40707,16843,11021,2162486046.8033,1521238947970344463.4316,16844,10.7829,0.0023,0.0099
5097,57327,52230,31443,2147689015.0388,1543339803626184985.5932,52231,14.141,0.0029,0.0026
22233,30419,8186,24220,2135012138.9254,1538056301864511601.963,8187,5.5665,0.0082,0.0029
5679,74661,68982,12152,2151633338.459,1533808307498969609.1619,68983,17.5864,0.0014,0.0048
11353,97886,86533,18943,2151105258.8635,1533366741125880921.4893,86534,9.2938,0.001,0.0027
10862,105840,94978,14980,2151175150.136,1545062328441051218.1213,94979,9.6265,0.0014,0.0025
24469,31619,7150,23816,2151925123.4557,1546011044412380434.7322,7151,13.4256,0.0045,0.0083
30466,109745,79279,29673,2155434608.4045,1535150934729537202.8098,79280,10.8487,0.0007,0.0051
32252,125377,93125,31091,2154636896.2909,1538674246291899542.8962,93126,8.3978,0.0006,0.0041
14596,68043,53447,28048,2160644094.8348,1543250468925896674.5961,53448,12.6103,0.0002,0.0063
16383,21347,4964,10898,2153147566.1855,1549863604754206139.5416,4965,3.0878,0.0043,0.0066
11141,55255,44114,28246,2164147913.248,1525129239893520058.9289,44115,19.0794,0.0008,0.0068
10190,54748,44558,6336,2156822327.5316,1533202741485500724.7708,44559,21.2146,0.0014,0.0089
4592,18208,13616,20651,2127732360.4638,1513730306160586103.3814,13617,13.9938,0.0138,0.0028
17346,50792,33446,9268,2146283453.2839,1548313043036285805.7897,33447,10.8634,0.0039,0.003
7826,69726,61900,20095,2153483711.1573,1530276767095798936.0984,61901,8.0336,0.0009,0.0035
7602,55174,47572,21235,2138434928.3585,1529975055061022539.762,47573,6.1451,0.0044,0.0007
7662,26790,19128,6640,2156864291.8731,1528455202424404410.3905,19129,4.6296,0.0014,0.0064
8401,71520,63119,14745,2149523933.5228,1538500421284360844.7098,63120,2.2546,0.0009,0.0024
16858,111513,94655,3689,2146677178.6278,1543586210794683078.9713,94656,14.4279,0.0025,0.0014
21580,86667,65087,31976,2141855321.7458,1537784845136382284.3135,65088,8.2734,0.0044,0.0012
6832,23521,16689,28315,2135855133.5604,1556990008899330605.2532,16690,14.9362,0.0092,0.0027
18080,87373,69293,27337,2149094395.5268,1534183957356182576.8757,69294,2.3147,0.0016,0.0026
22120,83630,61510,29835,2142118373.4527,1531543880269756608.0412,61511,4.0443,0.0031,0.0006
5412,73014,67602,5932,2149604549.2865,1532403731222976153.9609,67603,9.6122,0.0014,0.0024
29912,44388,14476,20709,2128814447.4783,1546534763484951149.22,14477,9.9319,0.0081,0.000
2314,49150,46836,6135,2135904889.6321,1523374596082596718.7194,46837,14.3864,0.0075,0.0012
31978,36646,4668,7478,2139881233.9285,1559799692569651368.5804,4669,8.0828,0.011,0.0073
25919,60936,35017,20106,2146818831.7372,1536506252422081133.0303,35018,9.1246,0.0031,0.0027
29533,29926,393,12637,2011535862.5457,1436653350165632010.1718,394,10.3959,0.0832,0.0036
28964,80778,51814,18388,2147340496.7565,1538874989015395687.7139,51815,5.8291,0.0024,0.0023
25760,110947,85187,24978,2147437247.5233,1538383310879465331.7825,85188,4.1936,0.0012,0.0013
27351,34213,6862,5662,2149775255.2094,1529423191049480177.4434,6863,2.8316,0.0039,0.0046
13989,50032,36043,20312,2159763506.9507,1528581070207508455.1102,36044,12.6631,0.0008,0.0068
19461,113063,93602,8322,2144138358.4186,1536940127483663963.1578,93603,11.4393,0.0023,0.0006
23661,66003,42342,9286,2136727794.9779,1539929265576416810.6507,42343,11.7615,0.0062,0.0002
12276,96503,84227,23778,2152147872.8024,1538051380440554029.4431,84228,22.2992,0.0019,0.0026
12106,22529,10423,20193,2118283279.7287,1509301900127874567.9905,10424,20.080,0.0187,0.0032
22681,86051,63370,410,2143510387.4307,1551829577713456634.1027,63371,9.5671,0.0038,0.0024
26648,62723,36075,21788,2153012871.9883,1535838329818815652.2996,36076,2.8563,0.0015,0.004
21082,55071,33989,19908,2139929249.0501,1548060462360964192.9584,33990,8.7375,0.0055,0.0019
22991,61329,38338,28255,2158584456.8815,1534872740924044358.8935,38339,7.6091,0.0002,0.0052
23093,111572,88479,5417,2141479734.8866,1538425873298436001.9367,88480,4.1707,0.0034,0.0005
24446,49769,25323,3524,2152168861.2034,1539580976788726813.8385,25324,8.1941,0.0028,0.0066
23602,40011,16409,2125,2134385656.095,1532574987914226578.8108,16410,8.7362,0.0094,0.0013
10538,54623,44085,21614,2152105881.6977,1528011422865545895.7172,44086,12.8707,0.0015,0.0042
20667,89826,69159,29927,2148733509.8894,1540152117908356360.9889,69160,7.6334,0.0019,0.0028
7131,61631,54500,4948,2155397173.1219,1549067441537954929.375,54501,7.8151,0.001,0.0055
11682,12734,1052,13294,2122664545.0218,1549797709158834558.745,1053,11.1822,0.0199,0.0045
4708,43471,38763,14733,2140778433.1289,1527957771349220062.5721,38764,10.2109,0.0038,0.0019
9127,53739,44612,25430,2136820309.6571,1542592928158503678.9491,44613,16.3541,0.006,0.0002
22017,88837,66820,14105,2147128461.2739,1531575617047799889.6655,66821,7.4097,0.0031,0.0021
8692,23857,15165,15363,2137715251.5683,1561166894406541591.7761,15166,16.402,0.0101,0.0042
3514,39746,36232,20015,2146746147.8387,1532163100619675102.2338,36233,8.2842,0.0059,0.0027
16001,85016,69015,20690,2141218023.3231,1557286698298304049.2872,69016,21.3681,0.0054,0.0025
15150,61156,46006,229,2136564113.4029,1543001447570766312.8698,46007,9.7075,0.0057,0.0002
6211,53525,47314,3044,2146130866.82,1542625610324588794.7419,47315,8.4405,0.0022,0.0013
21028,109002,87974,612,2141488238.0952,1545881926332931974.0009,87975,10.513,0.0038,0.0005
7009,30399,23390,14054,2144657419.6247,1529947653398925492.3653,23391,13.6991,0.0054,0.0029
31185,89053,57868,23637,2146190510.3884,1541441297584627279.8627,57869,3.0366,0.0018,0.0013
11113,53068,41955,6227,2145967860.0514,1551162343511449960.9125,41956,16.5281,0.0034,0.003
4245,35923,31678,23550,2157186846.8619,1527099705979954137.5681,31679,8.447,0.0025,0.0065
22946,35662,12716,26746,2128285699.6531,1518134751512262648.0798,12717,10.3685,0.0099,0.0016
19307,69696,50389,11548,2151403770.7252,1541088104984018283.5779,50390,5.6584,0.0011,0.0031
12431,101540,89109,15469,2161452048.5598,1531550302068007580.581,89110,21.5418,0.0002,0.0054
20021,117810,97789,9467,2138263733.7598,1534572000024127301.9822,97790,6.9488,0.0047,0.0002
3720,97335,93615,8875,2152553658.4995,1538851304626916105.7538,93616,9.6722,0.0006,0.0026
12131,93211,81080,20243,2145434057.9331,1536903784468260482.7917,81081,5.4895,0.0015,0.0005
14684,94159,79475,2857,2145703839.1705,1529621035774889603.0625,79476,5.8825,0.0025,0.0017
31751,45929,14178,20964,2153325601.2688,1546767521041688182.2075,14179,7.5591,0.0037,0.0081
30631,111662,81031,10981,2143544881.8718,1540237612577334555.0463,81032,11.8379,0.0034,0.0016
22149,113901,91752,32066,2145931793.8775,1532841790362343813.3514,91753,2.459,0.0022,0.001
15534,30801,15267,27559,2162583832.8712,1538993003271994080.6259,15268,9.015,0.0007,0.0099
20837,87085,66248,26079,2142331492.5086,1534874880682914343.4942,66249,5.5601,0.0028,0.0009
17536,64658,47122,1497,2164761597.3433,1531413239058924980.5994,47123,16.4232,0.0001,0.0064
5855,58837,52982,18365,2144078537.0721,1535313827822640026.5799,52983,2.6022,0.0034,0.0015
7191,84612,77421,422,2147597427.0417,1535851173038487753.2897,77422,3.4206,0.0014,0.0012
22419,75487,53068,15519,2132895872.1895,1544761569345581732.5392,53069,19.5798,0.006,0.0001
15224,51135,35911,2842,2146769500.9533,1531707355026471515.7872,35912,7.2435,0.0028,0.0023
32088,80782,48694,21561,2146708840.8175,1537363077918720435.7335,48695,2.1858,0.0019,0.0019
4244,25184,20940,5732,2154441539.0156,1539542425120206449.8029,20941,7.4346,0.0022,0.0056
19211,65725,46514,3737,2157644711.3731,1531242341561623194.1416,46515,15.5934,0.0003,0.0048
1202,52099,50897,7128,2150759870.7685,1546714919465138649.7514,50898,9.9924,0.0021,0.004
10291,103552,93261,28154,2141052325.0364,1526964759805624168.9411,93262,17.9146,0.0037,0.0012
25209,107855,82646,14874,2140449302.3676,1530071444448587305.8277,82647,8.9909,0.0046,0.0005
19195,95207,76012,30474,2153691200.0168,1534064382710213610.9811,76013,13.925,0.0009,0.0037
27528,34612,7084,31998,2145519921.8857,1566139174100913680.7138,7085,14.651,0.0085,0.0101
13515,81114,67599,20521,2144529539.2794,1543674253858719321.6281,67600,13.2727,0.0037,0.0018
30449,75813,45364,27909,2150110724.3539,1541393619613789020.8496,45365,3.0562,0.0013,0.003
2376,6803,4427,32739,2118259419.3067,1500391074113783684.7835,4428,9.8189,0.0166,0.0058
17830,55278,37448,15419,2153193783.7922,1537200485789835621.9397,37449,2.6648,0.0003,0.0035
6317,68457,62140,10907,2147146322.2406,1535444029617884866.9106,62141,13.5064,0.0021,0.0038
27481,116539,89058,31670,2144057016.4017,1532332966622683455.3947,89059,3.331,0.0034,0.0012
1659,36078,34419,13665,2140276066.5949,1543812551428312104.659,34420,6.7816,0.0041,0.0017
17796,32254,14458,11179,2175380251.3583,1537102090560530746.4364,14459,11.8336,0.0007,0.0113
6493,34097,27604,27259,2137739412.5049,1526586151929838436.3414,27605,13.0064,0.0069,0.0007
30362,78469,48107,16452,2158601226.457,1533066799069574817.3045,48108,9.6274,0.0001,0.0058
22205,90790,68585,27966,2142721167.7933,1541045716018258403.9892,68586,5.077,0.0026,0.0006
19446,52001,32555,18446,2146721162.2217,1558767111587797649.7628,32556,11.4978,0.0044,0.0048
15904,57707,41803,29112,2139194078.0781,1535097115612773946.5706,41804,13.0192,0.0051,0.001
7234,23905,16671,3254,2146125848.0528,1568578582029394891.4761,16672,14.5951,0.0068,0.0073
13938,64477,50539,16238,2149821934.8972,1528668010960297831.8864,50540,4.9921,0.0027,0.003
29622,72273,42651,4,2133117874.773,1540335975748803564.1508,42652,14.1135,0.0063,0.0002
20541,45044,24503,3452,2137362030.2822,1531168296135539722.5307,24504,7.2522,0.0052,0.0013
629,63611,62982,10296,2148627271.1483,1535902379221879940.6859,62983,5.652,0.0017,0.0018
13502,77207,63705,22473,2144872495.9501,1537799175018597515.3679,63706,8.4398,0.0023,0.0015
2856,41506,38650,9712,2151872086.2682,1541446324969645318.3434,38651,5.5104,0.0012,0.0039
22179,119128,96949,15735,2149189313.1162,1537920216601517918.8766,96950,17.736,0.002,0.0018
10444,73149,62705,8449,2139233218.0517,1548287259752724975.4943,62706,14.424,0.0054,0.0016
9273,43429,34156,19689,2136965632.2884,1560560327544942910.6767,34157,23.470,0.0078,0.0029
7991,31643,23652,30823,2127200513.4597,1539389880583901578.2704,23653,11.2467,0.0089,0.0007
3030,53308,50278,16945,2140742938.4973,1539410053667650087.7491,50279,7.2379,0.0047,0.0004
31487,68495,37008,16703,2151638182.1734,1534870964657389163.6863,37009,6.6771,0.0014,0.0037
17597,87619,70022,29063,2144440412.9031,1539751470669028208.1279,70023,5.1411,0.0025,0.0008
5484,81601,76117,3918,2143860131.0409,1534025224321490149.101,76118,5.7039,0.0024,0.0006
29969,111960,81991,28634,2150377015.25,1535070846254226335.9719,81992,1.2496,0.0013,0.0023
28356,53505,25149,15960,2145386311.0241,1527840383876724800.4412,25150,9.3428,0.0048,0.0036
15447,112015,96568,7987,2151856632.8852,1540549239703128514.2425,96569,5.648,0.0007,0.0022
8319,40026,31707,17767,2154253462.8213,1523391198145790903.8618,31708,10.9924,0.0028,0.0058
14276,16970,2694,27849,2211083049.4716,1514843917715666259.5991,2695,15.4892,0.0033,0.029
12572,54739,42167,18918,2140938468.9578,1525193222468348238.5794,42168,8.3192,0.0048,0.0017
21072,31851,10779,17305,2115504899.802,1550905721452407817.5755,10780,15.2713,0.0127,0.0002
14450,58817,44367,5337,2126011339.3103,1538169286553606943.7055,44368,19.4824,0.0082,0.000
31853,90721,58868,5609,2142631174.3392,1546420453722155624.9698,58869,8.8543,0.0035,0.0013
16771,48076,31305,11529,2155433197.3123,1537390592594611854.1338,31306,13.207,0.0023,0.007
32058,130399,98341,4896,2141921985.7046,1535425327276960143.1247,98342,11.2211,0.0033,0.0004
24326,34033,9707,9561,2110928081.8313,1513847090504717134.6182,9708,25.2554,0.0178,0.0025
18847,40229,21382,9085,2148493513.7926,1524540041074067315.8136,21383,9.205,0.0038,0.0052
10819,43316,32497,21005,2146278768.6691,1531511988672757720.8612,32498,2.7713,0.003,0.0018
30348,50647,20299,1504,2127655146.0466,1518086523437888839.6553,20300,15.1553,0.0093,0.0014
29162,42539,13377,5709,2130080717.1825,1539111542635954326.2535,13378,14.8209,0.0088,0.0003
17369,78104,60735,9220,2148616021.6307,1531781152526859244.3594,60736,9.3996,0.0016,0.0023
16596,77377,60781,18896,2144503389.8082,1533398219616371799.2463,60782,7.3917,0.0029,0.0017
5333,86696,81363,25299,2141583682.3087,1536434496816625048.0269,81364,8.3621,0.0038,0.0007
12215,15734,3519,27306,2131558170.3,1543965575348802049.1009,3520,3.0507,0.0101,0.0041
31626,83022,51396,32008,2152480066.2164,1539412652365515929.2242,51397,4.5981,0.0007,0.003
27732,32004,4272,10242,2149857874.7751,1508309624593237612.9897,4273,8.2546,0.011,0.0124
23082,28293,5211,20916,2114849935.4785,1527541890186858818.8635,5212,11.063,0.0143,0.0024
11975,65296,53321,11868,2158241502.3408,1536125608726017269.3338,53322,8.4769,0.0002,0.0052
20354,82234,61880,7978,2132709972.6907,1542915191930204865.0386,61881,14.2811,0.0062,0.0002
22523,92897,70374,20005,2149116128.979,1548920885712256923.2166,70375,11.5608,0.0022,0.0034
10848,70237,59389,24694,2151200344.651,1536015959124733128.1428,59390,18.7829,0.0017,0.0036
9517,45358,35841,27308,2142268042.0381,1523149602111914993.8227,35842,6.1036,0.0056,0.0021
31336,119545,88209,6075,2142087660.3045,1537641072468195683.4036,88210,4.8818,0.0034,0.0008
7062,12964,5902,22366,2190480362.1411,1528599920628055853.1841,5903,15.2917,0.001,0.0223
13530,108687,95157,2214,2158816690.0141,1532981896208600354.2754,95158,19.3112,0.0002,0.0043
6217,51440,45223,4838,2137901895.8733,1528871161834060247.0751,45224,12.0886,0.0055,0.0005
2509,70547,68038,20356,2145390605.559,1550064074503289711.6083,68039,10.5986,0.0032,0.0027
5159,75450,70291,17652,2137851123.402,1532455985546158624.6242,70292,14.1785,0.0048,0.0001
14563,77020,62457,1141,2153559299.8433,1532656328906036542.5288,62458,5.4548,0.0004,0.0032
25520,63561,38041,4104,2137000213.9644,1547281445885011117.1669,38042,13.0876,0.0058,0.0012
21516,87809,66293,3247,2136239719.8522,1545313063635953340.6092,66294,13.6937,0.0056,0.0004
24260,112844,88584,23502,2146008596.6076,1536253609619925166.1334,88585,4.8475,0.0016,0.001
22009,99911,77902,11056,2157971999.866,1539358146078510895.2163,77903,8.3602,0.000,0.0054
12115,87510,75395,15932,2144021729.2165,1534460822968226147.3793,75396,21.4099,0.0031,0.0019
11270,23392,12122,30653,2149300327.8954,1541507269787872287.5992,12123,0.9093,0.003,0.0049
25400,119653,94253,4716,2143720889.6476,1533412894501909282.7089,94254,3.790,0.0023,0.0005
14253,50015,35762,7015,2166622107.9676,1534238149361410061.8723,35763,12.1316,0.0001,0.0073
20625,93394,72769,13415,2146332716.0205,1542861130504929766.5148,72770,21.7449,0.0033,0.0031
7492,91267,83775,3278,2140387904.16,1536267863404737984.1352,83776,8.0497,0.0039,0.0003
20394,49183,28789,31329,2137784078.499,1537469424718851549.2542,28790,7.4793,0.0054,0.0013
9345,107251,97906,22091,2134748018.9382,1541370269645950947.5986,97907,22.5578,0.0057,0.0001
10692,36219,25527,23139,2156878576.8582,1547336117464903754.2787,25528,9.9804,0.0017,0.0065
27606,73053,45447,2255,2135920275.28,1533814288351930996.184,45448,9.8806,0.005,0.0004
30592,52165,21573,20761,2143609443.0849,1539773112768740660.3584,21574,4.8918,0.0034,0.0015
1649,44141,42492,9820,2158936503.9288,1535643015155336282.8989,42493,6.2759,0.0001,0.0057
3716,42791,39075,16042,2122262396.0163,1542621028145245133.22,39076,22.7629,0.009,0.0001
25043,104123,79080,3711,2156667346.1091,1544269293476699317.3049,79081,6.8686,0.0002,0.0042
1771,89200,87429,28255,2148592020.4186,1541503157317676755.6154,87430,4.1837,0.0016,0.0021
16876,66280,49404,13967,2152352584.6966,1534499535318945809.3213,49405,4.2221,0.0011,0.0031
11856,59932,48076,16745,2161277657.187,1528617671912940755.8834,48077,10.7472,0.0002,0.0072
12350,37497,25147,1843,2151190414.0363,1529936737737732184.7163,25148,6.3053,0.0026,0.0033
28378,119634,91256,20354,2136649139.6399,1537755617880736252.761,91257,10.3556,0.0041,0.0003
4170,55545,51375,2887,2135964623.2428,1534460313225309602.0798,51376,9.4059,0.0052,0.0007
11805,22955,11150,15051,2114993145.5738,1570342737443262405.3273,11151,43.3472,0.0181,0.0015
3100,55902,52802,10112,2154837291.2709,1551134406284707309.7018,52803,20.8548,0.0019,0.0048
4153,62168,58015,14993,2154685914.4123,1535994724721319339.8678,58016,10.8563,0.0006,0.0042
9017,66859,57842,5132,2153239574.8712,1533772560168600768.5041,57843,5.2965,0.0006,0.0031
29810,48940,19130,1342,2155762850.1888,1540193451414364271.702,19131,6.2037,0.0013,0.0047
18686,114923,96237,23748,2143052879.7851,1541728862013528604.8073,96238,3.4559,0.0024,0.0007
4438,5371,933,31762,2066311231.3887,1553510136773668862.5031,934,16.4361,0.0488,0.0044
23284,59619,36335,27000,2148610254.8289,1541283368367640649.5126,36336,9.6517,0.0017,0.0033
1621,62783,61162,23053,2134093163.2925,1535046194529337580.5872,61163,26.6506,0.0067,0.0007
17470,41038,23568,27214,2169832694.4102,1517683900254461841.6962,23569,26.3259,0.0015,0.0093
21108,54051,32943,26666,2134776935.4145,1538991384617542483.1684,32944,11.7519,0.0078,0.001
27146,89843,62697,26023,2144626635.5195,1538544343048281413.1963,62698,3.1554,0.0019,0.0006
28005,81788,53783,21864,2161812492.1869,1527861611270748202.0301,53784,21.3784,0.001,0.0068
29982,58828,28846,9405,2154185323.8943,1546583701421918866.9896,28847,7.525,0.0026,0.0046
13148,36803,23655,5854,2145955957.1165,1535310061995114556.5317,23656,9.1119,0.0033,0.003
32231,37209,4978,27269,2136217782.4714,1523889699218991396.9469,4979,13.9976,0.0088,0.0041
28042,125680,97638,16392,2146221416.2461,1541310030164499311.2032,97639,1.9611,0.0018,0.0009
8719,88912,80193,13792,2138004738.8205,1540833211814490415.2895,80194,11.3318,0.0049,0.0003
17110,93267,76157,7166,2145928315.529,1541137561276835778.4236,76158,4.1569,0.0018,0.0016
2572,66371,63799,25740,2146843895.5717,1548599015190698100.0314,63800,13.9274,0.0031,0.0031
125,35446,35321,14560,2139519211.8937,1540767930978039516.7193,35322,10.7593,0.0041,0.0013
10496,49936,39440,26069,2159333412.801,1531638172855429687.4537,39441,14.2132,0.0006,0.0056
21867,84649,62782,5643,2155335711.4998,1541937184459455974.0908,62783,21.1991,0.0015,0.0049
25572,96832,71260,11515,2145161946.5629,1541550224957303122.1403,71261,6.616,0.0031,0.0017
21402,53691,32289,25498,2141695585.5858,1541148340841076557.7533,32290,7.8539,0.0052,0.0017
28632,29782,1150,6456,2098187916.119,1492104439014178879.0258,1151,9.2683,0.0311,0.0043
22482,118235,95753,26192,2152354610.1172,1538661026459740916.5718,95754,8.5023,0.000,0.0027
11701,68181,56480,2060,2155517813.2624,1532075013100442096.6213,56481,12.9513,0.0006,0.005
9946,21424,11478,447,2143343837.6758,1544909114595244737.7048,11479,4.4015,0.0052,0.0034
16991,101267,84276,6153,2138918717.5518,1528541650608738918.4606,84277,9.8326,0.0046,0.0006
17786,97285,79499,3266,2144402708.8885,1538410002047032431.0712,79500,3.3022,0.0019,0.0006
14667,39479,24812,10626,2134757731.0888,1530341878852646749.9426,24813,16.0504,0.0092,0.0008
27621,50731,23110,18425,2148340748.0564,1535193879025278666.9427,23111,9.5459,0.0048,0.0027
29277,125789,96512,1278,2146937776.9532,1531901009631986134.0685,96513,19.486,0.0025,0.0022
31377,127903,96526,26719,2137860324.7008,1534451087256705337.0545,96527,10.5094,0.0053,0.0002
2939,74119,71180,3607,2148226241.5321,1541480351199886705.8159,71181,10.6557,0.0019,0.0022
21274,96884,75610,10675,2156008461.9822,1541379577937904414.0704,75611,11.0323,0.0003,0.0043
23670,29158,5488,2044,2109465086.8559,1550080765333087819.9991,5489,16.6579,0.0197,0.0001
1020,38840,37820,16132,2132239501.0596,1543312188064609353.1211,37821,22.2927,0.0056,0.000
32185,71316,39131,6845,2137297802.0317,1548000572808771494.4794,39132,15.2089,0.0057,0.0015
9903,64524,54621,25311,2148815005.584,1529659413651144370.7129,54622,5.4583,0.002,0.0025
20237,64057,43820,2314,2155385502.427,1542345142267829874.9434,43821,14.6797,0.0015,0.0049
9733,37650,27917,23401,2157370503.1375,1532732682238726970.6754,27918,7.7574,0.0013,0.0064
28904,127059,98155,18666,2143625985.089,1531537306929435567.1232,98156,9.9931,0.0036,0.0016
13220,73060,59840,11029,2134981638.0613,1539708437062625932.4011,59841,14.3486,0.0052,0.0002
16898,23231,6333,23384,2159986832.0961,1534947483898810465.8927,6334,6.0869,0.0033,0.0082
14691,112321,97630,13003,2142603593.1419,1533442460983309222.24,97631,7.1589,0.0029,0.0004
2078,50156,48078,9346,2129643254.443,1536319577985903551.6698,48079,21.9806,0.007,0.0002
9127,48764,39637,17785,2135921038.1298,1530428873831018361.8297,39638,8.8814,0.0059,0.0003
26002,41417,15415,11371,2149040485.2073,1540812638693879826.1654,15416,3.4058,0.0018,0.0039
26939,82350,55411,24347,2157723422.9505,1539450904682396515.8581,55412,9.2495,0.0002,0.0049
12183,83600,71417,9991,2152564017.7184,1540424862126910418.203,71418,9.929,0.0007,0.0035
29125,87350,58225,5378,2154792530.583,1533643841509962908.3154,58226,4.9117,0.0002,0.0034
4473,52592,48119,18910,2146409028.3203,1548838178358998881.0704,48120,19.3851,0.003,0.0032
13970,15498,1528,22212,2160772575.7619,1599654580393453518.7478,1529,10.2157,0.0143,0.0202
3810,12432,8622,14229,2165952116.2929,1529370250466069645.4802,8623,9.6966,0.0022,0.0104
29836,89843,60007,26478,2148371618.9065,1520244025859067075.6364,60008,18.4423,0.0029,0.0048
15865,103323,87458,28431,2143389474.1553,1534198491059860624.6104,87459,3.6755,0.0026,0.0007
29678,94488,64810,25169,2156341210.1617,1538849109249140206.8718,64811,7.5391,0.000,0.0043
26494,46487,19993,16480,2147120745.8863,1552119709020151979.8363,19994,10.1558,0.0044,0.0042
8167,50981,42814,8963,2140179977.5847,1536501783405312505.4202,42815,9.1053,0.005,0.0001
29367,119438,90071,2063,2151628265.5155,1529739788764746895.7188,90072,12.1947,0.001,0.0037
11893,36296,24403,11903,2150416016.4815,1527693239933224051.4404,24404,11.4633,0.0029,0.0042
17097,88755,71658,14601,2150811825.7743,1538565405085796826.0944,71659,6.8027,0.0003,0.002
16854,84928,68074,2359,2139848468.3375,1536647920869394581.828,68075,10.1519,0.0034,0.000
17956,22260,4304,16022,2226077425.1944,1517552012550732338.0214,4305,30.264,0.0002,0.0338
14494,73873,59379,13001,2154760307.8267,1536727718869235215.2407,59380,8.1282,0.0002,0.0031
29006,85642,56636,26128,2141078539.5681,1538406717199445727.5542,56637,6.9317,0.0041,0.0002
30136,78039,47903,19661,2137014954.7051,1533608898162818749.1425,47904,13.4523,0.0043,0.0005
26772,36195,9423,30060,2148719124.5187,1559110209271551107.4398,9424,10.3105,0.0062,0.0066
14527,32456,17929,12300,2151769924.8441,1534954719117090185.072,17930,5.430,0.0028,0.0054
494,23625,23131,924,2120511391.0331,1557869435660624295.8754,23132,31.2655,0.0125,0.000
6065,7020,955,3506,2076541289.6841,1547266248119226540.9107,956,7.9722,0.0309,0.001
20562,87885,67323,28971,2142442682.0148,1532915810591622531.0667,67324,4.4669,0.0033,0.0006
32474,117060,84586,14174,2145469763.5713,1548092746089096733.3718,84587,14.0142,0.0028,0.0022
8555,99892,91337,16486,2150311954.5715,1532221582741794746.3212,91338,27.1574,0.0032,0.0041
7143,10932,3789,32000,2139234812.6641,1504385498266865706.1845,3790,9.0873,0.0148,0.0072
20993,61458,40465,32207,2134617747.7944,1536036043510977983.5673,40466,11.9497,0.005,0.000
27133,114565,87432,9029,2150712228.1786,1534853424555961326.9824,87433,4.8819,0.0007,0.0021
25160,94667,69507,15833,2140839934.4074,1546381101509760720.1256,69508,10.384,0.0043,0.0015
9922,46867,36945,12761,2156711724.0109,1552391708137967069.8981,36946,14.240,0.0017,0.007
28083,114007,85924,20438,2140459614.3072,1531388240078756801.0003,85925,5.7761,0.003,0.0006
6658,97433,90775,16291,2157061627.6842,1539984971654918792.7304,90776,9.2968,0.0006,0.0043
8957,24196,15239,27948,2151875806.9215,1550212156066305550.2104,15240,5.9102,0.0026,0.0045
10845,29262,18417,23665,2179442293.3452,1547218493384059848.3448,18418,19.0297,0.0013,0.0133
11211,83888,72677,30014,2147787808.7902,1518836151752999941.8325,72678,18.4882,0.0033,0.0035
23857,64096,40239,3973,2136942020.2014,1527623079046469752.1,40240,4.8989,0.0056,0.0006
5542,29974,24432,25624,2153102001.2274,1551488934087916930.8985,24433,5.3783,0.0021,0.0053
9404,29794,20390,29245,2164585880.7134,1525520466644537696.0631,20391,7.4489,0.0019,0.0088
9885,55640,45755,11417,2146589600.8903,1543439167587498804.6836,45756,5.5309,0.0019,0.0021
11896,85675,73779,8388,2144263313.19,1530686353084518959.7472,73780,10.413,0.0029,0.0015
20330,21524,1194,1203,2126484318.1406,1560109876307037229.4915,1195,10.0717,0.0269,0.0119
15147,53829,38682,16407,2149983091.6456,1530174981580711387.6937,38683,6.0497,0.0019,0.0031
20893,93572,72679,24869,2142404648.857,1533551105872954213.5162,72680,5.5693,0.0028,0.0002
2800,59920,57120,14403,2152316691.7019,1538875298961351820.7992,57121,8.7963,0.0008,0.0041
496,8070,7574,30795,2123809525.9438,1509990953548164632.6432,7575,35.1066,0.0164,0.0027
18845,49729,30884,8497,2150816600.0997,1548710886535528332.5654,30885,7.0785,0.0034,0.0051
24124,26488,2364,2594,2167296373.2651,1555292226342267091.684,2365,11.5678,0.0094,0.013
4525,101047,96522,4666,2137809548.4723,1539016993030586539.2491,96523,8.6789,0.0039,0.0003
24394,120693,96299,8820,2142441038.6701,1529293112238208186.6209,96300,10.9938,0.0034,0.0008
10217,73324,63107,29984,2138894548.0151,1524434604164694352.8376,63108,21.7335,0.0056,0.0023
24257,50509,26252,32618,2133261721.6101,1530034890845339187.477,26253,12.0577,0.0101,0.0014
24671,96390,71719,14200,2146695721.5741,1539489844261334726.62,71720,2.4844,0.0013,0.0011
23483,37284,13801,9578,2154096360.7824,1524040266849791953.8646,13802,7.0336,0.0037,0.0077
32107,67562,35455,8553,2149023899.2256,1538388635172961217.922,35456,2.8437,0.0017,0.0027
18809,71525,52716,31868,2148727506.7106,1530076775838964815.223,52717,9.6409,0.0021,0.0035
26278,67402,41124,29738,2148810798.1311,1552584992793664657.2475,41125,6.5286,0.0027,0.0037
19196,70086,50890,17241,2157344285.0809,1536290235248314268.6866,50891,11.3011,0.0007,0.0043
15336,25357,10021,22961,2175581271.5874,1542129779141883411.8808,10022,15.7415,0,0.0111
5536,27917,22381,3442,2132013278.5353,1534992941120913866.1611,22382,24.4522,0.0098,0.0008
23177,83261,60084,12493,2148196343.6692,1535876811901776903.5911,60085,23.6385,0.0018,0.0023
7687,25319,17632,1449,2140939367.4323,1531169302704639677.5011,17633,6.3552,0.0063,0.0025
29690,44202,14512,31926,2158711183.703,1538049102325647375.1409,14513,4.6895,0.0011,0.0061
22809,25942,3133,14948,2128806217.6608,1548360530978704505.9587,3134,8.3002,0.0151,0.0048
9832,71919,62087,9817,2130510820.7403,1531752970358085801.3239,62088,17.7203,0.006,0.0008
29604,93613,64009,28805,2161021515.4407,1531949337910284884.7735,64010,19.3775,0.0003,0.0061
30705,70387,39682,8569,2155105394.0203,1548000941370463842.7665,39683,2.7667,0.0009,0.0045
25294,64014,38720,32474,2147772867.4375,1550727546805876140.8032,38721,7.7057,0.0023,0.0035
15217,86350,71133,20312,2153120217.0372,1529719356838861417.6194,71134,9.4479,0.0004,0.0034
26764,118716,91952,30278,2140785049.4473,1537152559119540902.6307,91953,12.5463,0.0039,0.0005
11116,79460,68344,26363,2147445341.7192,1538523677435232952.0911,68345,11.7781,0.0017,0.0021
14892,57258,42366,26458,2146694211.9276,1540536165564610371.7862,42367,5.8225,0.0021,0.0017
391,34912,34521,31717,2144315937.8435,1547442216162275062.3855,34522,6.5911,0.0043,0.0037
11031,105559,94528,10729,2152786868.6751,1543445133270777408.1624,94529,16.6492,0.0013,0.0036
13710,59904,46194,18531,2129596882.5594,1534744043038423511.2091,46195,12.3082,0.0069,0.0002
6965,47657,40692,2719,2153417694.4131,1552170473014317683.795,40693,12.3557,0.002,0.0058
2463,59356,56893,19824,2156192351.5771,1528017959037520960.6474,56894,16.5689,0.0007,0.0047
11620,26285,14665,12414,2159293138.1352,1525284181222338069.3212,14666,13.9159,0.0015,0.0076
29167,105950,76783,16616,2148416455.858,1536581450960088298.9074,76784,6.9023,0.0017,0.003
1667,63646,61979,19812,2143479676.0582,1531625318748010572.9196,61980,9.2339,0.003,0.0009
671,45546,44875,25206,2144000129.8198,1550501479350959192.2634,44876,13.9349,0.005,0.0031
2592,56784,54192,24155,2135570046.3042,1537850722998485815.4453,54193,16.5406,0.0042,0.000
323,18415,18092,4829,2156200185.0539,1534816128948952825.7343,18093,8.7955,0.0019,0.0059
11606,25128,13522,16681,2140969754.6547,1509896769398539404.7697,13523,6.2206,0.0077,0.004
14407,43336,28929,26247,2153402219.529,1541693272413765316.975,28930,5.027,0.0013,0.0041
29163,124497,95334,12306,2142252593.7472,1534877064596619459.7195,95335,22.8655,0.005,0.0009
11130,97502,86372,7480,2140066494.8033,1552299732061903227.5485,86373,28.7821,0.0044,0.0022
9211,81660,72449,453,2154504765.6225,1531612528751420746.1057,72450,5.8995,0.0002,0.0037
29092,40363,11271,32598,2160763743.818,1518506108187634412.4271,11272,10.3993,0.0019,0.0099
5493,100490,94997,24030,2144964682.9316,1536767097359871374.2098,94998,2.5536,0.0017,0.0003
30799,65491,34692,18604,2148537920.177,1534248369227905674.0321,34693,5.2527,0.0021,0.0019
27279,122397,95118,29363,2153592411.6867,1543972575285531849.8447,95119,10.148,0.0006,0.0033
2358,10766,8408,30765,2176311010.9698,1522647084881273346.798,8409,15.5113,0.0015,0.0124
29587,100327,70740,22285,2153829309.8337,1534068350566641666.7989,70741,5.3096,0.0003,0.0034
21528,47086,25558,20024,2145570855.4883,1528856311110129759.6456,25559,7.2696,0.0043,0.0031
6681,65722,59041,14326,2148753240.6244,1532085042305005981.0038,59042,12.3016,0.0019,0.0025
18320,100302,81982,5824,2139455822.6687,1540572415707699861.8704,81983,11.4219,0.0037,0.0003
25207,95208,70001,15618,2133830800.5213,1533818988330975373.9706,70002,19.5172,0.0062,0.0001
6525,44696,38171,32185,2166381086.9937,1552601015647447942.0005,38172,13.9506,0.0002,0.008
9202,34031,24829,8717,2141444194.2327,1527168842034575154.9084,24830,3.3725,0.0061,0.0019
17726,95264,77538,2324,2151654336.4854,1534865337307692303.2098,77539,8.573,0.0005,0.0025
24061,73357,49296,24606,2146424611.8807,1541647167401488917.922,49297,3.167,0.0021,0.0013
3316,56493,53177,10738,2148711793.3596,1534692164163642806.1268,53178,8.1674,0.0017,0.0036
32208,53767,21559,5435,2137512689.6069,1534446050086148154.2972,21560,6.9882,0.0055,0.0007
3414,52028,48614,15452,2154744186.0516,1525455734957368676.194,48615,11.9906,0.0009,0.0058
3805,93547,89742,6573,2139541042.6879,1537649825029277033.2488,89743,9.0108,0.0038,0.0006
24993,105932,80939,17626,2146657151.6626,1539440863415208449.1877,80940,1.5729,0.0018,0.0013
26844,59937,33093,1067,2153161110.8349,1529879948012995841.5671,33094,11.1245,0.002,0.0044
16909,67875,50966,4605,2156177705.5104,1543955638328976866.5707,50967,9.9476,0.0014,0.0065
15093,37740,22647,31133,2139542672.5004,1535810837228995288.8614,22648,4.2308,0.004,0.0014
896,86125,85229,446,2139364855.8459,1540736978895230761.0106,85230,16.7864,0.0047,0.0008
13919,86559,72640,29204,2153519649.3032,1544517713679106117.3962,72641,22.3184,0.0013,0.0047
13548,100239,86691,10016,2149073961.1096,1533406803870415992.8601,86692,3.5345,0.001,0.0015
890,66719,65829,2263,2147012370.0475,1540913165035000299.0802,65830,10.0433,0.002,0.0027
14307,88389,74082,15678,2157494592.5102,1547352365284383154.0888,74083,19.9177,0.0008,0.0061
20962,77107,56145,5141,2146895303.257,1538676843884356483.301,56146,2.1483,0.0013,0.0013
4478,48689,44211,9337,2143649790.4713,1535318163119860253.1372,44212,4.7656,0.0034,0.0012
14704,99631,84927,2441,2139411813.6145,1538694754480509328.8654,84928,10.8124,0.0044,0.0005
12868,100683,87815,20849,2156150902.4744,1535363510621490419.1914,87816,16.3811,0.0006,0.0045
1223,98665,97442,28472,2161137501.0243,1531470956067540909.966,97443,30.1218,0.000,0.0051
8038,61394,53356,32430,2145541748.0546,1539546248638432819.1698,53357,8.5244,0.0024,0.0018
5576,79052,73476,13726,2146126468.8303,1543123228786995942.7085,73477,4.507,0.0025,0.0015
23525,89306,65781,28343,2136829981.6656,1520401423135051735.8192,65782,20.7644,0.0057,0.0019
30241,66179,35938,18729,2157140919.4076,1533366330117632779.295,35939,5.7763,0.0005,0.0052
30327,33594,3267,12473,2177584590.9419,1501468489241732767.8993,3268,14.9172,0.0027,0.0177
28632,48634,20002,3640,2118121768.0685,1539778084058652841.154,20003,17.4244,0.0135,0.0002
13146,63915,50769,8286,2151858606.1186,1541737985443159814.5327,50770,7.6328,0.0013,0.0046
12407,74996,62589,9130,2153384848.5514,1540182869111131686.9744,62590,12.8543,0.0011,0.0035
4315,88173,83858,15196,2146356829.7631,1535421800023800587.3085,83859,9.4511,0.0023,0.0018
19134,76899,57765,16818,2161355181.7128,1537910822860716596.8785,57766,18.1709,0.0008,0.0068
20145,46132,25987,8089,2161528280.8508,1511896229728492721.4083,25988,18.3714,0.0033,0.0078
8383,87162,78779,10643,2145665525.1873,1533855374466659972.5338,78780,12.5053,0.002,0.0017
7902,49102,41200,18138,2158112055.6932,1539428483347081763.1119,41201,5.191,0.0001,0.0048
25734,33687,7953,26829,2183817457.6207,1548819868996972408.167,7954,12.5146,0.000,0.0155
14138,59555,45417,29870,2140009372.5121,1533997572206895329.5737,45418,4.4497,0.0038,0.0008
5306,80282,74976,3738,2146590905.5332,1542044337645771349.1357,74977,11.8029,0.002,0.0014
28995,95561,66566,11870,2158665101.2388,1535917263965672466.2705,66567,15.2935,0.000,0.0052
17355,62792,45437,4913,2152406141.9843,1523083231993966429.7024,45438,14.2809,0.0024,0.0043
11572,68139,56567,23522,2140589576.5069,1539111144201829703.1297,56568,18.9671,0.0041,0.0006
31195,109320,78125,17562,2147191267.54,1533446896712080708.0601,78126,3.0004,0.0016,0.0011
7520,32060,24540,14736,2151035629.6364,1521417982432640617.4994,24541,13.7136,0.0032,0.0054
22384,107304,84920,11034,2141742994.9893,1533018162954643023.4286,84921,5.1576,0.0031,0.0007
4478,60243,55765,17532,2145813214.0393,1535359317764259437.7513,55766,6.8506,0.0035,0.0022
28517,111890,83373,6493,2145758863.2255,1539995981183407596.1376,83374,13.1264,0.002,0.0016
535,55444,54909,24448,2139456618.8251,1533197521232461867.3457,54910,8.9134,0.0037,0.0011
3181,64831,61650,7427,2145266608.0029,1539660425140014994.5399,61651,8.6512,0.002,0.001
1513,86679,85166,19190,2143886036.3144,1527021088207870630.9716,85167,10.0087,0.0031,0.0014
7089,77212,70123,20030,2155837863.8346,1529621013594173113.969,70124,13.6284,0.0007,0.0041
6145,66456,60311,6343,2132075498.3136,1544225315834317300.9587,60312,23.7559,0.008,0.0011
23241,40673,17432,32492,2165922764.5834,1510695783433201575.6764,17433,25.3337,0.002,0.0102
815,83664,82849,20656,2147932167.4926,1548384523689009107.9359,82850,15.1306,0.0022,0.0024
28738,55826,27088,17748,2155038648.0136,1540784192386411021.5826,27089,11.5557,0.0011,0.0057
13492,57410,43918,14243,2148363228.9082,1535713700992912049.9459,43919,7.3618,0.0019,0.0026
29080,115769,86689,20192,2145780083.6885,1533113197064952474.4833,86690,13.9106,0.0029,0.0016
5253,69704,64451,18773,2155044502.7056,1542417808929211303.747,64452,5.1515,0.0007,0.0037
3930,97487,93557,11249,2150666169.9934,1542309351459894831.0056,93558,5.2357,0.0009,0.0023
8164,106093,97929,30222,2145988803.2247,1540182905620254640.0196,97930,12.2178,0.0024,0.0015
16465,30138,13673,17605,2113859879.6106,1556583704593916916.6967,13674,23.4803,0.0133,0.000
1367,42426,41059,16430,2151873460.193,1538774453758454570.7603,41060,19.1303,0.0019,0.0058
18394,95224,76830,1686,2151105602.4532,1539103688323061763.9303,76831,5.4221,0.0008,0.003
15872,34629,18757,16700,2155037246.6283,1532992507118197922.7953,18758,3.741,0.0007,0.0053
505,96798,96293,23094,2141270066.6267,1528616500758084788.99,96294,15.8484,0.0032,0.0014
21215,21421,206,24145,1831837881.2512,1270968547487558492.961,207,22.0159,0.1435,0.0048
29707,59865,30158,15915,2154358989.2665,1539020344867094792.6222,30159,4.8018,0.0019,0.0038
19405,20270,865,21148,2239256580.9457,1552751391260483529.2869,866,14.389,0.0018,0.057
23005,86990,63985,1802,2148326644.1973,1537373382370082844.2407,63986,2.4395,0.0012,0.0015
30490,89291,58801,5551,2145649896.7445,1535575829348141286.5429,58802,3.0669,0.0025,0.0011
21167,52507,31340,14545,2151758561.2995,1542040744498802410.5348,31341,8.5588,0.0026,0.0058
17464,36756,19292,28011,2130245707.0497,1559354559994460529.1945,19293,21.1232,0.0105,0.0018
25994,92695,66701,28503,2154131876.3292,1533008279570591052.3156,66702,11.9846,0.0007,0.0036
30160,77276,47116,29347,2152715277.2738,1524676268889545188.1418,47117,10.655,0.0013,0.0042
19706,22545,2839,28861,2205033541.0268,1519930447527654447.5584,2840,18.0586,0.0008,0.0321
14412,28155,13743,22277,2142312720.8434,1541062292341024129.167,13744,26.5555,0.0063,0.0032
24575,53640,29065,7775,2137627222.72,1552606488917699428.1692,29066,10.6195,0.0061,0.0019
6691,69964,63273,10777,2139108908.6667,1547822560164485037.1034,63274,15.1996,0.0051,0.0006
7478,65357,57879,29670,2145573009.8298,1542965501269815890.3776,57880,8.2892,0.0027,0.0018
15901,105035,89134,12607,2146753586.6753,1536429598202297534.3973,89135,1.9162,0.0009,0.0009
19742,114004,94262,4507,2141468965.0749,1532765204758834044.0835,94263,13.5074,0.0036,0.001
1908,32780,30872,28203,2151488958.4133,1525708705675260189.974,30873,7.5823,0.0015,0.0035
27447,107153,79706,7338,2147711755.4777,1533613150052578473.537,79707,3.1985,0.0019,0.0016
32476,90737,58261,17311,2135012156.7654,1544556834762667525.0636,58262,12.5298,0.0053,0.0005
19783,106622,86839,9603,2143375396.5193,1543880193672673018.0078,86840,10.9495,0.0032,0.0011
29676,92927,63251,21363,2151608681.0973,1534635860190327965.3685,63252,4.1131,0.0011,0.003
22230,35542,13312,19841,2139317392.5094,1532015761237593046.5713,13313,3.9083,0.006,0.0019
10463,47954,37491,6775,2153961677.8455,1534824234194045430.0402,37492,5.6427,0.0014,0.0043
8219,83399,75180,27592,2140746518.0974,1542819406667650037.3995,75181,12.0535,0.0036,0.0012
24583,33989,9406,6082,2168877214.9176,1526515294307395947.1865,9407,7.6346,0.0015,0.010
7507,87339,79832,22292,2144690416.8448,1538273631173258034.2855,79833,9.9648,0.0023,0.0011
15331,59449,44118,25563,2152605030.8162,1543359440910694961.412,44119,2.6549,0.001,0.0042
2655,89561,86906,3648,2144659176.5349,1536640402675162810.8252,86907,5.3795,0.0029,0.0008
25524,122450,96926,3228,2143619056.9088,1546634248087244966.9222,96927,11.1919,0.0035,0.0011
526,36289,35763,11723,2145980765.581,1526652345816428241.5717,35764,6.9882,0.0031,0.0034
9202,95566,86364,8364,2138969124.4101,1537797697989168722.0287,86365,10.3016,0.0041,0.000
13546,63595,50049,19740,2136454973.2143,1539502888507701618.4309,50050,14.5903,0.004,0.000
5671,48838,43167,4274,2154116060.6223,1551464902439527201.5182,43168,9.4428,0.0026,0.0057
19477,60691,41214,17932,2131608872.0847,1540596042513532792.4457,41215,12.4572,0.0069,0.0003
6101,74737,68636,25386,2153854248.0058,1537437236162702287.2322,68637,5.9047,0.000,0.0038
1051,31833,30782,12754,2124230632.5955,1539384254003495137.7982,30783,17.1777,0.0102,0.0002
28829,37258,8429,31500,2150317537.5807,1512932292366774976.8599,8430,10.4256,0.0067,0.0083
5142,26770,21628,30187,2134689342.5098,1535452789362807018.8362,21629,6.6595,0.0054,0.0001
13830,53198,39368,28175,2156971740.9773,1546170986175076613.7829,39369,14.7871,0.0016,0.0071
30003,62072,32069,5806,2152454527.7538,1536421081501679768.2726,32070,2.608,0.0005,0.0037
13725,55462,41737,2357,2141867241.0566,1535646197513096065.9587,41738,14.5432,0.0047,0.0019
11184,21713,10529,32532,2151528447.3374,1540054614006355241.3092,10530,4.0027,0.0035,0.0062
7004,75783,68779,23574,2123441272.3616,1536641552079511030.8748,68780,58.9195,0.0082,0.000
27280,27691,411,21955,2182805458.199,1500457155339372837.8973,412,8.0068,0.0222,0.0335
19030,23528,4498,7798,2157029726.3296,1519959391539780966.4477,4499,6.8103,0.0045,0.0117
29398,50448,21050,31675,2159946625.63,1568331846390345451.8847,21051,21.2203,0.0031,0.0085
3048,60117,57069,24874,2151454637.6324,1543077150179942941.308,57070,9.1603,0.0018,0.0035
25494,64455,38961,22944,2131681303.2791,1541921551611958973.1564,38962,16.7123,0.0069,0.000
15407,105538,90131,30513,2142519163.972,1540307418596061513.3337,90132,7.040,0.0027,0.0005
26721,91121,64400,32040,2151678266.3631,1530913469935636570.8782,64401,10.2811,0.0016,0.0039
31653,108867,77214,22818,2153372982.6409,1540026139118566296.0654,77215,7.1595,0.0006,0.0033
8963,106791,97828,29043,2161105633.9339,1542205730553375953.7182,97829,17.4731,0.0001,0.0057
26187,58004,31817,9103,2152406304.904,1520390981738429905.1854,31818,10.4781,0.0038,0.0046
20627,108501,87874,3406,2149575275.1508,1538517395809918217.9416,87875,4.9548,0.0009,0.0022
22321,81826,59505,1637,2132975185.4234,1532151688732462203.0234,59506,14.7077,0.0061,0.000
32342,40333,7991,30059,2136779427.51,1525146329867834876.378,7992,15.4132,0.0101,0.0055
1217,40587,39370,22796,2156573649.439,1537110447737566664.7535,39371,4.6114,0.0003,0.0042
27999,106598,78599,17858,2140310713.489,1529223193024986919.2424,78600,16.8818,0.0047,0.0007
3219,65755,62536,11278,2146311036.5774,1520967767530828552.5293,62537,13.9123,0.0039,0.0028
1932,20109,18177,15866,2162124889.7088,1541039367463348820.3105,18178,9.1708,0.0003,0.0065
6123,16314,10191,26409,2136227176.1405,1535341712972635982.1129,10192,7.0313,0.0057,0.0013
29057,125473,96416,10250,2148798454.2153,1534602486721087954.7235,96417,7.8209,0.0011,0.0015
31047,66532,35485,23547,2153696964.0656,1542777169932429111.2456,35486,8.6664,0.0012,0.0052
1155,69572,68417,2377,2156876889.2882,1538556039543851600.3694,68418,9.5338,0.0009,0.004
27727,122426,94699,24490,2142097101.0259,1538878195800991253.2878,94700,10.7286,0.003,0.0005
28802,127054,98252,14349,2145495486.6641,1536949801539692719.5469,98253,5.872,0.0026,0.0007
6495,73266,66771,18758,2143233448.1239,1536011240530522705.7261,66772,11.847,0.0045,0.0009
18293,104139,85846,29494,2139890248.9626,1537210500389356828.4217,85847,5.5129,0.0032,0.000
32366,109255,76889,13780,2157054709.4068,1539782870995263112.2941,76890,11.861,0.000,0.0044
12697,90442,77745,3692,2146908163.0946,1535477857934774312.1561,77746,5.0524,0.0016,0.0014
12463,36334,23871,20694,2148594936.5027,1540593902577233349.5449,23872,1.0159,0.0032,0.0031
19705,59045,39340,19657,2153995026.7146,1521680835938570754.8368,39341,22.5669,0.003,0.0056
22287,106986,84699,24918,2156426754.6072,1533665922149454541.2207,84700,19.5604,0.0001,0.0041
8368,39183,30815,24703,2144032900.6485,1532372240103400425.3526,30816,1.9878,0.0036,0.0018
32046,104069,72023,30955,2153397723.9863,1535926545284526233.1896,72024,4.700,0.0003,0.0028
14824,108519,93695,20865,2148807544.7787,1525954704558107911.6532,93696,18.042,0.0025,0.0032
9566,54396,44830,28792,2160575127.0102,1543884284141980052.4689,44831,12.6584,0.0006,0.0071
8791,78463,69672,20389,2151204645.8198,1537959235170747024.7277,69673,3.4333,0.0004,0.0023
9822,97913,88091,5769,2135190308.4803,1540115547257837531.536,88092,24.3642,0.0046,0.0001
14004,77385,63381,11262,2142741488.4591,1537964075827875018.3905,63382,5.5311,0.0029,0.0001
23294,110493,87199,4064,2144174808.805,1540392114806912128.5588,87200,7.7784,0.0031,0.001
23025,92712,69687,4552,2150836466.1915,1537607089511679582.948,69688,4.8458,0.0011,0.003
10478,29637,19159,28482,2119565264.0612,1549182800211728916.6265,19160,17.0623,0.0105,0.0004
7964,31126,23162,17104,2150881034.2456,1538384326041068546.7309,23163,5.4023,0.0014,0.003
12203,70667,58464,22242,2152520601.1825,1539807612352376081.0345,58465,4.991,0.0006,0.0033
24680,68436,43756,1348,2150919826.717,1552410799845096127.2613,43757,6.2167,0.0021,0.0043
23624,59882,36258,22326,2141212666.2412,1525562465331902704.0892,36259,7.5918,0.0041,0.0022
23057,115900,92843,16542,2142018587.6523,1542885097331010599.8374,92844,4.9389,0.0035,0.0013
456,89334,88878,17609,2147334696.5435,1539130846844875073.6235,88879,15.422,0.0029,0.0021
2716,20876,18160,11330,2133676348.5598,1536471504600676190.0671,18161,10.9882,0.0073,0.002
31556,36216,4660,24831,2145641536.7134,1520672871345102049.0331,4661,6.0778,0.0086,0.0085
12337,98576,86239,12425,2146378051.6647,1539644515243616633.4488,86240,5.6982,0.002,0.0016
17485,85679,68194,22811,2152786100.6829,1530527905534526972.793,68195,5.1548,0.001,0.0034
7400,103403,96003,8267,2146761980.1886,1537012923912027516.6859,96004,16.0087,0.002,0.0023
18003,80964,62961,12846,2143106391.9336,1535779543523178720.7314,62962,16.872,0.0039,0.0015
11150,99905,88755,8495,2136551997.7421,1538892917803832436.3516,88756,12.4074,0.0043,0.000
26780,65498,38718,1430,2141405973.2579,1532092365634453601.3914,38719,4.3488,0.0033,0.0003
23486,82011,58525,29575,2152960838.7731,1535610970034170684.547,58526,5.9188,0.001,0.0031
24517,37614,13097,9846,2158744856.4214,1523883883898578113.4246,13098,12.9344,0.0024,0.0081
12452,59006,46554,9793,2133517822.0542,1534538861402103540.1836,46555,10.091,0.0061,0.0002
14273,36992,22719,9512,2146661996.1592,1543974999787025904.3,22720,7.7945,0.0039,0.0049
10566,19567,9001,2699,2134873207.0943,1575132884990103185.2012,9002,22.6349,0.0109,0.0056
19552,29394,9842,28496,2135486497.1073,1558239841769505709.3362,9843,14.0012,0.0087,0.0016
18615,52445,33830,12911,2147945380.187,1543017299206062907.9031,33831,6.6511,0.0025,0.004
28983,84579,55596,1940,2152299854.4632,1537840720162049510.0377,55597,10.0607,0.0011,0.0031
17028,30221,13193,11759,2148976426.7957,1535049470321732145.6043,13194,8.9776,0.0043,0.0043
26221,86309,60088,11830,2157755239.8299,1539156087072564041.4599,60089,17.9126,0.0004,0.0053
13750,102299,88549,25491,2146222999.3954,1539564602586289488.2112,88550,11.7679,0.0018,0.0013
3239,76036,72797,21460,2138478435.2186,1533166298825785659.1049,72798,15.1678,0.0047,0.0001
9234,42081,32847,28529,2158056578.0553,1535008522405597836.0771,32848,6.2061,0.0004,0.0049
200,23107,22907,30993,2140147089.8066,1562640595922332997.9946,22908,18.1164,0.0069,0.0049
30949,82618,51669,14506,2149637788.312,1550658326631556328.0277,51670,14.7741,0.0027,0.0038
23856,110302,86446,7223,2156129239.9399,1536143016587399174.8466,86447,10.3318,0.0005,0.0032
9871,42357,32486,11960,2148280455.3575,1540473336697090199.4172,32487,2.235,0.0026,0.0024
3783,96660,92877,30023,2140994011.693,1545700913046662372.5084,92878,18.2586,0.004,0.0008
10429,107357,96928,18355,2141217631.8027,1543175591148858082.1629,96929,8.5905,0.0033,0.0004
23364,36140,12776,30112,2137948370.62,1532218505775934467.2239,12777,2.9133,0.0064,0.0011
13199,49244,36045,10849,2132958099.4094,1521099178568577198.7978,36046,18.5762,0.0084,0.0026
5152,93701,88549,7219,2147328274.6836,1527528523661044528.0886,88550,11.3423,0.0023,0.0027
13837,110140,96303,12393,2151832695.6648,1540922767591544185.5918,96304,9.5342,0.0009,0.0029
4027,8530,4503,26758,2139963575.4893,1552363654194833351.074,4504,2.7431,0.0074,0.0041
31510,118443,86933,5957,2147480760.0523,1535035335569132370.1217,86934,11.284,0.0011,0.0017
3290,38941,35651,1348,2149340008.7265,1546457042007461491.9921,35652,14.478,0.0029,0.0028
28960,34390,5430,14960,2165038660.9893,1539948530311745368.5213,5431,12.8379,0.0033,0.0114
27131,46467,19336,5881,2158171170.9764,1552287916624249553.0931,19337,5.7136,0.0015,0.0065
25201,115903,90702,6626,2140282421.9708,1544760163970521829.7811,90703,14.4642,0.0045,0.0009
29267,68893,39626,26381,2141490210.1493,1543065565076572060.3119,39627,9.3029,0.005,0.0015
13239,27909,14670,32053,2159011114.2858,1548706927505513450.8825,14671,5.3473,0.0032,0.0064
17063,39147,22084,11673,2143695539.2205,1543537611352691686.6366,22085,10.6356,0.0046,0.0028
19615,79119,59504,113,2156445642.3512,1540271764561487324.6942,59505,15.3187,0.0006,0.0043
17977,99805,81828,6373,2148851682.2795,1529129234046903211.1006,81829,11.5066,0.0021,0.0023
15843,72442,56599,18366,2138750764.4699,1526853577292695184.2945,56600,8.083,0.0044,0.0014
22488,42382,19894,32075,2127454182.1097,1552655090096835086.6099,19895,12.2409,0.0097,0.0011
997,87805,86808,1202,2152279915.3443,1541173518585295122.871,86809,6.0453,0.0004,0.0028
31614,110429,78815,18490,2157195847.094,1533168938887865513.3828,78816,15.955,0.0009,0.0059
3163,25098,21935,19025,2135097152.9821,1535848161150927132.9709,21936,7.9991,0.008,0.002
26264,57877,31613,24143,2154478344.9769,1530020657372061137.5748,31614,5.8702,0.0022,0.0054
23534,34821,11287,8578,2160015443.809,1540375753061093868.5854,11288,6.0521,0.0016,0.0094
14997,67996,52999,12280,2146647193.8333,1550014995465839537.7522,53000,25.1382,0.0042,0.0023
6346,77718,71372,13642,2156678399.8194,1542054931395447222.1317,71373,8.5969,0.001,0.0045
15984,98801,82817,20819,2140713937.8621,1534992679774400319.3292,82818,3.9061,0.0034,0.0007
18433,104743,86310,30663,2143641960.0752,1533708018749494084.8323,86311,4.2042,0.0025,0.0008
1425,71018,69593,19505,2143289482.9834,1532712879765640257.3258,69594,6.0217,0.0031,0.0008
22651,42418,19767,9905,2152980114.7181,1528083856802759900.6261,19768,6.9509,0.0032,0.0064
3011,35351,32340,3258,2139394573.9011,1540278056757191324.473,32341,9.9864,0.0053,0.0009
19474,50862,31388,31371,2148720029.9407,1546419396264506592.7274,31389,4.6846,0.0025,0.0032
2417,50447,48030,2855,2155725435.5437,1544635087293689940.2817,48031,7.1719,0.0005,0.0042
317,60783,60466,30197,2143178551.1375,1545672873224081724.6776,60467,7.4802,0.0035,0.0018
20802,73867,53065,4253,2146023500.5962,1548699811082904178.7151,53066,17.5617,0.003,0.0023
28275,101665,73390,30545,2149069424.0628,1530522534121054714.5868,73391,6.0804,0.0016,0.0026
5518,101848,96330,23390,2141961832.2866,1539545780893020956.2653,96331,4.8986,0.0033,0.0002
19534,83114,63580,18118,2142250060.7573,1551444270756297059.1843,63581,12.7975,0.004,0.0015
9897,71161,61264,21677,2149339204.3339,1527592849912683602.4337,61265,17.9277,0.0021,0.0037
30318,84264,53946,731,2149523672.2661,1546057618082495928.0781,53947,7.8174,0.002,0.0028
12235,87944,75709,4275,2148108034.9553,1547363804032965552.6289,75710,8.9079,0.0021,0.0022
7636,14823,7187,29466,2179230271.4733,1545565864813557759.2142,7188,12.5525,0.0004,0.0126
27030,99054,72024,5467,2142972721.3332,1535747219460841293.7484,72025,9.4598,0.0054,0.0006
10023,20117,10094,7859,2169832170.574,1558213578875884128.336,10095,8.8837,0.0023,0.0123
22067,35377,13310,21081,2160125230.8884,1536130797096116180.9119,13311,13.5837,0.0021,0.0076
2108,96119,94011,30371,2141295656.9111,1541816682942323569.3608,94012,10.5145,0.0035,0.0007
26479,36641,10162,23475,2117028104.4683,1521114695633387086.4537,10163,12.3874,0.0135,0.002
28079,68097,40018,7433,2142858140.9793,1540615525101501480.1054,40019,7.1442,0.0041,0.0016
27355,89644,62289,2556,2138204017.0683,1545781219825101503.8297,62290,14.5142,0.005,0.000
15070,66485,51415,5147,2149113442.1759,1536975639698411581.8177,51416,2.2863,0.0012,0.0018
17938,56357,38419,32085,2152800572.6796,1523691085111744708.7886,38420,16.0459,0.0016,0.0044
8865,96303,87438,20859,2148639254.8471,1540696889436951091.2119,87439,7.9979,0.0011,0.0018
15920,67868,51948,30327,2151125552.5981,1530473914260979222.4135,51949,16.1318,0.0015,0.0036
8823,94684,85861,27131,2151106030.6484,1533803083753669445.1621,85862,12.999,0.0008,0.0032
11014,82658,71644,29246,2147323456.8995,1534585190471890002.8952,71645,1.0683,0.0016,0.0014
29804,104534,74730,4964,2146777774.6983,1541069640573555615.4039,74731,9.4642,0.0021,0.0013
24236,33412,9176,17335,2117333342.4207,1509543917460842407.4365,9177,9.3037,0.0135,0.0017
23504,46105,22601,1135,2154769660.2244,1542965028635010562.1936,22602,8.6332,0.0021,0.006
16767,91197,74430,9207,2156413683.3265,1538497892382537953.1445,74431,10.8243,0.0001,0.0047
31065,57887,26822,7391,2139233595.0954,1543715759428653870.288,26823,3.769,0.0054,0.0026
15034,112216,97182,17957,2150926667.1491,1539273094606189343.7032,97183,6.4512,0.0007,0.0023
24756,104046,79290,7365,2140138556.4058,1539156217701483628.6209,79291,10.1958,0.0037,0.0007
1547,23832,22285,4349,2157191127.3001,1547268412443355840.7286,22286,5.4955,0.0007,0.006
8231,87423,79192,416,2149883245.9477,1537591437003820921.3824,79193,4.4101,0.0011,0.0022
26165,102265,76100,29906,2153792161.848,1537334926730116333.5847,76101,5.6763,0.000,0.0029
23431,93018,69587,9151,2149944882.2221,1535331232148496959.5809,69588,5.8851,0.0013,0.0027
10014,86932,76918,25509,2144304810.367,1547614164950249471.8448,76919,12.1739,0.0031,0.0013
7044,80025,72981,19905,2144484783.3101,1536814794340334111.8715,72982,4.6199,0.0034,0.0014
27849,33090,5241,20545,2165715584.9056,1527836457783778652.3644,5242,5.748,0.0025,0.013
7166,45427,38261,5510,2152556135.5592,1526625630731356185.1682,38262,10.1614,0.0016,0.0054
13742,96985,83243,23172,2142056835.4004,1543294398022622001.2479,83244,14.0363,0.0028,0.0006
26966,32912,5946,20848,2151318848.4902,1541877750223919667.0321,5947,7.4886,0.0061,0.0069
24710,37373,12663,16920,2129779759.361,1548179444097283220.1915,12664,11.6354,0.0098,0.0015
29120,32012,2892,14464,2133431582.7895,1564975165610943916.6536,2893,7.3976,0.0116,0.0061
10612,16390,5778,9369,2184880651.4677,1536973521493484397.835,5779,7.8314,0.0003,0.0142
5678,76248,70570,24604,2140655033.5519,1540264885341007369.6551,70571,12.695,0.0036,0.000
6094,38455,32361,1169,2156018533.5764,1527934438721093401.8587,32362,12.2652,0.0007,0.0051
32287,81417,49130,23008,2139476401.1588,1562227558973509768.0016,49131,37.9452,0.0065,0.0028
7796,60278,52482,31012,2149346972.7308,1539196990884523386.4193,52483,0.3695,0.0011,0.0022
20467,48310,27843,13201,2143765961.5733,1521226456201575653.9386,27844,9.1639,0.0066,0.0037
15808,45521,29713,22323,2146294214.7277,1535768744435767616.9002,29714,14.1849,0.0054,0.0024
10462,101202,90740,14522,2135672499.0761,1545477012613967507.3688,90741,22.2245,0.0065,0.0007
25117,54430,29313,6842,2164476449.7254,1536028398868114733.2411,29314,11.4832,0.000,0.0084
18025,101414,83389,24579,2150449994.8005,1535232711001660300.6988,83390,3.0829,0.0005,0.0023
15600,104660,89060,25308,2152486582.0414,1548750215715864199.8333,89061,16.528,0.0019,0.0036
1041,73414,72373,7415,2138895149.4117,1530707135990556142.2317,72374,12.4078,0.0047,0.0005
25186,106519,81333,23958,2148082007.5365,1530776761507047134.2426,81334,6.9277,0.0024,0.0023
30166,101199,71033,31605,2146378791.9569,1533035686049430205.7018,71034,7.1115,0.0018,0.0016
32378,82003,49625,12233,2149653347.5238,1543284854282142499.7873,49626,4.0496,0.0021,0.0028
2669,43038,40369,18533,2143056133.6945,1539550885635832211.662,40370,5.5928,0.0043,0.0011
11137,72493,61356,21445,2139459168.3927,1529982575424351439.6639,61357,8.422,0.0046,0.0011
23270,87195,63925,3648,2143941856.7344,1533385901508581331.7325,63926,4.7921,0.0031,0.0012
20143,23523,3380,1347,2148074313.425,1547719951128295695.4464,3381,4.1892,0.010,0.0078
4901,96377,91476,16451,2142740404.4404,1532108800879327289.0774,91477,8.1678,0.0029,0.001
7402,96621,89219,27349,2154158649.1168,1530404650625396400.6398,89220,21.1746,0.0013,0.0046
9051,104813,95762,32246,2149994600.8689,1536755200925210239.9265,95763,9.1833,0.0013,0.0028
16272,34642,18370,15381,2149588720.3551,1514093568027281449.8573,18371,10.0958,0.0052,0.0068
18688,115479,96791,20759,2159071948.7505,1537509496825364766.6574,96792,13.5694,0.0001,0.0042
1322,8854,7532,11407,2134433765.8809,1539072303745039597.9148,7533,6.1164,0.0087,0.0019
8080,60423,52343,22612,2150168487.4334,1534633153103711074.1074,52344,2.6416,0.0017,0.0026
4989,69004,64015,14099,2149584775.7789,1531404050761734673.1135,64016,6.5794,0.0019,0.0029
31009,89809,58800,12142,2140872970.454,1536305989439918524.8126,58801,7.3596,0.0041,0.0005
10284,20050,9766,10093,2150707096.0625,1531271177536275939.6148,9767,7.1469,0.0051,0.0067
13720,16474,2754,27139,2225546756.7572,1508783040720494685.2409,2755,17.3316,0,0.0345
9797,97284,87487,17216,2145572773.3917,1540326583928127690.5499,87488,3.7113,0.002,0.0008
21038,63774,42736,26581,2130759469.1309,1541461868417133314.8471,42737,17.4494,0.0072,0.0002
9805,59134,49329,20879,2135796188.8991,1528903862017315105.7863,49330,5.9353,0.0049,0.0006
18695,65530,46835,15354,2146705737.4587,1535410926391946393.0314,46836,7.9952,0.0017,0.0015
17354,36779,19425,9505,2122200637.4123,1554744667599618179.2655,19426,25.2367,0.0112,0.0003
22642,116764,94122,20575,2144828747.3917,1542964243667186123.3056,94123,6.4248,0.0025,0.0011
14351,77307,62956,32699,2156618142.8689,1541807462840292058.9009,62957,12.4382,0.0006,0.004
27544,38092,10548,26177,2141340692.563,1544050759367347383.496,10549,6.0664,0.0074,0.0032
27959,36553,8594,2573,2142175466.1218,1532667373260732641.4075,8595,6.4608,0.0051,0.0022
7611,61116,53505,10233,2148484117.447,1529503898684620635.6864,53506,3.6768,0.0017,0.0025
4972,44098,39126,17317,2138032931.5653,1554169983145481920.0132,39127,17.6482,0.007,0.0017
22356,83074,60718,2511,2151442824.8117,1531733516256564951.8483,60719,6.3273,0.0016,0.0034
17234,98462,81228,1877,2154704144.0895,1538131581368522880.6618,81229,9.161,0.0001,0.003
8833,58227,49394,28126,2155963929.8373,1532007303217664951.3476,49395,5.6983,0.0008,0.0046
15081,50692,35611,22273,2146259953.2953,1534864063888475545.8363,35612,8.3617,0.0052,0.0021
17365,32199,14834,3170,2164729563.059,1553144618864218428.9568,14835,5.8642,0.0001,0.0094
14513,42204,27691,5696,2159566619.5789,1539303879949499350.8987,27692,11.1407,0.0013,0.007
30831,112928,82097,23714,2144948241.2774,1533207573368253453.1298,82098,3.3497,0.0021,0.0011
24982,89741,64759,30811,2143769827.1751,1523997993049736802.2776,64760,16.0504,0.0039,0.0026
23091,84082,60991,7077,2149126986.2198,1525305299337513597.9228,60992,19.1367,0.0028,0.0042
15578,41927,26349,22713,2153933138.61,1543770357658128977.0867,26350,6.7789,0.0016,0.0035
12339,75319,62980,15220,2168350735.545,1542940739839111733.2528,62981,21.898,0.000,0.0075
335,12645,12310,7922,2153890960.4027,1515715631363826123.2338,12311,6.053,0.0043,0.0067
22882,55283,32401,20246,2148008649.9885,1538989279754529555.3073,32402,0.6125,0.002,0.0027
27484,126862,99378,3801,2143702102.1816,1538915298182463898.8588,99379,6.6886,0.0024,0.0009
6207,32142,25935,31823,2139036564.0824,1540382471833773554.7424,25936,4.6721,0.005,0.0007
20179,119911,99732,21634,2144937934.7203,1537808506959514885.837,99733,3.6622,0.0018,0.0006
23084,94052,70968,22874,2149452652.19,1541369131370203691.7378,70969,8.4132,0.0015,0.002
29404,116481,87077,28798,2143879203.4045,1534989431785160412.0182,87078,22.815,0.0034,0.0013
14271,27324,13053,8359,2127359824.1901,1535231919260267117.3415,13054,13.0319,0.0089,0.0005
31155,56831,25676,30212,2144601250.6387,1553313706625738267.8627,25677,4.4039,0.0044,0.0039
13185,86429,73244,9172,2147109010.4533,1534593291983434117.0247,73245,16.402,0.0028,0.0038
1818,27004,25186,27842,2160909750.5456,1526802097894046581.7013,25187,16.2704,0.0013,0.0067
4170,19167,14997,6649,2145982780.294,1548649133207620120.5589,14998,11.4465,0.0057,0.0037
20480,116802,96322,30231,2145814684.7739,1539410830311516190.8887,96323,4.5829,0.0022,0.0011
3804,53845,50041,13293,2141258877.7358,1543751887320819721.8457,50042,9.0474,0.0033,0.0008
19697,29095,9398,15103,2159405744.0993,1514963084765056754.0426,9399,13.4131,0.0026,0.0092
6028,97380,91352,13009,2147488875.4061,1532239241661008186.3834,91353,9.6922,0.002,0.0024
1652,42748,41096,28374,2150630994.2272,1544956165349748422.859,41097,11.4906,0.0029,0.0046
27859,61444,33585,16170,2160333401.4509,1527882087359363247.8207,33586,11.7646,0.000,0.0057
6704,102541,95837,2986,2151477190.7443,1534329240363968448.0491,95838,7.8043,0.0008,0.0027
26978,28332,1354,18743,2165754642.0236,1536917865326885980.6002,1355,2.0959,0.0059,0.0139
31416,36051,4635,8548,2123624915.0582,1507440438082865172.8469,4636,18.3013,0.0223,0.0074
29761,128013,98252,3188,2145773479.0932,1536720338638801868.3232,98253,3.0885,0.0017,0.0009
17679,80929,63250,10951,2150469067.9354,1539062743544073069.2355,63251,3.1553,0.0009,0.0024
17711,84299,66588,17168,2150510306.8146,1533648757841453855.3016,66589,1.5666,0.0008,0.0024
10454,22083,11629,16918,2139647697.6331,1532263152949347779.5461,11630,3.3427,0.0054,0.002
30946,81819,50873,24562,2136007421.3575,1528236569289958760.4141,50874,10.4641,0.006,0.0002
25025,78826,53801,27993,2152055047.2828,1528760052384250075.649,53802,10.2561,0.0012,0.0046
4661,47434,42773,7544,2151819401.2122,1532535530989714404.5572,42774,4.7359,0.0015,0.0037
583,24979,24396,20095,2157882904.9907,1538396068023978694.1072,24397,5.1756,0.0007,0.0049
15646,56395,40749,10839,2161866051.2325,1539797612878738562.7499,40750,5.9463,0.0008,0.0074
26042,26974,932,25036,2142635378.6731,1552178065328473666.6402,933,19.4437,0.0204,0.0323
16410,87869,71459,3436,2144940685.0996,1542621163225080901.5326,71460,5.6103,0.003,0.0012
2256,87504,85248,23083,2145497389.7541,1532342773669761423.1865,85249,3.7923,0.0022,0.0014
25898,45007,19109,20267,2152664104.3969,1536976365553314381.0123,19110,10.3486,0.0019,0.0062
24614,97757,73143,11751,2160602761.2104,1537083623488082938.2875,73144,21.1629,0.0004,0.0074
25554,69933,44379,6177,2155785305.9467,1539813460972153762.5851,44380,16.2285,0.0012,0.0065
16359,90374,74015,31361,2153973988.2038,1532523168179828705.0706,74016,5.3535,0.0012,0.0036
25087,122868,97781,20796,2133211248.6706,1540668081042858950.8741,97782,27.822,0.0064,0.0005
24403,37906,13503,4547,2167241785.1493,1552246687958670841.9185,13504,14.598,0.0006,0.0095
16980,107742,90762,26651,2142675836.3283,1532658610842856641.9326,90763,9.4729,0.0034,0.0005
7481,54151,46670,12087,2141935897.4778,1537389918299820034.3245,46671,3.5092,0.0033,0.0004
26723,88491,61768,24074,2157481607.0409,1541531141575258962.6672,61769,16.207,0.000,0.005
12455,22737,10282,18150,2147760804.892,1549812507023233290.6985,10283,5.0298,0.0052,0.0044
23060,104660,81600,13243,2152908422.316,1533222007554202615.5572,81601,5.0922,0.0008,0.003
32734,76768,44034,3401,2158211229.7544,1540810927310390407.4038,44035,5.4899,0.0004,0.0054
22048,99195,77147,29401,2138836816.0406,1538678805747310010.9572,77148,12.0577,0.0044,0.0002
20815,61756,40941,22491,2154593776.4332,1545132384695398684.3094,40942,5.1814,0.0014,0.0044
9915,43910,33995,2256,2151803704.474,1539793795014539785.6748,33996,1.9936,0.0009,0.003
19978,52643,32665,4286,2160377333.4289,1532908613342337499.5495,32666,11.9266,0.0006,0.0073
24552,119946,95394,13611,2137764819.6375,1533229539036474503.3589,95395,10.8778,0.0049,0.0001
20084,25178,5094,20382,2162200711.9888,1518436410383352121.5047,5095,5.2724,0.0057,0.0112
18752,113506,94754,26386,2144494870.2866,1536522606360032693.8233,94755,7.8562,0.0024,0.0011
1185,52314,51129,16515,2141199411.993,1546345950570674702.5731,51130,15.2455,0.0049,0.0013
6274,67039,60765,21342,2151040876.1693,1532879813982126130.1974,60766,15.3155,0.0013,0.003
26553,43547,16994,30116,2168845722.0054,1546676479845131204.3239,16995,13.2151,0.0001,0.0096
16379,36842,20463,20262,2153308612.199,1547965294483305941.8678,20464,4.5132,0.0019,0.0046
3018,61068,58050,19853,2139345894.1398,1532286224059456546.9535,58051,11.2473,0.0048,0.001
11075,55708,44633,1778,2164450263.2707,1527475998532858602.6176,44634,23.6239,0.000,0.0086
20765,66992,46227,8511,2139127169.7335,1530192979945917086.1024,46228,11.802,0.005,0.0013
2456,41651,39195,8975,2147871913.1873,1537656887178164460.1008,39196,5.8317,0.0032,0.0029
23431,57389,33958,20290,2148727398.1893,1541202766712091471.9384,33959,4.031,0.0018,0.003
12660,86917,74257,32258,2147277939.4388,1537429038862104379.34,74258,2.311,0.0014,0.0016
25105,69996,44891,9400,2131402046.5931,1537587550822391536.9701,44892,25.0931,0.0092,0.0008
29630,124960,95330,30009,2142590657.0194,1547869385266261038.0453,95331,16.4665,0.0034,0.001
11467,105125,93658,1604,2138159253.7034,1538037305780826208.5992,93659,8.2309,0.004,0.0002
30668,79681,49013,11564,2154370575.1115,1535198467821241284.3754,49014,4.4127,0.0004,0.004
20782,120202,99420,31265,2142878840.0353,1530434614199431616.7925,99421,12.118,0.005,0.001
10635,97232,86597,16894,2153893742.5678,1543210462313754892.6047,86598,10.5432,0.0011,0.0052
11704,107155,95451,15487,2149217999.0815,1544120124220729626.089,95452,9.9605,0.0016,0.0024
22255,42221,19966,5829,2146461773.7715,1532490935220948449.5756,19967,4.6743,0.0025,0.0025
10885,97991,87106,13736,2150277966.9769,1533302499073252829.5366,87107,9.7331,0.0015,0.0025
25729,63371,37642,1907,2140828008.245,1532640794506746125.1709,37643,5.5199,0.0042,0.0009
20762,102617,81855,8804,2145584873.7048,1534641096442911992.932,81856,4.4702,0.0019,0.0011
10994,106421,95427,8438,2146800927.0486,1538013330539136810.5198,95428,4.4659,0.0016,0.0016
9401,73412,64011,16480,2150259572.5444,1538989641596110059.0544,64012,8.5821,0.0012,0.003
9618,100641,91023,21164,2149568946.1275,1532917931795071700.7418,91024,5.0189,0.0011,0.0026
28401,49769,21368,18482,2171708616.1281,1540503488538345763.6931,21369,16.2706,0.0003,0.0105
9592,22168,12576,14853,2164840359.9285,1541249141968616434.1481,12577,6.9705,0.0007,0.0085
24485,116920,92435,4621,2140941202.4782,1534824116836970185.4898,92436,5.6874,0.0032,0.0004
21388,43269,21881,16354,2135379335.9661,1541352286194581049.1297,21882,6.590,0.008,0.0006
25764,86502,60738,28384,2143330128.0506,1542487516299045345.4468,60739,10.6883,0.0028,0.0016
28679,116460,87781,1322,2152290955.6796,1541658294746574222.9554,87782,8.0583,0.0002,0.0027
13913,35431,21518,12149,2152829046.9462,1521697477705850281.1591,21519,27.9881,0.0026,0.0061
31262,87427,56165,5375,2148244014.1239,1548976783503247467.3686,56166,7.2289,0.0022,0.0032
18552,20710,2158,5819,2118576528.7948,1534548368935120104.517,2159,6.2663,0.0158,0.0043
32652,92905,60253,26940,2144529712.3614,1528559359880803068.7434,60254,4.8734,0.0035,0.0018
1111,100900,99789,12069,2156334495.267,1528608175265215152.73,99790,11.7309,0.0002,0.0044
21087,28636,7549,32668,2106498783.757,1563350652704210757.2144,7550,14.2296,0.0186,0.0032
1862,33603,31741,13485,2149926494.7937,1541911591548511888.05,31742,9.3585,0.0018,0.003
4305,70828,66523,15405,2159042795.7157,1544904462897554988.742,66524,13.0607,0.0001,0.0062
25122,36020,10898,25619,2115538235.2772,1575282413493664568.9274,10899,43.1619,0.0195,0.0035
14400,56113,41713,18948,2153256147.6927,1547121127896941215.3512,41714,4.6865,0.0015,0.0041
4196,26592,22396,15085,2140066830.7216,1535266709941686867.6209,22397,12.9913,0.005,0.0021
30464,43600,13136,26296,2180099091.627,1530873041781999531.2309,13137,15.0021,0.0009,0.0119
1586,59982,58396,30629,2148200193.5403,1538582347623071002.9252,58397,4.7753,0.0017,0.002
9694,101783,92089,21021,2155887569.6505,1535543005901544369.2684,92090,7.6004,0.0002,0.0037
12853,90639,77786,28324,2152022837.4437,1543385945234200394.288,77787,12.195,0.0014,0.0033
4810,51958,47148,27085,2148944454.359,1544992089790378956.7452,47149,6.5422,0.0022,0.0036
22749,77715,54966,13453,2133865997.9839,1528522905123071443.0051,54967,14.2642,0.0064,0.0004
19551,41789,22238,12266,2153744188.2999,1522772118006490795.3183,22239,6.9046,0.0029,0.0052
30674,130391,99717,13107,2140681130.5571,1534223671895956057.341,99718,10.1196,0.0035,0.0003
9620,44918,35298,26839,2133527511.3035,1531418429861899807.168,35299,8.4609,0.006,0.0001
8180,36600,28420,1515,2141892614.974,1544833814844708510.0113,28421,12.9955,0.0069,0.0033
16019,115485,99466,23901,2144742581.838,1543859391902076760.1729,99467,14.725,0.0024,0.0013
16721,109744,93023,2685,2144233565.9039,1540358889242692810.4646,93024,7.6123,0.0026,0.001
26047,84076,58029,11503,2145855854.9676,1544046017060544620.111,58030,8.4854,0.0026,0.0019
10376,24643,14267,14553,2169718756.0198,1513335612599738221.5178,14268,18.8732,0.0009,0.0122
28507,39726,11219,29975,2120598655.5385,1516993371912519795.9569,11220,12.5668,0.0149,0.0011
24555,25770,1215,7091,2204461160.1316,1578291226118752564.3774,1216,12.5207,0.0074,0.0329
15838,76885,61047,25741,2159299315.4861,1542593571229345127.5031,61048,17.6132,0.0004,0.005
16928,92511,75583,26221,2143036582.7599,1538598708120955854.7252,75584,6.5459,0.0023,0.0003
19039,65491,46452,18095,2156078334.8799,1543031438318236068.2132,46453,8.2807,0.0003,0.0054
18898,64793,45895,12389,2139141680.0742,1533440973687634977.7181,45896,8.2493,0.0057,0.0008
4707,80451,75744,18601,2155196046.5696,1541597534831678233.2416,75745,6.3304,0.0006,0.0036
5035,79194,74159,28072,2145606888.3557,1538781948811087664.3619,74160,11.3163,0.0022,0.0015
30471,101695,71224,11721,2148694792.1745,1535517135976249115.8892,71225,2.6424,0.0014,0.0017
17550,54366,36816,31588,2157497943.4222,1531724197971392312.1377,36817,6.344,0.001,0.0045
5355,85556,80201,641,2143510972.5226,1544280313105830537.5551,80202,7.5738,0.0034,0.0016
366,77446,77080,13067,2152395130.9046,1539564605062811907.7656,77081,6.6804,0.0007,0.0032
29883,88523,58640,22649,2137962346.0069,1543162413532432737.8699,58641,10.5594,0.0043,0.0001
7335,64406,57071,14673,2142996436.1784,1536712628802147250.8343,57072,11.4633,0.0034,0.0022
6463,94839,88376,17152,2144849028.3434,1532470530461709524.0774,88377,13.9414,0.0032,0.0015
22859,30906,8047,30664,2170346578.4225,1555433434421854046.6277,8048,12.2511,0.0018,0.0154
14192,87257,73065,26523,2149098415.9436,1532311523514385155.6713,73066,2.7027,0.0016,0.0018
7714,61200,53486,26973,2139827883.9192,1543847487917152642.4827,53487,21.657,0.0046,0.0012
10175,96244,86069,10671,2143548445.1371,1535323580558917356.0522,86070,5.3401,0.0028,0.0006
18658,38672,20014,6577,2156021829.9135,1540988742003164917.6758,20015,5.4989,0.001,0.0047
26458,75909,49451,31748,2158337332.0028,1539979044480358330.8339,49452,7.6607,0.0002,0.0043
16715,49114,32399,16625,2162665853.0111,1535735462894822842.812,32400,12.8797,0.0006,0.0072
24632,43071,18439,6508,2141008084.6627,1541887608141527985.5021,18440,6.5302,0.0053,0.001
9503,33539,24036,15308,2151463791.2158,1531414251039621263.7156,24037,15.4505,0.0026,0.0043
10716,25279,14563,30963,2155765159.6192,1538908933802045860.8752,14564,5.6441,0.0023,0.006
26019,104080,78061,3053,2140579525.8077,1542963403859133581.519,78062,8.6255,0.0039,0.0011
19294,37265,17971,19028,2110983266.6186,1554328291107395328.4013,17972,40.4056,0.018,0.0029
11812,12804,992,389,2127402714.6798,1594212979788643853.6135,993,7.1733,0.0205,0.0128
8308,48648,40340,22901,2141664697.0581,1540878782478390379.3479,40341,8.0561,0.004,0.0007
14064,92629,78565,9601,2143139381.8583,1534789288285254641.3947,78566,4.1492,0.0025,0.0004
3436,64851,61415,27427,2135235605.0972,1543737002803471003.0936,61416,17.3499,0.0053,0.000
29408,103785,74377,32200,2140189794.9118,1535653199875734285.6005,74378,5.8808,0.0031,0.0001
3550,20948,17398,17097,2147969041.1211,1505439920593800918.3983,17399,16.6064,0.0067,0.0059
22699,107462,84763,2722,2142536003.0431,1538760386249681464.5091,84764,17.5906,0.0039,0.0008
26911,124007,97096,11246,2145453935.3048,1541755836232535871.9543,97097,11.9934,0.0028,0.0011
22283,104257,81974,16926,2148438949.9719,1546284699199420423.7994,81975,19.6757,0.0025,0.0031
30298,126267,95969,12988,2150832440.1981,1535180256639523973.6537,95970,4.8206,0.001,0.0022
30801,93464,62663,23503,2134577417.6494,1535604062619474878.672,62664,19.4705,0.0051,0.000
14585,97922,83337,14018,2152665614.585,1541235768167273845.3699,83338,16.587,0.0009,0.0033
10161,51167,41006,4157,2154695605.8533,1529056830621842150.5578,41007,5.7443,0.0008,0.0037
17478,25374,7896,11734,2166191709.2686,1552512340511673577.443,7897,20.406,0.0038,0.0151
29894,116147,86253,8870,2146062104.1684,1542730526698205714.9283,86254,24.1541,0.0034,0.0019
7307,40947,33640,9989,2150508652.0103,1530839074250466469.1039,33641,14.3963,0.0025,0.0038
27484,37258,9774,6978,2149572390.9351,1536931584616592642.0079,9775,10.9089,0.0031,0.0054
17957,45098,27141,21439,2154406533.4869,1546770598043306356.3206,27142,7.6332,0.0021,0.0049
29983,44339,14356,1572,2156527581.9113,1554862622416476467.052,14357,9.5437,0.0033,0.0076
31193,91301,60108,14409,2145179113.4103,1531894190535673213.6724,60109,3.2268,0.0026,0.0014
32590,118172,85582,10598,2142555844.9484,1537939835339813808.8608,85583,4.068,0.0028,0.0005
15611,94775,79164,22785,2138721855.8291,1529970961446701235.3374,79165,21.3284,0.0044,0.0021
31502,125494,93992,2940,2143691640.9428,1539043721210783293.1227,93993,2.8117,0.002,0.0003
21205,84983,63778,16685,2144589597.1896,1540360626575152256.0997,63779,8.0167,0.0038,0.0015
14804,59628,44824,12357,2151571959.9973,1530055599817486017.4614,44825,16.7707,0.002,0.0036
15882,52966,37084,18762,2151634159.5224,1524312339666224659.4306,37085,5.4673,0.0024,0.0044
19654,77211,57557,10530,2148351116.3086,1536585186989612689.4143,57558,15.6542,0.0018,0.0037
5560,73123,67563,1945,2154990648.7784,1533946495046793463.4635,67564,16.0573,0.001,0.0033
30080,52670,22590,30481,2162318716.8197,1530397652683886272.3308,22591,10.1828,0.0002,0.0073
8216,104983,96767,18550,2155725185.0238,1540068079625105036.0021,96768,9.5506,0.0003,0.0041
4738,77456,72718,27851,2145960261.9709,1526875824413649618.8118,72719,4.5767,0.0027,0.0018
16321,44071,27750,20893,2157663206.688,1516751738039544447.0788,27751,13.0555,0.0038,0.0069
18078,104703,86625,3157,2142287179.6638,1534452103678056976.2558,86626,5.3216,0.0028,0.0004
25108,34891,9783,13707,2151676396.3062,1559483362946405843.5837,9784,5.2966,0.0047,0.009
26087,27829,1742,24734,2116990468.6024,1560775411972961034.8936,1743,5.9902,0.0162,0.0022
18511,106081,87570,2536,2161968499.6273,1535594746890384301.4517,87571,19.6186,0.0001,0.005
32429,88748,56319,13267,2137334632.7364,1520709914283068198.176,56320,16.1246,0.0068,0.0015
12809,102489,89680,3877,2143642951.6369,1535731920632100466.3327,89681,1.7388,0.0023,0.0003
4514,68679,64165,28734,2154750557.8075,1537124315341047743.1926,64166,7.8988,0.000,0.0035
9975,70185,60210,26504,2144646036.8843,1536218378664630363.7287,60211,12.0841,0.0022,0.0011
20673,55781,35108,29905,2142965100.421,1539944695753917264.1192,35109,5.6849,0.0032,0.0013
31796,107968,76172,26249,2146986193.9635,1526430559322889900.418,76173,9.7712,0.0023,0.0025
22321,55533,33212,30316,2157924481.3938,1525083621462033290.9423,33213,7.6477,0.0011,0.0069
24527,72786,48259,17894,2143628352.3645,1533183169505065012.702,48260,6.3886,0.0025,0.0012
10467,73828,63361,8351,2145338468.062,1531256960296038536.87,63362,7.1863,0.0029,0.0013
25205,31126,5921,15258,2154883863.625,1535258344400009185.8906,5922,3.1676,0.0027,0.0058
9148,31515,22367,21046,2161233103.4084,1524733405291076008.3732,22368,11.6189,0.0008,0.0069
10336,14229,3893,30378,2130623065.1086,1552654795153997168.0013,3894,6.1587,0.0106,0.0017
20061,62646,42585,29310,2155961989.5825,1530144942758302934.7464,42586,4.5839,0.0014,0.0047
21923,37559,15636,30163,2149682872.6974,1534429742859079704.2816,15637,3.8514,0.0032,0.0036
13356,74841,61485,29911,2149887256.9099,1535366401834618635.8747,61486,6.8129,0.0011,0.0024
9679,85568,75889,29275,2143595795.5275,1538848372883063761.5702,75890,4.4832,0.0025,0.0005
3720,24961,21241,11502,2137447036.4596,1533676977324259384.2554,21242,7.2762,0.0054,0.0001
31944,120010,88066,26028,2133766581.7501,1539562715214045445.7787,88067,14.0079,0.0054,0.000
10444,61949,51505,9422,2142541278.0317,1542275892895049265.8175,51506,6.4499,0.0034,0.0005
6744,33186,26442,20049,2139677184.7517,1535401215963367832.2855,26443,7.8635,0.0071,0.0019
29616,75816,46200,23815,2153716177.4904,1518644752472420133.6094,46201,19.0512,0.0025,0.0056
19813,84553,64740,31371,2141430228.7885,1535119309551247155.8266,64741,2.8604,0.0029,0.0005
29320,55138,25818,2654,2171791118.5513,1538611664125571121.4605,25819,20.2173,0.0002,0.0089
27104,65741,38637,16722,2166871767.2985,1540408091678419782.4947,38638,30.2864,0.0002,0.0125
10278,60845,50567,31822,2144252717.5598,1530730777791163194.0329,50568,18.2744,0.0041,0.0028
1527,13147,11620,21424,2159853419.1034,1538703128297094826.75,11621,8.2351,0.0013,0.0082
596,77854,77258,5134,2145758355.08,1543245101479269794.0056,77259,6.3685,0.0025,0.0012
21975,68422,46447,17672,2141386440.4501,1540501888254600119.9068,46448,6.6413,0.0032,0.0007
25772,102133,76361,2179,2154532759.9653,1535621222238085117.8917,76362,4.8087,0.000,0.003
11946,43183,31237,27469,2163621777.2075,1523678863335696799.9532,31238,14.2919,0.0012,0.0071
17343,23982,6639,2895,2148611758.2181,1521736727234278308.491,6640,4.9159,0.0054,0.0045
9304,21085,11781,11500,2135400069.7713,1533181471469600445.4774,11782,8.3292,0.0067,0.0021
24760,117378,92618,1587,2140042443.8797,1532828837959472137.2147,92619,13.7781,0.0043,0.0005
19268,56744,37476,593,2162161738.3216,1525148350079322022.3499,37477,18.6693,0.000,0.0079
17333,110328,92995,27396,2149470082.4631,1535109398329387874.1261,92996,15.821,0.0019,0.0025
368,47150,46782,3539,2148411345.8343,1539167793673138281.028,46783,3.776,0.0018,0.0021
24077,99891,75814,29159,2146723790.2165,1533373981575018563.7504,75815,6.3406,0.0022,0.0016
20976,26145,5169,9243,2130369392.7836,1582002817809173737.3978,5170,11.4798,0.0136,0.0084
1958,77260,75302,21611,2146377231.27,1535887908219002996.7214,75303,3.078,0.0022,0.0011
24228,108351,84123,3172,2144237312.6258,1539563804490933677.6989,84124,2.1646,0.002,0.0008
12080,79584,67504,12588,2140907496.396,1537232083339650858.3324,67505,9.0317,0.0028,0.0006
7459,102797,95338,2355,2148126802.2553,1544753904370245242.5069,95339,17.0766,0.0028,0.0025
6573,43541,36968,31639,2145666426.0406,1542220962030927928.8285,36969,2.976,0.0034,0.0036
15441,85944,70503,2842,2152677906.1795,1534784891146023080.0255,70504,8.1187,0.0004,0.0032
13414,104522,91108,23322,2151424805.6685,1543298622948292402.3685,91109,9.8008,0.0012,0.0029
22505,40185,17680,21918,2140420263.5399,1528534268565588628.327,17681,3.1298,0.0055,0.0014
13373,17898,4525,22053,2124661939.5848,1517956454919884537.6277,4526,8.5512,0.0201,0.0035
16866,94597,77731,8671,2154416741.7596,1540461774380203405.3108,77732,9.4171,0.0003,0.004
2816,88095,85279,23310,2146104097.4752,1535760843178406997.1364,85280,23.6882,0.0022,0.0019
9060,28876,19816,17659,2140395761.7116,1536707711313578782.9668,19817,6.9044,0.0065,0.0015
25536,111210,85674,30934,2146565942.8079,1538558991638608035.6778,85675,5.8404,0.0017,0.001
32265,97261,64996,7855,2155281564.8346,1536402286113634268.4752,64997,4.3459,0.0002,0.0035
14428,55353,40925,23042,2141075344.1109,1535312394924396122.5464,40926,12.9798,0.004,0.0007
22497,49240,26743,12039,2131665090.0761,1545602405322951351.8588,26744,15.3775,0.0066,0.000
8739,92936,84197,21425,2149392176.0255,1545895090862497750.2329,84198,11.3409,0.002,0.0026
17120,45883,28763,13089,2140593007.7506,1528328081047293307.7097,28764,8.973,0.0059,0.0012
27287,108992,81705,9326,2140126372.1928,1528357891049786053.5684,81706,12.5721,0.0034,0.0012
1479,87346,85867,1468,2150478591.3221,1533811172306197565.5751,85868,2.3572,0.0009,0.0021
17802,75856,58054,14736,2148408803.5389,1541580492189755108.1964,58055,4.0716,0.002,0.0024
31303,79000,47697,7242,2150026019.0652,1533137067797429456.4908,47698,9.7535,0.0016,0.0029
2942,72951,70009,12669,2151520784.8679,1541336287443061641.6104,70010,7.2802,0.0012,0.0032
16869,29178,12309,19617,2119248677.2508,1530445510635590135.8652,12310,9.2554,0.0104,0.0001
7473,53892,46419,21658,2142090353.9491,1533321094136334293.1659,46420,11.0204,0.004,0.001
855,87212,86357,27708,2146466943.0398,1536557067422314043.2825,86358,10.5954,0.002,0.003
8141,69795,61654,29067,2147252677.1139,1539297102229487970.0726,61655,2.0718,0.0015,0.0016
6261,18452,12191,959,2148200537.9462,1530845191930342445.106,12192,3.1028,0.0034,0.0035
19110,75942,56832,5449,2146054894.3594,1538591053465925086.3746,56833,2.4888,0.0024,0.0013
9334,64320,54986,24068,2146993663.1125,1537749929621573175.1724,54987,7.9256,0.0018,0.0015
7249,36703,29454,13218,2139882037.5376,1522643468984236688.2829,29455,14.0534,0.0065,0.0025
1285,27462,26177,16271,2125795588.5076,1538375094806874476.7934,26178,10.9869,0.0094,0.000
635,3627,2992,523,2141559962.9816,1509488272700663242.8493,2993,12.9999,0.0147,0.0122
18740,111312,92572,6524,2148175418.4042,1535159347462956096.1842,92573,3.9292,0.0012,0.002
22911,38878,15967,28652,2156541056.2014,1552409738468205802.6679,15968,2.9478,0.0013,0.0066
18926,63648,44722,24647,2161303420.931,1544720709099924378.2001,44723,14.3372,0.0001,0.0058
6804,100696,93892,5574,2146233939.0749,1533290143264601188.5268,93893,4.0217,0.0016,0.0011
20237,117518,97281,11568,2152598835.1426,1541184907306216914.1176,97282,9.3517,0.0005,0.0035
31774,74857,43083,15984,2141801251.4332,1549324248331312989.9247,43084,16.6778,0.0047,0.0019
23945,82658,58713,268,2158004348.6103,1541728385281222281.2214,58714,7.4164,0.0003,0.0045
25056,72038,46982,32395,2140060670.8794,1538176760679864291.7137,46983,10.7818,0.0042,0.0012
913,69594,68681,26337,2146255671.369,1533235439185398116.8585,68682,13.5293,0.0029,0.0017
25433,92850,67417,14837,2133273885.8547,1533861736819028524.0876,67418,14.6237,0.0065,0.0004
23679,119164,95485,16407,2146354870.2419,1535524090977729282.1532,95486,2.9654,0.0016,0.001
27777,97839,70062,24882,2148688674.0264,1532888763261784876.7114,70063,4.8256,0.0009,0.0017
18177,44845,26668,14539,2158963886.7588,1543521268081917050.8368,26669,7.4845,0.0009,0.0056
20279,72269,51990,22288,2150873996.8235,1535508160304113254.3144,51991,2.1881,0.0007,0.0023
14444,63793,49349,23061,2149654231.1225,1545292698963771981.2912,49350,18.7308,0.0034,0.0043
25196,96034,70838,31958,2140899489.6642,1541764426252195798.723,70839,12.8858,0.0038,0.0003
28438,127855,99417,11649,2151978327.6135,1531399405440756033.8952,99418,28.2881,0.0014,0.0036
5839,85556,79717,10581,2155245127.3369,1546742078123038361.8506,79718,14.1295,0.0013,0.0043
14285,17929,3644,6129,2140174153.1753,1539208944344151927.8197,3645,5.4309,0.009,0.0074
2435,101881,99446,21153,2152322563.9886,1535804654369659625.6835,99447,13.0984,0.0001,0.0027
5329,56116,50787,24457,2165100299.4562,1538479867652743350.0539,50788,15.0685,0.0002,0.008
23270,64956,41686,622,2134493287.5109,1540506481395309332.0551,41687,12.9166,0.0065,0.000
15362,39494,24132,29435,2136645982.9033,1544474016057669200.8085,24133,12.8144,0.0077,0.0013
2557,6544,3987,27808,2160260558.1459,1538549207179404178.918,3988,8.1789,0.0038,0.0116
16629,59829,43200,23205,2144319968.3349,1533634667549302744.031,43201,3.4934,0.0026,0.0016
22039,60955,38916,9387,2151949089.9239,1538786212416458253.366,38917,5.5886,0.0009,0.0033
3945,64639,60694,4747,2144243475.7131,1549239952364715451.0769,60695,6.9554,0.0033,0.0025
14979,88608,73629,7944,2146650023.1947,1534578264603078524.747,73630,5.5818,0.0017,0.0011
2930,30306,27376,16411,2172754179.428,1531191367501310601.3025,27377,14.3665,0.000,0.010
25700,125470,99770,4172,2147539508.5456,1541014430630979613.9676,99771,4.7641,0.0016,0.0015
10278,23934,13656,4115,2152185577.1196,1558257939205466093.8324,13657,12.4112,0.0042,0.0054
6813,46960,40147,1181,2152491765.5313,1539872157832064408.1179,40148,5.777,0.0019,0.0038
12971,72473,59502,12571,2146506352.2532,1537597108623435978.2462,59503,4.0529,0.0016,0.0009
8784,35593,26809,1930,2132066545.3217,1531572498706918537.5662,26810,10.7305,0.0077,0.0008
17675,60729,43054,11130,2147548859.353,1537213077307661220.728,43055,5.7136,0.003,0.0022
13050,87044,73994,616,2157394740.3786,1547403053088108336.9392,73995,8.6992,0.0004,0.0046
8199,61534,53335,27898,2151488108.0433,1537613397099610143.0858,53336,4.348,0.0003,0.0022
20764,61364,40600,17145,2133261916.9239,1542616735388403943.9092,40601,15.7076,0.0062,0.0002
14691,103055,88364,17165,2151311307.8386,1533532170289028304.2109,88365,12.5465,0.0006,0.003
17272,88251,70979,16148,2155313435.1939,1536662647206638984.7188,70980,6.2458,0.0004,0.0038
26025,34819,8794,24797,2170806207.9906,1545613967182742490.0062,8795,9.9674,0.0009,0.0115
27664,103717,76053,24249,2150069230.159,1538006279824346842.569,76054,8.0064,0.001,0.0028
24900,76281,51381,22472,2148653782.0228,1527849863337471863.235,51382,3.9812,0.0019,0.0028
20756,71133,50377,12881,2152399209.0957,1534164722551993820.1852,50378,9.2735,0.001,0.0043
15018,74560,59542,7825,2139876366.5818,1536877232584472847.4325,59543,9.9267,0.004,0.0002
4526,59582,55056,3245,2140796507.5078,1530016885369676341.3793,55057,9.8497,0.0039,0.0005
28553,73735,45182,13727,2135977979.1192,1540374189466276850.199,45183,10.1503,0.0052,0.0006
1138,47579,46441,3933,2146754131.41,1541517417242527696.6558,46442,2.7476,0.0022,0.0015
18334,70657,52323,11566,2150266359.7611,1535271700478212622.699,52324,2.903,0.0005,0.0021
24411,69280,44869,6279,2158975116.2932,1531915874429331920.7588,44870,7.0948,0.0005,0.0054
3235,10741,7506,16981,2151967776.2031,1545882971515558326.0087,7507,2.8146,0.0037,0.0073
9234,15123,5889,26778,2157366054.7516,1534918670357782167.1976,5890,5.5359,0.0056,0.0124
12853,63851,50998,22777,2160183585.1097,1531767439450921478.0131,50999,21.3183,0.0006,0.0074
3801,40164,36363,27494,2150473210.7835,1539902989782029532.5248,36364,5.1343,0.0018,0.0026
18040,98839,80799,6159,2144576265.4493,1534385012642316267.2066,80800,6.7437,0.0026,0.0009
23869,40462,16593,27733,2137289408.4117,1521541484385525589.1846,16594,7.6305,0.0092,0.0025
25268,103716,78448,29427,2155133502.0368,1531068530231013046.0685,78449,17.0714,0.0005,0.0036
26901,126828,99927,1724,2146000157.5202,1538150468516120942.0339,99928,4.4032,0.0012,0.0006
25982,63948,37966,3171,2135334782.8489,1531591669491772541.5104,37967,12.6339,0.0059,0.0006
23877,24374,497,13359,2143342682.1345,1466326541300294225.9678,498,2.4352,0.0239,0.0155
20474,70152,49678,25950,2143819855.4789,1544060583332025700.3068,49679,10.1141,0.0031,0.0015
9530,54622,45092,14874,2136494470.5783,1534531615054610025.9233,45093,6.6887,0.0052,0.0001
19199,60034,40835,20971,2154101194.2611,1532591853222259958.5002,40836,3.9939,0.0003,0.0036
21724,75407,53683,30767,2151685977.956,1536182842367405499.4132,53684,11.7415,0.0013,0.0038
11090,37354,26264,15490,2147194578.5647,1537451634755784430.0033,26265,13.8252,0.0051,0.0028
17721,39016,21295,22182,2155557745.4068,1544971269509159186.2383,21296,4.4965,0.0022,0.0058
29601,74539,44938,4919,2154235005.8615,1538106581326663377.8323,44939,13.1477,0.0012,0.007
17355,70227,52872,7306,2137171318.3663,1531080622584474015.1446,52873,18.7105,0.0054,0.0004
32615,100964,68349,25634,2153890168.2443,1530609003137688643.3861,68350,12.2093,0.0006,0.0035
17487,82160,64673,27937,2152614338.4285,1532792404743223109.1527,64674,9.1582,0.0009,0.0035
25414,30976,5562,16945,2146702265.9989,1533935211365529551.6905,5563,10.8518,0.008,0.0076
17285,113648,96363,6885,2150947583.3615,1530013172868239408.7316,96364,8.5521,0.0012,0.0031
20495,108622,88127,24901,2148861583.6685,1536143174520005624.3378,88128,6.3037,0.0017,0.0015
19113,71819,52706,19587,2133455856.3792,1531853649670351973.2314,52707,13.1958,0.0061,0.000
22211,24768,2557,23053,2122203737.3108,1523748942183127903.337,2558,13.1742,0.0173,0.0023
25854,76910,51056,2093,2149785274.4241,1528855368878255821.329,51057,9.5726,0.0023,0.0029
29273,122922,93649,128,2142253556.1265,1536823073179742974.4159,93650,17.5371,0.0037,0.0013
1801,80504,78703,258,2159839689.4358,1528307819914690746.8021,78704,26.3668,0.0003,0.0065
27435,38819,11384,3689,2159876487.0052,1545350228762605208.5569,11385,12.409,0.0027,0.0094
15501,86002,70501,8755,2145718074.8588,1541613895481359783.9964,70502,17.5347,0.0025,0.0015
27891,114877,86986,30759,2147593413.9429,1539643393322918914.2098,86987,14.6437,0.0022,0.0018
29579,42268,12689,2084,2133329955.3553,1543088575291956779.3077,12690,6.0389,0.009,0.0016
20432,119757,99325,15040,2141638458.2433,1540338344790311735.7537,99326,8.3505,0.0034,0.0004
15786,106107,90321,2949,2149398234.6109,1530478360108537984.8244,90322,9.1072,0.0021,0.0026
4804,60839,56035,13930,2147822926.2345,1538484789447379589.9956,56036,5.0599,0.0018,0.0021
17366,87481,70115,24873,2138760310.5675,1532068287164704809.1189,70116,7.6293,0.0039,0.0004
27139,92421,65282,8985,2139100864.6935,1540806507420121655.3064,65283,13.2516,0.0042,0.0001
6825,82598,75773,4954,2150972998.6526,1532272395554701599.7018,75774,4.727,0.0007,0.0027
6014,73526,67512,2979,2154749937.7803,1533764158904350745.6948,67513,12.3353,0.0002,0.0039
20688,23546,2858,22096,2115099824.9482,1594171003446348583.7826,2859,16.8513,0.0197,0.0036
28237,56574,28337,18234,2151295920.3386,1542300984401372131.9355,28338,3.2605,0.0026,0.0033
32344,33820,1476,29717,2140258240.8687,1535548788754416263.54,1477,3.4884,0.0158,0.0082
22121,69901,47780,14176,2142677587.2729,1533070827300317742.6406,47781,4.4952,0.003,0.0008
18912,72083,53171,20791,2146885346.215,1532085247241064621.2921,53172,2.4941,0.0018,0.0016
9756,83380,73624,21806,2160323334.3099,1534060102345875226.677,73625,11.3793,0.0002,0.0062
23389,86672,63283,23650,2145429104.0495,1534172446167847490.1437,63284,5.6627,0.0022,0.0016
24793,98183,73390,26497,2151562265.7282,1540605149860459707.883,73391,7.816,0.0012,0.0036
29257,90958,61701,18716,2133366563.5383,1538486426949641897.4601,61702,14.6595,0.0059,0.000
8032,33675,25643,13361,2147250688.551,1551608024490024359.389,25644,8.4397,0.0038,0.0036
10738,81870,71132,6576,2145484576.8128,1535898840480752966.6504,71133,4.9626,0.0014,0.0006
6711,72250,65539,26944,2135330683.4227,1532961250312471584.36,65540,10.4113,0.0056,0.000
13484,52393,38909,11944,2162284389.5098,1531224746817771828.6704,38910,14.6731,0.0004,0.0061
24247,35121,10874,25532,2109823896.8704,1532054994755825256.1499,10875,14.4943,0.0172,0.0002
31085,107357,76272,7920,2156308734.288,1542857586869574998.0314,76273,6.2389,0.0004,0.0046
28258,104527,76269,15117,2153659869.7988,1545303729071174591.7899,76270,15.0837,0.0013,0.0037
29527,95807,66280,2338,2155092829.8399,1539072291660856030.1409,66281,10.2707,0.0004,0.0052
30117,104632,74515,19574,2144443789.3493,1548176260222858520.6637,74516,11.9967,0.0031,0.0022
30196,44188,13992,5125,2151417694.4193,1539921952012476340.9185,13993,9.8098,0.0041,0.0087
3056,36818,33762,31258,2148262496.2359,1537504108348867113.335,33763,16.436,0.0041,0.0047
6257,74021,67764,18822,2146979765.7815,1536421576917537899.6503,67765,15.1952,0.0021,0.0016
17033,24951,7918,23321,2120588383.81,1551854063582253499.0712,7919,11.5293,0.0115,0.0002
28636,59212,30576,7649,2140216874.3702,1538710599230195493.3602,30577,14.7294,0.0068,0.0014
31133,114994,83861,1958,2154402037.8887,1532667318396421799.6233,83862,12.4607,0.0006,0.0036
19008,93663,74655,20671,2149032264.8142,1540310895453270413.904,74656,15.271,0.0017,0.0029
23029,48204,25175,2288,2150598128.9433,1532321712359261789.9038,25176,4.1804,0.0022,0.003
26107,72119,46012,25948,2137441525.181,1529772774233636304.9983,46013,14.5527,0.0057,0.000
18645,43563,24918,23715,2155252930.6528,1537576588799476220.1835,24919,4.8329,0.0012,0.0049
3507,13975,10468,11086,2165209479.6289,1552808565587540234.0695,10469,6.6176,0.0022,0.0103
17716,47651,29935,10918,2129195548.0366,1531504990079894281.1828,29936,15.7421,0.0091,0.0003
13549,109410,95861,25555,2144127067.9143,1539174787872406882.4777,95862,6.5801,0.0023,0.0006
1091,91664,90573,31167,2135049252.6782,1541392758273050001.9214,90574,22.0208,0.0049,0.0001
16605,111495,94890,12390,2157283869.8215,1543947239707302251.5467,94891,11.9241,0.0007,0.004
19522,100522,81000,20880,2137467849.7987,1541757107099319368.7956,81001,13.2402,0.0052,0.0002
7495,44928,37433,17481,2153290337.8591,1547958565478706653.2655,37434,6.206,0.0021,0.0039
13958,75811,61853,27816,2147901048.2302,1529904546584229683.3242,61854,15.4202,0.0031,0.0032
11472,60436,48964,21546,2160248083.234,1525558033221623107.2966,48965,21.6959,0.0009,0.0076
26086,52359,26273,5336,2146657277.4752,1529170273030100923.2443,26274,5.8756,0.0036,0.0026
10148,84612,74464,19727,2146036172.4112,1534851041925201759.6806,74465,6.0818,0.0014,0.0011
20020,83698,63678,31345,2140421509.2006,1529665401691533354.0255,63679,7.9802,0.0039,0.0014
24771,57739,32968,24826,2143220074.8809,1538215850634131780.8284,32969,3.325,0.0043,0.0017
5515,11449,5934,8367,2169205561.1776,1539300574733304338.913,5935,4.8926,0.002,0.0123
103,61733,61630,15686,2144384734.5891,1537243272101636579.8864,61631,5.5158,0.004,0.002
503,24949,24446,11658,2188191283.1808,1538224179927713251.4703,24447,33.9499,0.0001,0.0157
165,17666,17501,2290,2138981066.9654,1545446303384490429.8145,17502,15.653,0.0068,0.003
7142,33290,26148,17303,2139824022.3012,1531563386360625121.2455,26149,6.5662,0.0044,0.0006
15502,85933,70431,24677,2144658722.4287,1540828785937995673.5893,70432,12.5227,0.0037,0.001
16590,17612,1022,14769,2187551528.1701,1411992045803088223.2477,1023,22.4985,0.0187,0.0386
21456,43653,22197,14756,2138238562.781,1538740848427958327.8361,22198,13.3752,0.0056,0.0019
30264,128325,98061,8881,2143450651.0977,1532503385409175475.635,98062,6.5304,0.0023,0.0008
15616,104435,88819,29054,2153969197.5743,1540530708867211879.3631,88820,18.7689,0.001,0.0056
16048,83770,67722,17534,2130455039.7748,1533810166516155852.7775,67723,21.5417,0.0071,0.0003
487,96732,96245,2409,2152933270.6672,1530240677485398988.0331,96246,15.475,0.0012,0.0034
8922,100843,91921,16164,2150208071.1489,1541877290588711609.518,91922,2.823,0.0007,0.0023
5718,15476,9758,4320,2113020062.8729,1552157066705135300.8975,9759,21.6659,0.0144,0.0001
4362,35175,30813,27362,2135244408.6603,1540927310686441357.7665,30814,5.0522,0.0065,0.0007
19612,80409,60797,23217,2152091293.2838,1530035044201418949.1928,60798,16.7241,0.0018,0.0049
27274,102944,75670,24914,2151007116.2281,1551520814899371612.8917,75671,20.4778,0.0031,0.0039
2204,56247,54043,801,2150687199.4368,1534411099511973229.1755,54044,8.7458,0.0007,0.0023
18847,101440,82593,5401,2146842636.5968,1548863648461618623.1564,82594,19.8621,0.0028,0.0025
25882,100787,74905,12142,2141008847.3873,1538268365026508355.2814,74906,9.6478,0.004,0.0007
13664,14959,1295,27674,2164818679.6975,1548447709595886522.8776,1296,3.2325,0.0058,0.0139
17736,68821,51085,12396,2134420063.8433,1540845199967923643.5025,51086,16.3846,0.0055,0.0002
20919,81899,60980,6177,2149779831.6329,1534428854779952617.0872,60981,11.7443,0.0018,0.0033
21070,107895,86825,18655,2145955756.0381,1540310438954677821.3305,86826,13.2601,0.0029,0.002
24463,72554,48091,31289,2142461829.1112,1534362394563688952.2303,48092,7.3311,0.0031,0.0013
24393,109843,85450,28080,2153404878.6574,1541815887173267690.5848,85451,9.2862,0.0008,0.0031
26932,98691,71759,30013,2151888387.4309,1545577898160972560.8423,71760,16.8522,0.002,0.0033
8581,21383,12802,17916,2165608176.8731,1560918400062158869.1671,12803,9.6422,0.0018,0.0101
16898,41821,24923,14820,2148487088.9592,1542496044457379112.6563,24924,7.2117,0.0029,0.0044
28686,76843,48157,23354,2157735962.9747,1541169673852872519.1251,48158,10.5115,0.0012,0.0048
29521,100920,71399,1838,2144882579.7476,1525749287405274985.5559,71400,9.2298,0.0034,0.0018
11647,65040,53393,17526,2149926718.6577,1529554191389072908.1023,53394,7.6114,0.0015,0.003
25729,64473,38744,30240,2151849274.0638,1531203340391758578.9557,38745,6.3617,0.0016,0.0038
22530,88237,65707,2446,2157507485.1653,1532387818071146118.4242,65708,20.7766,0.0003,0.0047
32161,108436,76275,1577,2145471344.1671,1540216790934258998.7963,76276,3.0979,0.0021,0.0017
12707,71043,58336,28387,2140288224.6081,1537721265544958901.3418,58337,5.9458,0.0047,0.0002
10756,62659,51903,7030,2153949283.2682,1528326090015782970.539,51904,10.4149,0.0017,0.0045
11570,86248,74678,29347,2147186653.4422,1522112818850687707.6172,74679,14.1168,0.003,0.0031
32328,53912,21584,29741,2142689639.8212,1539235399125183014.0345,21585,2.3191,0.0047,0.0024
26954,125237,98283,17106,2150053467.2443,1534164990850507748.4788,98284,4.6835,0.0011,0.002
15986,73933,57947,31801,2133027840.1716,1525377307292506343.7894,57948,15.5493,0.0065,0.001
21172,120851,99679,22693,2148883894.5889,1537032155106689714.0042,99680,6.4481,0.0011,0.0017
27483,84592,57109,20330,2150709566.6096,1536825406441291715.4536,57110,5.9586,0.0009,0.0023
22627,95906,73279,646,2151741085.0319,1530408449945991986.5549,73280,21.0589,0.001,0.003
1798,69495,67697,23189,2141357593.1769,1539692405439904178.9487,67698,8.8971,0.0031,0.0005
10911,98099,87188,21128,2145051592.0778,1540576530218328657.3297,87189,3.3803,0.0021,0.001
15335,109936,94601,3711,2153553982.1162,1540707374085231920.9635,94602,4.1557,0.0003,0.0028
30886,89153,58267,12109,2158523760.3036,1541430114823506649.9192,58268,11.2321,0.0003,0.0056
14038,40727,26689,28587,2138123798.684,1538282078044681707.2341,26690,8.6109,0.0049,0.0006
5179,29046,23867,28683,2135812735.3277,1544351619830508912.8977,23868,11.2401,0.008,0.0019
10500,95274,84774,32312,2151003513.4528,1536592487648391321.6371,84775,5.9685,0.0013,0.0031
21211,24068,2857,25894,2178054401.3153,1525847235119292448.9409,2858,10.9109,0.0025,0.0195
29726,61437,31711,1334,2156451361.3325,1529633581668439418.3572,31712,6.6196,0.0024,0.0064
30174,111829,81655,1597,2143052646.2281,1543014785355114051.8121,81656,9.4605,0.0029,0.0008
20989,55338,34349,25846,2147657348.0148,1529288120205105321.8472,34350,9.7714,0.0038,0.0036
31000,101327,70327,26616,2144514114.5281,1532726089687366211.054,70328,1.9914,0.0027,0.001
9373,68793,59420,4019,2143679598.6687,1533899309031562375.5224,59421,2.1446,0.0033,0.0007
21528,68587,47059,11049,2149482474.9059,1542465786661124484.1698,47060,4.4278,0.0018,0.0028
25426,121378,95952,16965,2147278741.1574,1539797483826165006.9261,95953,9.5876,0.0013,0.0011
5912,84879,78967,30236,2145504919.1122,1539992895146168115.8243,78968,8.8885,0.0034,0.0017
28004,46394,18390,1841,2147387316.8288,1549175961098250456.1466,18391,15.3592,0.0058,0.0042
31805,119295,87490,21164,2150982091.8733,1530951829743975111.2196,87491,4.2007,0.001,0.0026
27314,54901,27587,27650,2143839340.6547,1540359707768789086.1395,27588,5.2478,0.0041,0.0022
17241,115046,97805,25452,2143730832.0831,1540108421059050924.1582,97806,13.1571,0.0033,0.0011
26678,100645,73967,24709,2147576330.5686,1547712138191660094.8681,73968,17.1081,0.0027,0.0032
6014,10659,4645,3693,2139277613.364,1556513530146616716.1902,4646,7.1399,0.0096,0.0064
18661,38561,19900,25177,2148841127.0402,1533191506128094537.2662,19901,2.5295,0.0028,0.0035
27079,59624,32545,23426,2142865882.704,1533744406662174542.24,32546,3.7943,0.0031,0.0014
4309,42275,37966,25723,2147522603.8888,1541458889523311755.0319,37967,5.9725,0.0026,0.0029
9067,72806,63739,7708,2155780421.6519,1528044300681804333.4198,63740,13.4265,0.001,0.0056
29255,70313,41058,17605,2153051939.3682,1530838969630486150.3031,41059,5.940,0.0007,0.0034
10292,75123,64831,13469,2170567922.5148,1535338521673283302.7562,64832,26.1066,0.0002,0.0079
29274,80405,51131,14811,2145268341.6968,1544481974075407395.3188,51132,10.3722,0.0032,0.0025
12535,110396,97861,31005,2142716211.474,1546423696911975735.0935,97862,20.2297,0.004,0.0009
10132,49491,39359,7652,2144459994.9797,1539430295607106985.9012,39360,5.767,0.0035,0.0019
6561,29408,22847,27975,2147535977.2591,1535570422983408740.0407,22848,7.9266,0.0026,0.0031
30454,52248,21794,24042,2162343730.2237,1549570224674694363.6665,21795,9.3864,0.0001,0.007
22254,106582,84328,28133,2145292107.4251,1541801646800055346.6464,84329,6.7538,0.0036,0.0015
10727,104326,93599,6909,2152124317.6757,1530539434778044397.5292,93600,15.7241,0.0006,0.0036
30884,41638,10754,2929,2111087172.8855,1548092503749107579.9145,10755,24.2802,0.0174,0.0005
21655,118093,96438,24716,2153906670.2449,1535757878376088704.4025,96439,12.275,0.0005,0.0033
9743,98468,88725,19843,2153904978.021,1548576543074634977.0029,88726,13.4655,0.0014,0.0035
31043,41317,10274,27891,2153197766.7004,1535483272564351448.0366,10275,6.557,0.0024,0.0047
2186,101260,99074,19590,2151852508.6734,1529340798195040424.9269,99075,7.8813,0.0007,0.003
8371,23803,15432,7288,2135317000.086,1549816332477450297.0442,15433,12.1505,0.0093,0.0036
15252,61239,45987,7081,2137129176.7579,1528742237849107468.2753,45988,9.4101,0.0059,0.0013
21163,113475,92312,513,2152853475.9362,1533181609383575570.3126,92313,14.137,0.0002,0.0029
11657,91863,80206,7745,2141842919.5533,1533545489706891765.2816,80207,7.6724,0.0036,0.0005
2819,11591,8772,14458,2161828057.261,1508698122532622485.6487,8773,18.0079,0.004,0.0104
6729,62226,55497,24211,2149669094.6071,1554020225739007203.444,55498,11.6518,0.0031,0.0038
22171,36459,14288,632,2143893492.608,1547535299383938077.9324,14289,8.5354,0.0073,0.0039
24660,34590,9930,18294,2149679073.8783,1539740816460760804.5854,9931,2.9841,0.0035,0.0047
19253,89928,70675,8751,2147448163.1179,1529687012819653320.0681,70676,19.3635,0.0042,0.0025
25953,109028,83075,7048,2147924672.7065,1522482899187966269.6191,83076,11.4744,0.0028,0.0033
12675,35403,22728,24748,2135445614.588,1524284152998521029.6992,22729,6.9586,0.0072,0.0019
1003,19479,18476,2559,2152043956.1129,1527182166569501153.8697,18477,11.4283,0.0024,0.0046
32642,94241,61599,3412,2150039281.0647,1530039758003413456.5021,61600,18.1813,0.0021,0.0026
19101,29365,10264,25871,2160306842.0357,1550265753909278221.8664,10265,15.7958,0.0025,0.0099
24572,84089,59517,25957,2159893074.6,1540050551437918793.1975,59518,10.997,0.0002,0.0055
481,70706,70225,10399,2156860062.9439,1532033472944616771.8204,70226,7.5936,0.0001,0.0046
13063,15261,2198,16404,2208699175.6453,1510020926878766048.7018,2199,14.6798,0.0006,0.0282
3586,23331,19745,22624,2148325606.8923,1539106942807506631.2142,19746,3.8425,0.002,0.0026
19341,118707,99366,13592,2145707472.3317,1538675169134370903.5029,99367,0.7343,0.0012,0.0006
28979,127162,98183,31754,2151339193.3035,1532025930707863780.7975,98184,9.9617,0.0015,0.0026
21081,33399,12318,4414,2160871269.876,1518115533984825085.6896,12319,13.2234,0.0016,0.0082
10486,108535,98049,30943,2145335761.506,1535921841585783718.3441,98050,7.5547,0.0024,0.0015
17119,68718,51599,29543,2143434392.6398,1532875918994242236.9458,51600,6.5128,0.003,0.0009
14777,23140,8363,23556,2098455913.7219,1544643563513478094.5939,8364,19.2541,0.0188,0.0012
12876,55818,42942,21473,2145317506.6737,1551788207951935306.8463,42943,12.8201,0.0039,0.0025
3654,84853,81199,27774,2136478068.795,1542888461543904977.7053,81200,21.7263,0.0053,0.000
424,59296,58872,26806,2151740400.6285,1543300048658472359.1586,58873,7.0602,0.0009,0.0031
13280,59744,46464,1719,2155781355.3432,1537470682260601207.5563,46465,13.0196,0.0006,0.0052
13125,92541,79416,7572,2147395547.8527,1534193886119814433.2193,79417,10.6787,0.0013,0.0017
884,55321,54437,28161,2142172920.7276,1537021811220152853.0968,54438,19.2435,0.0052,0.0016
24163,78687,54524,22642,2138239778.2764,1526684227815976481.1732,54525,11.0355,0.0051,0.0014
18069,115262,97193,1661,2147344766.5491,1532936253779859473.5877,97194,19.463,0.0033,0.0023
7296,99375,92079,29867,2145559156.7278,1543661521321716580.8992,92080,9.3014,0.0024,0.0016
19576,73864,54288,6032,2153142257.4195,1539857347659308752.4009,54289,6.3935,0.0006,0.0037
11748,85720,73972,12002,2161601140.352,1534940670836212905.1958,73973,13.3043,0.0003,0.0065
7465,45017,37552,10903,2153288254.7456,1546226555718886050.5535,37553,3.9375,0.0007,0.0042
31004,57752,26748,30981,2144138398.7594,1530631932279354591.0234,26749,3.8326,0.0051,0.0024
28943,121711,92768,22521,2150304529.2221,1521070538104261514.8387,92769,29.3342,0.0027,0.0041
20650,85966,65316,1287,2140391888.2287,1538387343470660389.1144,65317,8.7192,0.0046,0.0006
12666,63593,50927,7653,2152095269.8091,1538039660243833104.0344,50928,10.5063,0.0008,0.0026
30867,128673,97806,11390,2150551913.1885,1529704900589917722.5923,97807,13.1935,0.0013,0.0029
13887,80749,66862,9829,2148723525.8135,1534788393397305742.5752,66863,0.9081,0.0011,0.0015
22743,93008,70265,23444,2146632348.4835,1537601431378060776.5985,70266,1.2902,0.0015,0.0009
32140,36150,4010,20132,2139527346.9127,1516757578620710363.8074,4011,7.825,0.0083,0.007
8499,65166,56667,19942,2147058185.5618,1538289549155536335.5365,56668,3.268,0.0021,0.0014
2302,32161,29859,14448,2135052342.9743,1531909264323977141.62,29860,6.4803,0.0056,0.000
1245,72698,71453,5811,2155595387.9923,1542953961719506315.4752,71454,7.759,0.0003,0.0043
25357,90735,65378,6127,2162574194.2153,1536191863947348806.1611,65379,16.4013,0.0001,0.0058
8178,53422,45244,6338,2147510479.4139,1532489271074683951.8308,45245,4.0377,0.0017,0.0021
15525,21439,5914,6405,2152417751.3949,1526193094917629392.1947,5915,20.1089,0.0062,0.0102
22894,87226,64332,3274,2137091803.4745,1531790521219856297.1766,64333,11.0151,0.0045,0.0003
29726,125524,95798,4405,2144109111.8549,1541520391295090961.7608,95799,12.9711,0.0026,0.001
26961,104868,77907,29860,2150373477.5782,1537518752183017705.4621,77908,5.1139,0.0007,0.0023
1919,74801,72882,20017,2146289874.2884,1533124541384207143.0504,72883,10.3466,0.0017,0.0016
17839,40444,22605,2538,2153245272.3633,1531254635095540976.9337,22606,8.2477,0.0024,0.0049
10922,85652,74730,11092,2157566142.3487,1534972447668588105.2029,74731,16.8586,0.0002,0.0051
24085,112248,88163,248,2153313329.815,1536216928676485620.3703,88164,6.4425,0.0001,0.0031
24515,76823,52308,21818,2129393148.8808,1542153981480613281.722,52309,17.9685,0.0068,0.000
3680,20721,17041,619,2142418693.8436,1520529917706310599.1036,17042,13.4109,0.0074,0.0053
31295,88792,57497,23848,2141338105.3668,1543683453172630462.5278,57498,11.5244,0.0041,0.0008
4620,100615,95995,9223,2146594173.0371,1531028170166852191.3016,95996,15.0382,0.0022,0.0022
4445,49100,44655,13218,2140051925.6949,1525127068591240310.8727,44656,16.5936,0.0054,0.0026
8384,75150,66766,19466,2147058779.1171,1533048022133842972.9333,66767,9.0303,0.0022,0.0024
30484,45606,15122,29827,2176446697.7844,1520659822778652061.6433,15123,15.7874,0.0007,0.0125
3335,76504,73169,6827,2146277486.6522,1540413175531396669.2356,73170,5.9158,0.0019,0.0014
30842,73961,43119,17322,2157455809.8273,1537326867073432990.8338,43120,10.1816,0.0001,0.0045
5944,54202,48258,32317,2143744189.0029,1536595641705007496.1726,48259,9.4612,0.0035,0.0011
30430,67017,36587,4414,2148829728.5845,1541265654722526709.0102,36588,15.3665,0.0047,0.0034
18656,72718,54062,11260,2151572155.8296,1549428664503190826.6551,54063,3.7307,0.002,0.0039
27564,72449,44885,3894,2149644158.4647,1541110613617777826.8096,44886,4.5186,0.0019,0.0023
26766,65102,38336,3331,2145128667.4588,1538064105713029984.7549,38337,3.1086,0.0021,0.0012
3057,81031,77974,8146,2131296343.8247,1540778948270576251.5852,77975,24.0239,0.0062,0.0006
14979,62500,47521,11770,2150168999.4068,1529272966760978385.6206,47522,6.7065,0.0021,0.0031
7819,90608,82789,28358,2150292571.1429,1530524969287744076.3961,82790,12.932,0.0019,0.0035
15346,87694,72348,13638,2137453914.9513,1538430713670076158.4414,72349,12.1322,0.0049,0.0004
17296,49486,32190,29168,2139216926.3112,1532059575893404635.2009,32191,6.3744,0.005,0.0007
27293,106919,79626,3294,2147408910.8483,1538629649834354849.9042,79627,7.1512,0.0015,0.0013
6874,72902,66028,2757,2147175090.5112,1535346872110877771.6946,66029,17.6977,0.002,0.003
13176,80398,67222,18644,2146971454.8201,1535177931460764136.0677,67223,2.7159,0.0018,0.0012
8244,88398,80154,27095,2142856045.2603,1536587789401187220.9438,80155,7.9582,0.003,0.0006
30672,87462,56790,18158,2153871551.534,1532113451076064501.6847,56791,10.1285,0.0001,0.0031
2754,48779,46025,8606,2149344133.1992,1539391768104400863.987,46026,14.3369,0.0046,0.0026
23571,33548,9977,5292,2159001934.9656,1537303735104540486.3717,9978,4.8241,0.0009,0.0082
1208,67356,66148,9451,2144543760.2082,1531089241806592016.223,66149,4.8258,0.0025,0.0011
27797,82745,54948,25044,2158051701.7913,1544129224233175712.5766,54949,13.1912,0.0012,0.0064
32466,70056,37590,19563,2158175128.454,1532554153179533798.4558,37591,9.7907,0.0006,0.0045
11580,50877,39297,6633,2141419822.299,1537285334748550741.9044,39298,12.828,0.0065,0.0009
13762,62483,48721,30855,2158212326.7315,1543828077522731212.4563,48722,11.1375,0.000,0.0045
11193,83695,72502,13252,2154783568.2463,1539216823272613566.5971,72503,5.6458,0.0004,0.0036
15940,95589,79649,12199,2152417133.1091,1528238668306268676.1867,79650,9.943,0.0015,0.003
13372,111574,98202,5523,2150121741.4972,1528226969799553523.7036,98203,10.7311,0.0012,0.0027
8080,45153,37073,23710,2148209217.8613,1544200188738709728.0147,37074,5.9496,0.0024,0.0027
25942,89920,63978,6523,2158855537.0699,1521268328109984663.725,63979,21.4887,0.0013,0.007
8590,49072,40482,9115,2152850399.8397,1537358547549085210.1805,40483,12.8853,0.0012,0.0039
18152,112335,94183,29301,2149810681.8054,1529615516957688096.6387,94184,18.5156,0.0016,0.0028
11601,61987,50386,20097,2139994405.0606,1547539954821291214.6611,50387,11.4014,0.0045,0.0012
15009,23112,8103,27256,2161468668.2009,1551727929772831037.1645,8104,7.3511,0.0034,0.0119
11179,93002,81823,16309,2136592887.3436,1548735487923924698.1809,81824,26.9613,0.0062,0.001
14442,94234,79792,23602,2151687111.5811,1533390376442674940.9105,79793,8.2167,0.0015,0.0031
11006,77932,66926,11261,2151921840.1194,1533088325506897029.3244,66927,10.0432,0.0004,0.0027
16919,55080,38161,7410,2165452087.2817,1530075067805222498.5664,38162,26.0309,0.0002,0.0075
3603,66052,62449,18196,2142482296.3698,1526034733550929231.1309,62450,11.5295,0.0045,0.0018
8487,55577,47090,24995,2149517631.6109,1551103433415809893.5985,47091,19.7195,0.0027,0.0033
24935,89554,64619,20447,2140279059.7521,1538885638983176632.0635,64620,8.3973,0.0039,0.0003
24349,44962,20613,4852,2135386734.9002,1523523167612953957.995,20614,10.2582,0.0072,0.0013
9012,12055,3043,28493,2152870310.0572,1540388301003183994.4074,3044,18.2266,0.0082,0.016
24688,36215,11527,8298,2161094554.8088,1523855626552473102.7452,11528,7.0207,0.0031,0.0079
22965,107202,84237,22535,2145025719.0592,1537530288305330011.6529,84238,16.5328,0.004,0.0012
29864,59118,29254,5510,2144634745.816,1530716725171376716.6309,29255,7.5374,0.0034,0.0022
24681,76263,51582,23416,2163038268.117,1537792347471250235.8842,51583,12.1873,0.000,0.0075
22255,83209,60954,9008,2153509949.8756,1534287587799386233.4254,60955,6.4153,0.0007,0.0042
201,66504,66303,21573,2154429259.5463,1538319379215234580.2787,66304,10.7711,0.0002,0.0038
21983,115847,93864,25351,2159612868.5494,1541592463396176239.5261,93865,27.3336,0.0008,0.0066
2314,40209,37895,15755,2152561774.6104,1529672629090339009.888,37896,3.6298,0.0016,0.0036
7255,83306,76051,16222,2151927965.5295,1530937758238813343.5468,76052,15.6771,0.0016,0.0036
22110,55539,33429,25500,2158207206.2949,1516875302588981892.5168,33430,20.1203,0.0017,0.0073
16328,64524,48196,4040,2136629942.6364,1539192170058588765.7686,48197,10.1753,0.0048,0.0001
14981,65083,50102,10746,2135425382.9403,1534030919941094439.1421,50103,13.5455,0.0063,0.0009
32310,68184,35874,22682,2145492934.6297,1541220500158772687.6166,35875,4.2974,0.0025,0.0018
5952,80869,74917,11300,2142273629.9375,1532166839530645607.9694,74918,11.3337,0.0041,0.0016
9697,23774,14077,2383,2137713228.3336,1527627331867984279.9812,14078,4.8984,0.008,0.0015
23185,26746,3561,13423,2158674801.5079,1523292161071753689.8805,3562,2.3348,0.0049,0.0111
16267,47599,31332,31827,2148539737.0612,1538244600656493342.8865,31333,4.1619,0.0016,0.0026
24924,66164,41240,15057,2154608685.4669,1538483713282846133.6727,41241,7.7331,0.0007,0.0044
19249,90332,71083,10095,2138777277.3687,1540135351162966093.2075,71084,8.7544,0.0045,0.0003
7405,90724,83319,13923,2143911010.6074,1542977555666524586.9769,83320,6.2905,0.0027,0.0007
31639,46502,14863,14808,2154393546.4042,1526352604709855581.3442,14864,5.7264,0.003,0.0068
14794,103873,89079,18856,2147305789.7042,1543492352942145597.6278,89080,2.6641,0.0015,0.0019
25009,91066,66057,26780,2142937282.0756,1532645503496054600.1492,66058,15.2917,0.0036,0.001
9097,60293,51196,9896,2156947202.7263,1536403475852141941.0449,51197,6.9359,0.0005,0.0054
7696,107152,99456,366,2141673942.0598,1537102566983609761.2316,99457,5.6183,0.0028,0.000
14502,71992,57490,19753,2148981379.6882,1525899708909996546.7226,57491,4.8766,0.0028,0.0026
25944,79385,53441,14877,2145869845.7492,1536136044344484071.3881,53442,12.5515,0.003,0.0024
7043,39762,32719,27393,2142403598.0291,1541806727301193643.2053,32720,4.4123,0.0042,0.0011
21101,62933,41832,19266,2140028862.4413,1537399016170520527.2336,41833,7.7491,0.0041,0.001
7884,103373,95489,5586,2159513510.6357,1533185734087324028.9452,95490,21.5439,0.000,0.0045
24135,120500,96365,10852,2143887606.7655,1543406469878631592.6878,96366,5.4554,0.0027,0.001
13512,77847,64335,22031,2142403071.1941,1524589822845537155.0045,64336,10.1271,0.0048,0.0018
11029,74867,63838,5982,2144473134.1034,1533595364885494326.818,63839,3.9849,0.0021,0.0015
30776,101295,70519,28291,2154788537.8621,1543425568862575882.5915,70520,10.6354,0.0005,0.0051
13521,69191,55670,11755,2151998456.2983,1535726093300452338.452,55671,11.2565,0.0009,0.003
16594,56590,39996,28556,2155973668.8596,1546998818375550830.8624,39997,16.9914,0.0007,0.0054
11304,105330,94026,7252,2136694830.3162,1529074055065804130.273,94027,15.0754,0.0049,0.0004
2575,25822,23247,14408,2158069274.1332,1550600754093592683.2985,23248,8.8814,0.0018,0.0067
9980,106650,96670,5335,2156540821.6242,1543512794293015153.244,96671,8.0237,0.0002,0.0039
25480,122416,96936,11397,2146719361.7562,1536753711838125241.2408,96937,2.3463,0.001,0.0008
167,65298,65131,10948,2134681871.8649,1524544908493746125.3508,65132,18.953,0.0058,0.0005
29867,47473,17606,23677,2151884090.8145,1547433357626008708.5474,17607,7.0641,0.0028,0.0053
19820,55072,35252,7971,2154126977.6816,1537074754672979688.6562,35253,5.1023,0.0013,0.0037
20989,109880,88891,23223,2136631661.9756,1540243832891058479.3969,88892,15.1939,0.0057,0.0001
23236,68246,45010,7754,2164255644.5387,1539572128078443111.5969,45011,19.5871,0.0001,0.0074
21992,109257,87265,16781,2146338882.7392,1535883154871755692.4546,87266,1.5235,0.0019,0.0018
11842,79665,67823,6944,2151453336.7446,1533527135550495324.8226,67824,5.3201,0.0008,0.0022
867,50342,49475,11580,2154527483.9067,1544132691920366058.2332,49476,6.8073,0.0015,0.0045
2496,10009,7513,27754,2169359658.9442,1492411651220153197.2565,7514,24.7216,0.0055,0.0145
25670,58881,33211,25349,2135723329.8059,1528763265994740413.0749,33212,11.8008,0.0064,0.0016
13161,96413,83252,29286,2142718990.4244,1528024637536746387.6407,83253,9.5252,0.0041,0.0016
19322,73118,53796,32737,2134193418.0509,1536272236506028444.5356,53797,12.2248,0.0053,0.0004
26110,65613,39503,19165,2160874097.4789,1524524113360156688.0057,39504,21.9716,0.0006,0.0064
7162,24883,17721,4096,2159598412.6534,1526931326876001969.0229,17722,20.9397,0.0011,0.0066
18317,20617,2300,21252,2093043234.0952,1529476787395845595.8532,2301,24.4693,0.0237,0.0007
32619,124452,91833,640,2145407008.5983,1533280562661796986.5625,91834,6.7524,0.0025,0.0012
30336,122092,91756,6225,2154811058.5714,1541199358174320604.8181,91757,11.4761,0.0001,0.0041
16459,95139,78680,11783,2154560847.1112,1535833048447141980.642,78681,6.7574,0.0008,0.0034
6570,104306,97736,12586,2153884039.7627,1541547503611509974.4211,97737,5.0794,0.0001,0.0027
29276,119261,89985,14107,2143378247.1152,1540687179867355298.8684,89986,8.0428,0.0029,0.001
29311,83280,53969,16437,2140288519.9398,1537359873991650880.2073,53970,6.0229,0.0034,0.0005
1374,15977,14603,14987,2168964552.6739,1543259547142142207.1392,14604,7.6818,0.0013,0.0084
18760,36339,17579,19886,2142536515.0113,1524834558871080483.0965,17580,6.0121,0.0056,0.0021
32461,59875,27414,25128,2144799840.6585,1543910745191431547.635,27415,6.2753,0.0037,0.0023
21576,113131,91555,6744,2155657884.4612,1527023842697396336.9878,91556,21.4135,0.0007,0.0041
11772,53289,41517,21405,2154107744.1019,1545251032471949262.7476,41518,10.2716,0.0012,0.0046
10506,53467,42961,4270,2149364373.2087,1542866407315582708.8628,42962,6.1612,0.0022,0.0032
14010,42559,28549,6750,2133673903.869,1535135444521353375.8365,28550,10.5269,0.0083,0.0004
25004,73491,48487,4826,2145903959.3759,1549855538779927888.3164,48488,7.8007,0.0029,0.0027
29429,95183,65754,1151,2156949697.1928,1535620680458376192.3048,65755,21.0919,0.0002,0.0041
27036,125865,98829,13193,2149798415.6439,1544141502569369132.6764,98830,12.3406,0.0015,0.0026
2563,13644,11081,7795,2164010371.726,1535780953428560293.7496,11082,3.678,0.0006,0.0071
24113,47889,23776,4148,2134694123.9852,1536057142960654407.12,23777,9.4604,0.007,0.001
28315,116086,87771,10985,2147423203.6209,1541054797028949868.532,87772,5.4069,0.0012,0.0016
23259,78052,54793,3218,2150620177.4655,1535026363841227827.5706,54794,8.1597,0.0018,0.0038
29358,61232,31874,20538,2162580994.7814,1539415567834565748.766,31875,8.1725,0.0003,0.007
14948,21167,6219,12337,2154283616.8698,1547895164890243556.0496,6220,6.9191,0.0062,0.0072
5266,24498,19232,21504,2164350771.5653,1549592297795878955.5767,19233,12.8571,0.0005,0.0083
31901,130152,98251,243,2147082125.1845,1527388390217623878.2442,98252,9.683,0.0025,0.0023
1797,56285,54488,9952,2156428377.6198,1543962206003844128.9176,54489,9.7677,0.0009,0.0061
4639,62645,58006,27253,2147273614.1503,1535266343676109337.0484,58007,12.6383,0.0027,0.0034
22940,39799,16859,28346,2145852839.0312,1533629774893257930.8402,16860,3.1737,0.0035,0.0026
19108,31495,12387,6839,2164466814.3331,1565711619113909558.1934,12388,10.4313,0.0035,0.0099
16545,23848,7303,21880,2122771868.0411,1532421843650644004.1763,7304,3.8956,0.011,0.0011
30111,126827,96716,26185,2149823685.7089,1535934659496007610.142,96717,5.0084,0.0009,0.0025
5368,80314,74946,17718,2147001691.9132,1533770232517077966.111,74947,7.8075,0.0022,0.0021
7943,57783,49840,13808,2147941054.8274,1518429498711017977.749,49841,14.315,0.004,0.0042
31502,131189,99687,11024,2157641502.5277,1532321265962026415.3561,99688,16.448,0.0002,0.0057
19224,67631,48407,14200,2155209558.7444,1539418034254289071.4996,48408,9.2933,0.0007,0.0041
21144,90439,69295,21878,2138060483.4898,1549007264311819383.3088,69296,23.0469,0.0049,0.0004
28157,80373,52216,12184,2154782603.3466,1541196998378959714.1381,52217,8.5267,0.0001,0.0043
24144,29038,4894,2122,2137179786.484,1509903245801760388.4561,4895,8.3376,0.0112,0.0059
24742,73994,49252,21670,2161434166.2664,1544376803399579633.2169,49253,14.607,0.0007,0.0066
13193,107737,94544,4159,2150993073.5859,1542289446037843286.8719,94545,5.0708,0.0004,0.0025
30444,51541,21097,20427,2145133641.0749,1522249118499710989.9829,21098,3.0011,0.0053,0.0034
25067,102151,77084,26456,2143250470.7555,1539316264604913116.0095,77085,3.3858,0.0024,0.0002
4496,50930,46434,16892,2151897766.2399,1524942288434596946.5078,46435,5.4957,0.0024,0.0038
11541,55264,43723,27419,2155074515.0484,1540388145727740701.521,43724,7.9123,0.0008,0.0039
5090,28869,23779,12226,2138172034.3865,1544597315519818230.858,23780,10.179,0.0058,0.0007
7340,104842,97502,2917,2142397185.3069,1525495371014545739.8485,97503,12.8862,0.0037,0.0012
27298,28671,1373,23553,2165403072.941,1554170696753364981.8299,1374,15.4207,0.0128,0.0314
28227,92811,64584,9457,2147600172.3354,1526678039890614254.834,64585,5.063,0.0027,0.0027
7118,18932,11814,17058,2147443670.5665,1538279152975160541.0102,11815,9.7616,0.0045,0.0054
28108,36003,7895,4351,2149501637.9012,1545471843347471486.0546,7896,11.7646,0.0058,0.011
11089,94117,83028,12247,2147505625.1463,1536375104630860982.9162,83029,4.9764,0.0017,0.0018
8043,71014,62971,1561,2151742787.9185,1534872803446199337.6985,62972,3.6229,0.0006,0.0029
8927,103276,94349,10106,2152620349.5649,1539524132829185766.1624,94350,6.2662,0.0002,0.0034
25911,125617,99706,11266,2162175414.287,1540317279631623165.0817,99707,14.5392,0.000,0.0051
24608,98221,73613,2597,2143105698.6041,1544319213228265072.1385,73614,20.0383,0.0041,0.0026
11207,31876,20669,15362,2172924179.6976,1554381224907580391.3572,20670,22.1977,0.001,0.0146
24758,110340,85582,31467,2146664768.1484,1537329434180739737.4201,85583,6.9325,0.0015,0.0015
11900,106586,94686,6151,2137481323.8486,1537619483666839487.5915,94687,8.0408,0.0045,0.0003
18564,36360,17796,2489,2161713415.8521,1531635590379632697.2392,17797,12.0664,0.0006,0.0069
7855,22594,14739,10054,2154283992.0292,1526415664567171246.4248,14740,10.8577,0.0032,0.0062
14999,102291,87292,19444,2141578885.1073,1540578985901417429.0296,87293,6.2906,0.0035,0.0003
17958,23716,5758,14884,2156726513.8998,1548378342063563747.5071,5759,2.8849,0.0031,0.0079
17166,89891,72725,7326,2143457227.6474,1543917365709213912.1309,72726,8.4309,0.0033,0.0012
1329,37918,36589,3664,2142388066.1076,1530234376476706523.4391,36590,7.7333,0.0048,0.0016
1048,89998,88950,26237,2142073979.6097,1532843800816677550.039,88951,15.084,0.0034,0.0008
30081,89984,59903,8529,2156205493.0385,1544175893395519541.6096,59904,13.3371,0.0004,0.0046
28080,116351,88271,7228,2154607452.2482,1533434861638578008.9042,88272,11.6326,0.0001,0.0031
23394,57612,34218,10099,2143110104.0606,1531311464621837575.7365,34219,8.662,0.0041,0.0013
3334,9204,5870,24389,2158660301.3977,1549504866495560970.0518,5871,2.1388,0.0026,0.0115
21992,78152,56160,13837,2156769410.8395,1532873132387023710.5564,56161,6.647,0.0005,0.0043
14389,113010,98621,20264,2150559326.9629,1530667623984262636.5123,98622,9.672,0.0011,0.0024
5951,34439,28488,23537,2142809708.9583,1523046531367565588.8525,28489,9.706,0.0044,0.0026
21092,55456,34364,26930,2141646253.7662,1553313313536441781.9554,34365,10.1635,0.0048,0.0023
3123,50907,47784,4265,2163124437.2874,1545256588408818391.0136,47785,14.9536,0.0005,0.0071
2028,77500,75472,22066,2148488407.4352,1540493008117702288.4047,75473,12.6104,0.0028,0.002
6853,85165,78312,11399,2145412785.1077,1537388055507787099.4603,78313,12.7269,0.0028,0.0015
30919,84014,53095,29450,2143689345.0341,1525407541658598404.4997,53096,12.5508,0.0034,0.0015
25889,62141,36252,40,2154212944.3851,1527248889794078785.3847,36253,11.2148,0.0019,0.0042
6276,80737,74461,13773,2142149100.2936,1538041702716206718.8453,74462,5.8007,0.0028,0.000
23377,46083,22706,22873,2161142165.5914,1541809763289144725.0731,22707,18.4376,0.0007,0.0109
15133,54483,39350,10718,2154176308.3615,1530589629401616327.3822,39351,8.2976,0.0013,0.0041
713,61020,60307,6877,2142042521.945,1536491505484863982.9395,60308,12.4692,0.0039,0.0012
19171,79810,60639,23564,2156152456.6641,1534913487253465470.5803,60640,7.1671,0.0001,0.0049
18274,34904,16630,5698,2151340571.2503,1542159230850691578.6898,16631,3.742,0.0028,0.0065
30398,46850,16452,30435,2138182602.9051,1553884246538544516.5622,16453,11.0969,0.0089,0.0028
25253,91407,66154,24886,2146258062.6903,1531115470055099289.7487,66155,5.9874,0.0025,0.0017
23834,54194,30360,4027,2155565910.1069,1551723461982222420.8921,30361,10.5418,0.0018,0.006
6224,59786,53562,23223,2137984441.2845,1533942788454021099.4033,53563,8.4584,0.0054,0.0008
26951,51635,24684,2872,2150350744.6743,1555842519368561306.9054,24685,8.3683,0.0042,0.005
20862,71542,50680,29290,2160231734.5559,1532142827656780679.431,50681,10.1741,0.0001,0.0056
20509,67255,46746,23316,2148786826.273,1528358315404401340.2621,46747,4.900,0.0018,0.0026
21493,87998,66505,13903,2145177554.2987,1541301957359096584.4335,66506,3.701,0.0023,0.0013
13166,41114,27948,20066,2148260366.912,1559362003328308414.239,27949,10.4496,0.0032,0.0062
11304,90854,79550,19576,2134563158.5851,1538991151794888512.676,79551,18.3175,0.007,0.0002
8472,106462,97990,26511,2147440677.3702,1534618924647930410.3512,97991,3.3149,0.0014,0.0013
6399,54743,48344,27039,2156027654.1922,1547608189037172927.3723,48345,12.9272,0.0011,0.0052
2629,67421,64792,4059,2154421951.4727,1539239359199315458.539,64793,4.911,0.0002,0.0035
17300,48592,31292,19733,2155868792.5299,1530734068663559502.6999,31293,8.9064,0.0008,0.0047
16819,48957,32138,9778,2145830124.2935,1536387063547883715.6781,32139,5.7092,0.0029,0.0016
22218,57817,35599,3733,2133703486.6434,1518529041399883794.2137,35600,21.4805,0.0074,0.0021
1241,37222,35981,28215,2142916373.6649,1540084259441122050.2596,35982,5.1995,0.0044,0.0012
32165,64642,32477,32487,2122968144.3345,1552014572139657600.4709,32478,45.6299,0.0088,0.000
20158,39459,19301,30625,2156744358.5764,1535845183669509811.9689,19302,8.3313,0.001,0.0057
17431,69280,51849,30078,2160438146.3538,1535843788393416585.7577,51850,14.7418,0.0002,0.0049
18872,67579,48707,7043,2145604893.3026,1541864971917212946.923,48708,6.5049,0.0033,0.0019
4338,86575,82237,7965,2154609700.038,1537059646508403678.3181,82238,7.6584,0.0001,0.0026
28597,82278,53681,7812,2138524175.7267,1543223731134952860.0984,53682,9.9616,0.0049,0.0011
4302,100227,95925,5205,2145174722.0049,1532972509018440609.334,95926,10.7805,0.0024,0.0013
160,76313,76153,12350,2147014894.5885,1535753373413852271.9824,76154,2.8154,0.0023,0.0019
32303,37414,5111,849,2144253369.716,1554791205228980378.0187,5112,3.6524,0.0058,0.0043
5677,31338,25661,9046,2153107482.626,1536492758408279975.6358,25662,8.5867,0.0011,0.0043
5996,45221,39225,23842,2148328620.6857,1536710570494437399.6003,39226,4.1893,0.0012,0.002
1893,69175,67282,10228,2141970026.1769,1537053352337785401.3931,67283,4.7023,0.0025,0.0001
21003,63204,42201,29185,2146678158.345,1540391458908617567.8208,42202,4.3597,0.0018,0.0014
30764,72924,42160,17295,2136884877.3359,1533179280093655151.9011,42161,11.6485,0.0071,0.0011
15352,74924,59572,24927,2138542666.1727,1540161812134706093.5987,59573,17.4296,0.0047,0.001
29040,42765,13725,8799,2121526689.8654,1530045821426971133.4264,13726,11.5739,0.0117,0.0007
12461,28796,16335,27911,2143975495.3472,1544855612263208013.972,16336,3.6121,0.0038,0.0026
7486,54019,46533,4274,2158015986.0868,1544375920932198305.1971,46534,10.077,0.001,0.0055
14752,107068,92316,3114,2140410170.1014,1540934772467694578.3841,92317,8.6297,0.0031,0.0006
29941,38604,8663,19814,2159967766.4086,1532332748897625510.8871,8664,5.2424,0.0017,0.0068
10764,88264,77500,9344,2155971346.4892,1531374397131465075.2989,77501,17.8699,0.0014,0.0057
4252,23104,18852,18277,2164581274.9781,1547632778763786665.0331,18853,9.3419,0.0001,0.0075
26213,98012,71799,4565,2145789603.1457,1533826595953446689.5636,71800,15.1572,0.0029,0.0031
25552,108962,83410,4345,2146489406.9552,1536349098933989928.243,83411,3.930,0.0021,0.0011
6884,71730,64846,7229,2142426752.4607,1541312173150718240.5388,64847,22.035,0.0032,0.0004
14473,88684,74211,28690,2149167221.2891,1540139398721537643.7494,74212,7.7535,0.0016,0.0034
2787,73745,70958,5289,2151914272.2092,1540857463076099892.3761,70959,4.7845,0.0004,0.0029
5367,82339,76972,7145,2144479944.9742,1540266416678305376.5521,76973,5.9252,0.0031,0.0012
2324,101980,99656,18664,2149556908.517,1535436875505177894.5947,99657,2.5143,0.0009,0.0014
9014,101252,92238,28704,2152578129.7319,1526687967849845726.0354,92239,11.9854,0.0009,0.0037
3879,35472,31593,27226,2141898929.0067,1531502559373164331.9502,31594,20.701,0.0075,0.0035
23982,71881,47899,31331,2142180467.9999,1534250647943813336.4036,47900,8.2485,0.0037,0.0003
13300,83388,70088,31610,2144438107.6553,1537552360824897911.4354,70089,9.5471,0.0029,0.0009
23567,121724,98157,6373,2151209284.8651,1526546873971558108.1562,98158,11.379,0.0016,0.003
12501,77841,65340,16108,2139290287.461,1534745613756922057.0845,65341,11.0295,0.0043,0.0009
12889,44437,31548,10125,2146750149.2764,1531972650681367319.4915,31549,5.3587,0.003,0.0039
17713,73888,56175,25543,2158211517.692,1540199768719695306.4467,56176,5.7992,0.0001,0.0047
30356,96319,65963,9114,2143557213.3034,1523926754901243621.7994,65964,14.8511,0.0036,0.0015
6064,98726,92662,19578,2142579089.5502,1538764982427373059.7189,92663,5.659,0.0026,0.0006
12647,95422,82775,7276,2140861641.7242,1536304002900688290.3043,82776,6.0482,0.0039,0.0002
13395,46456,33061,24662,2154557490.7718,1535302615177320424.7774,33062,6.0936,0.0018,0.0036
26185,100457,74272,27904,2151706044.2008,1537254720767084274.6146,74273,4.9261,0.0006,0.0029
14616,57360,42744,3318,2141652552.4421,1545907904753709763.1007,42745,4.6378,0.0041,0.0011
6502,20792,14290,20124,2135031123.8258,1508291562912080337.4342,14291,10.0204,0.0098,0.0033
9922,24194,14272,19679,2129402076.5487,1552137110088769677.5669,14273,16.1781,0.0097,0.002
2912,5073,2161,2532,2147778888.7137,1521468093850839584.9342,2162,1.8694,0.0134,0.0116
9519,93583,84064,29275,2142708776.679,1538120977190378223.7218,84065,4.1302,0.0025,0.0002
22853,59027,36174,28883,2165077496.6463,1550724380493717979.2592,36175,13.3673,0.0006,0.010
23157,78192,55035,24338,2145194494.3966,1532927759266117858.4884,55036,11.3077,0.0025,0.0021
22381,107559,85178,28983,2155896042.4587,1533766274901396981.7667,85179,10.5657,0.0003,0.0046
32267,34956,2689,13482,2128567254.5558,1543121708943656436.2387,2690,27.7632,0.0151,0.0076
24635,117156,92521,29805,2138673066.6694,1532452371443007938.6166,92522,9.6676,0.0051,0.0004
31120,105733,74613,4820,2144773804.8886,1537297761566792938.8891,74614,9.0161,0.0029,0.0011
31465,96628,65163,32296,2142324862.4308,1529155953852587905.1458,65164,7.4284,0.005,0.001
14169,100429,86260,30806,2147678943.4282,1548215693465882691.5936,86261,23.9948,0.0032,0.0029
10300,75586,65286,22336,2143211199.9104,1534018225184499688.6471,65287,4.5149,0.0033,0.0006
32332,41553,9221,27937,2155054795.3911,1529574027104399280.1687,9222,8.5183,0.0054,0.0072
17740,17978,238,16773,2038849121.5983,1487913742509158642.2822,239,6.1139,0.0549,0.0041
18004,91655,73651,728,2149281345.395,1523449936923610236.9477,73652,11.3305,0.0029,0.0035
20691,46309,25618,27663,2163751193.9643,1534424683351101681.4418,25619,11.2558,0.0002,0.0081
28417,119475,91058,30435,2144722617.82,1544522698780327975.2165,91059,11.6767,0.0032,0.002
2997,12624,9627,29098,2168394456.0758,1563787862786779283.7431,9628,9.1373,0.002,0.0123
8399,33467,25068,18605,2130964219.7473,1543070774307333154.3931,25069,21.3682,0.0061,0.000
30058,118937,88879,16470,2139863546.7374,1546266775891485480.5153,88880,9.3206,0.004,0.0013
10566,52133,41567,25854,2158959345.8341,1529791178532372198.6819,41568,12.9524,0.0007,0.0061
1122,19964,18842,24895,2124491464.4355,1534940733903035722.147,18843,10.5922,0.0092,0.0001
17254,70350,53096,4814,2139042149.8691,1543555209505444564.1908,53097,5.8246,0.0037,0.0012
13708,108739,95031,20933,2146551060.1814,1528159499273441149.4504,95032,14.1149,0.0024,0.0025
31281,61122,29841,20066,2140876648.6035,1534403457552146357.2768,29842,4.6725,0.0036,0.0004
25287,79390,54103,5543,2145051930.491,1537452736858798304.9569,54104,7.5112,0.0026,0.0012
20195,42565,22370,28603,2153653413.506,1517646124454023789.6712,22371,8.8086,0.0042,0.0054
6483,92090,85607,22904,2145954534.3638,1543743113901906240.9477,85608,7.8919,0.0018,0.0013
32760,47559,14799,16617,2161086277.4741,1545711544058076436.165,14800,8.363,0.0001,0.0078
14657,66274,51617,32557,2152669454.384,1538829403106220968.0115,51618,7.3591,0.0008,0.0028
14092,87275,73183,13055,2154927047.6321,1535919798276401225.2347,73184,13.427,0.0005,0.0046
24237,52555,28318,654,2140991665.997,1518974255425873136.9079,28319,8.1942,0.0053,0.0031
26859,123016,96157,21145,2139404120.9983,1535499680204246961.9611,96158,16.2332,0.0038,0.0005
23500,24717,1217,23077,2132924254.9122,1516840125165554467.5563,1218,3.9045,0.0178,0.0093
26866,101735,74869,7872,2150109463.0036,1532592928440954055.3013,74870,13.3871,0.0015,0.0021
9331,83527,74196,14842,2153127592.2734,1530838030360899872.8186,74197,10.5793,0.0008,0.0034
5619,26959,21340,17796,2154274593.2761,1521307409098497245.6342,21341,15.0223,0.0023,0.0052
32683,118312,85629,30375,2149725844.7305,1539812909112548083.3949,85630,3.9705,0.0007,0.0021
29181,104140,74959,18158,2148188054.2599,1535153964554054415.136,74960,8.0659,0.0013,0.0017
27271,110113,82842,25272,2138637256.105,1527538256598918507.0695,82843,25.0143,0.005,0.0007
19886,74752,54866,5774,2162253447.9012,1540219345266989189.0642,54867,17.7537,0.000,0.0083
6078,33646,27568,27482,2134943447.7852,1536663819429510171.6068,27569,10.217,0.0059,0.0011
3070,44383,41313,30615,2143198576.1006,1540823118206446983.4696,41314,11.6758,0.0047,0.0023
8858,46738,37880,32234,2157946953.4636,1541576648639068789.8032,37881,20.0327,0.0011,0.0072
13339,89500,76161,30861,2147798399.5724,1535000774567912130.5485,76162,8.5438,0.0023,0.0022
14681,83321,68640,16870,2146694722.7722,1536446792380617830.3917,68641,4.4522,0.0014,0.0012
3491,16227,12736,7907,2155945217.0304,1539544839752602012.9045,12737,9.780,0.0024,0.010
29908,124430,94522,21881,2139396519.8726,1540186020814080573.7869,94523,15.195,0.0039,0.0003
7952,47192,39240,12644,2160195195.4248,1534143898915880780.3641,39241,15.135,0.0003,0.0058
26227,83060,56833,14353,2147919995.2951,1542614558998603155.56,56834,6.1716,0.002,0.0022
9511,91820,82309,17825,2148973274.0917,1541179752352436168.9211,82310,8.681,0.0016,0.0021
4919,38546,33627,9532,2157228807.3694,1531014521958150238.8674,33628,24.7055,0.003,0.0057
13096,20644,7548,24371,2174784411.5985,1511771190973172997.0791,7549,12.0189,0.0006,0.015
24338,68565,44227,13224,2127557726.7016,1538132569611999299.5129,44228,28.0432,0.0087,0.0004
2119,71080,68961,19185,2153777952.4024,1535367120278425378.3589,68962,11.1067,0.0013,0.0041
12819,55590,42771,7604,2151575526.7326,1529810343554134871.4808,42772,8.9245,0.0014,0.0031
17496,91948,74452,4181,2139791559.6048,1540891636206622592.0457,74453,19.6064,0.0041,0.0004
30299,40320,10021,10599,2136549205.7694,1566292191775094193.568,10022,18.0697,0.0108,0.0052
29700,84996,55296,23715,2143593226.1129,1524196755753523822.6462,55297,11.8939,0.0044,0.0018
4579,65687,61108,1138,2158913127.8359,1539799136053958522.6179,61109,6.3348,0.0002,0.0061
7055,79319,72264,1052,2138769457.7856,1537584395066690706.5033,72265,16.457,0.0053,0.000
27779,84172,56393,26553,2159172211.4799,1532219390642866294.8431,56394,12.0358,0.0001,0.0054
20734,35100,14366,30370,2158511129.8673,1518110324898475902.0406,14367,18.2693,0.0036,0.0079
9386,63020,53634,15065,2152889266.1405,1542013415148326693.1317,53635,8.8927,0.0009,0.0038
8223,90059,81836,9117,2155998722.3785,1537287297614353033.0119,81837,10.8884,0.0004,0.0047
27292,32793,5501,338,2171507502.9257,1543238104220855501.7486,5502,9.8811,0.0021,0.013
27596,87367,59771,15269,2152222642.9158,1544448986762105624.0279,59772,7.2306,0.0014,0.0029
2732,32698,29966,27141,2141429209.7397,1533080588285954198.6167,29967,2.557,0.0047,0.001
2952,89484,86532,16271,2136198313.5625,1534412681314706806.6985,86533,12.3764,0.0045,0.000
32230,80645,48415,20486,2144848498.0962,1550496876792434280.6428,48416,14.2296,0.0043,0.0024
30945,48987,18042,8215,2151014519.943,1546985790786365832.9126,18043,10.7783,0.004,0.0082
29078,118159,89081,25985,2143831789.3947,1534793776174175789.5721,89082,6.252,0.0028,0.0008
16043,103158,87115,32201,2151311792.5406,1527233405603263080.3017,87116,13.2378,0.0017,0.0034
15220,83300,68080,24713,2161988045.1471,1529818205162564025.5593,68081,18.0067,0.0006,0.007
8064,39056,30992,19051,2151416041.9471,1535597386716290180.4331,30993,3.9932,0.002,0.0035
26086,46969,20883,13897,2161682226.1091,1531499819399728142.3969,20884,8.7836,0.0027,0.0072
9966,26378,16412,7172,2157341397.5177,1532264766194786974.6123,16413,5.737,0.0014,0.0063
8836,80602,71766,25969,2144777777.8358,1536361733937686788.6283,71767,4.2838,0.0028,0.0012
1688,60037,58349,6587,2157557008.3276,1533781009542396847.8278,58350,10.6954,0.0001,0.0048
992,54697,53705,17300,2145760324.1734,1531644251856168025.1626,53706,21.6533,0.0054,0.0019
30193,44681,14488,17860,2138870384.2086,1523968764837737887.5891,14489,4.8961,0.0064,0.0029
5658,24687,19029,21003,2150346826.9314,1524075054669223917.8599,19030,7.1242,0.0034,0.0045
2989,37588,34599,23796,2127959592.6325,1548384525558262131.5344,34600,22.2142,0.010,0.0021
21948,23111,1163,27420,2183935336.8333,1534995470111237992.0186,1164,2.5154,0.0049,0.0197
14875,40638,25763,30616,2137329598.1775,1525381337529903736.9262,25764,7.1476,0.0055,0.0004
27324,101015,73691,31704,2144310303.4299,1537456451409102426.0397,73692,3.2172,0.0022,0.0005
16432,84205,67773,21909,2151000422.9997,1531772865167040443.9083,67774,15.4658,0.0015,0.0043
24729,29892,5163,464,2179010730.8943,1554639451777783117.5469,5164,7.7949,0.0017,0.0158
13533,61548,48015,28136,2146302954.5556,1527840125730908203.1929,48016,14.1174,0.0042,0.0029
20072,50296,30224,13947,2140241496.048,1526863644736039035.1768,30225,8.9342,0.0051,0.0015
5219,39399,34180,13222,2157792861.8145,1546542543084988591.0597,34181,12.2518,0.0023,0.0056
31694,85433,53739,22909,2150677328.0849,1533000510839240913.3604,53740,7.5495,0.0011,0.0034
20804,102302,81498,567,2139343121.0058,1537188226530760120.0954,81499,6.6254,0.0038,0.0004
8128,56817,48689,18864,2146810167.5687,1534384415193572730.8876,48690,1.2512,0.0014,0.0013
3059,5711,2652,16991,2108888996.7531,1501670570121403286.2018,2653,10.6819,0.0241,0.0043
18607,68737,50130,13513,2144461948.2347,1548557161513733452.0073,50131,5.7558,0.0033,0.0028
18380,31286,12906,28638,2169013497.7229,1531364856809821647.2802,12907,21.380,0.0008,0.0142
3265,34329,31064,5174,2144937699.9748,1552687877888318881.196,31065,12.9005,0.0045,0.0037
6226,89562,83336,19684,2153344005.7534,1532269553547083688.0048,83337,11.1086,0.0009,0.0039
23277,95004,71727,14701,2154394163.4902,1545264131225037042.7741,71728,12.2936,0.0002,0.0038
27093,119800,92707,16613,2147489485.2457,1543288183611829933.7538,92708,6.0351,0.0017,0.0018
9181,97669,88488,18830,2148607421.6478,1534679862176729259.6861,88489,7.9357,0.001,0.0017
19109,21193,2084,18116,2180066513.7041,1517470971164456139.8237,2085,20.1721,0.0019,0.0164
2947,66285,63338,28775,2140344403.9577,1530473581032861144.2817,63339,18.1687,0.0069,0.0011
10046,34520,24474,1369,2159356392.4775,1541486991681684463.2193,24475,5.9295,0.001,0.0065
19014,31706,12692,1489,2170583724.4783,1524423423239329914.5547,12693,21.1579,0.0012,0.0134
8032,72440,64408,13273,2154530781.612,1536624030050179229.6096,64409,7.1321,0.0005,0.0036
15510,78194,62684,17670,2152052831.6744,1529538442639738018.156,62685,11.0236,0.0009,0.0037
26382,117377,90995,4871,2153035798.5854,1535776909049270010.8083,90996,6.9237,0.0006,0.0043
24458,77777,53319,10561,2154007245.5684,1532103436936804765.1008,53320,10.5772,0.0005,0.0036
8096,18791,10695,4558,2158792262.3691,1541196306217077441.1401,10696,4.0294,0.0019,0.008
7155,26502,19347,15319,2141192468.3154,1534226544212987608.8078,19348,2.1151,0.0045,0.0015
24294,104923,80629,3347,2150642085.2063,1535462649730894472.643,80630,16.8226,0.0027,0.0026
3670,101251,97581,27556,2141510635.3332,1539618176246566232.3219,97582,12.5742,0.0035,0.0004
9546,107008,97462,24097,2150871879.4421,1538791783142474396.6014,97463,4.4509,0.0006,0.0022
9713,16560,6847,13489,2150517525.1075,1553166433894364851.5726,6848,6.8397,0.0052,0.0083
9832,85712,75880,19373,2149770482.5188,1542150174084605832.8634,75881,8.3201,0.0017,0.0024
47,15361,15314,24031,2138469945.8603,1539908742868007606.3048,15315,4.4065,0.0056,0.0016
7896,27343,19447,5531,2129568350.8344,1550347369138379541.7239,19448,13.2812,0.0087,0.0001
6265,69234,62969,28620,2151907163.716,1537615279823345543.5946,62970,8.2157,0.0003,0.0027
31580,79842,48262,6683,2165087624.9921,1529835625201305632.1152,48263,22.0163,0.000,0.0073
15534,62527,46993,6928,2153248217.1744,1541675678852533086.2067,46994,3.2011,0.0006,0.0034
25993,53757,27764,18787,2144557919.2776,1526344225809536571.725,27765,5.5573,0.0048,0.0033
20031,56897,36866,25820,2143816122.822,1544569443145090220.2777,36867,6.6944,0.0044,0.0015
21009,100012,79003,32570,2143006483.7458,1539878627143140978.9349,79004,13.1119,0.0032,0.0016
5605,42745,37140,12929,2147955033.8528,1531026291908281310.1626,37141,8.7094,0.0026,0.003
31463,88488,57025,3045,2152239065.0065,1538760170064756106.6264,57026,12.5111,0.0019,0.0031
11922,16984,5062,11557,2140780170.9876,1519644792123979539.1685,5063,7.869,0.0103,0.0064
4553,96786,92233,25668,2152031227.8688,1533785256583779042.4319,92234,7.1968,0.0008,0.0027
23621,108025,84404,32463,2144229310.8048,1538142838584341715.3069,84405,7.7745,0.0028,0.0006
29840,38433,8593,21074,2172424583.3874,1535972829199313720.4779,8594,13.1084,0.0024,0.012
13514,45005,31491,5202,2140360873.7883,1531271277683639349.8516,31492,3.2313,0.004,0.001
17021,43380,26359,25159,2139446496.5841,1534144515548219494.1443,26360,7.7378,0.0037,0.0004
19886,102834,82948,4856,2155481187.7074,1536479763594224976.9048,82949,13.6168,0.0009,0.0043
561,48103,47542,8533,2155941585.6157,1530055590356102272.6177,47543,13.5746,0.0013,0.0059
6845,37009,30164,18417,2144124359.651,1549465380264788320.713,30165,15.8143,0.0044,0.0024
31409,118075,86666,15397,2151411631.436,1533147469615420782.5573,86667,3.1548,0.0012,0.0034
23385,86514,63129,23006,2146272243.4186,1538538038979481582.4146,63130,4.6674,0.0021,0.0016
12389,45509,33120,26555,2137931273.2546,1533915884371425487.5439,33121,10.5878,0.0049,0.0014
18255,87140,68885,23705,2148473057.0821,1536696071626395268.6323,68886,4.3786,0.0011,0.0016
2472,101888,99416,5510,2147338751.6056,1533225756062173408.9249,99417,2.1112,0.0018,0.0013
28069,65887,37818,10773,2159651596.1957,1540373620520264310.9689,37819,11.7357,0.0007,0.0062
7388,91721,84333,1414,2147049429.6351,1543866818072364735.2337,84334,16.4232,0.0021,0.0021
28225,54216,25991,3579,2145984291.7709,1533121241327697046.8981,25992,2.8141,0.0029,0.0034
4268,76477,72209,18892,2146449387.9147,1536501135914622839.2043,72210,3.3939,0.0016,0.0009
18879,118445,99566,25361,2146136944.9601,1541787755178563606.7324,99567,10.463,0.002,0.0014
9301,109174,99873,32287,2154500265.1956,1544091066048894748.201,99874,8.2796,0.0005,0.0041
23821,83135,59314,15590,2156740893.8176,1529177636895024369.6762,59315,25.8813,0.0016,0.0061
23805,37709,13904,15166,2161461329.1709,1539990567628447418.0616,13905,11.9622,0.0025,0.0086
11159,65323,54164,687,2155269893.8169,1529450426398578386.2014,54165,14.3731,0.0008,0.005
29713,85483,55770,22222,2139102800.2459,1524818545074806486.2154,55771,12.109,0.0055,0.0014
5615,42714,37099,20066,2144181454.2547,1555858961880873052.6984,37100,10.2418,0.0037,0.005
22196,82435,60239,4549,2147513605.4193,1532120326947533133.3139,60240,2.0245,0.0016,0.0022
18749,23337,4588,4548,2179249739.2192,1489389263140936781.6852,4589,16.8956,0.0043,0.019
11555,93093,81538,7890,2153751129.6427,1538848694344371786.0919,81539,8.9423,0.0005,0.0038
3675,8537,4862,6136,2168269632.1834,1543508138139010367.5814,4863,5.7617,0.0048,0.0178
30330,45803,15473,30939,2138502577.121,1535590400946429542.3913,15474,6.0235,0.006,0.0012
7537,13853,6316,14128,2177289820.2072,1515954453614128953.6007,6317,11.8036,0.0006,0.0156
19898,81897,61999,13960,2142330295.1769,1541333830256018030.9786,62000,6.3112,0.0029,0.0007
19889,21424,1535,24837,2137234436.8333,1523486691881720549.1389,1536,4.6488,0.0153,0.0067
12028,54319,42291,30838,2136500973.2656,1528251665343578474.4661,42292,8.3641,0.0062,0.0013
21669,49635,27966,25929,2147801876.2999,1547262953940425233.1861,27967,5.9563,0.0034,0.0047
18965,69940,50975,27583,2140946777.1598,1532843199809500012.7231,50976,6.3929,0.0036,0.0008
96,50931,50835,25668,2142864753.4618,1535081531818864441.0173,50836,10.161,0.0034,0.0022
22491,103594,81103,14260,2148508303.7434,1544839881893755298.0838,81104,4.6272,0.0017,0.0024
23383,74679,51296,27218,2161612721.3849,1526386619868375053.0366,51297,15.3451,0.0002,0.0067
1310,79192,77882,13912,2156098515.2645,1526872039569949817.0806,77883,14.1628,0.0006,0.0044
7893,68148,60255,22605,2148494894.3614,1531938821858057029.6599,60256,6.2066,0.0015,0.0019
20542,38687,18145,29206,2151885814.318,1540479657735924614.0596,18146,6.6757,0.0027,0.0067
10059,40931,30872,23327,2149965996.3794,1533939860064464656.8355,30873,9.0548,0.0022,0.004
31968,118983,87015,7777,2135907427.9415,1528175274834768338.5082,87016,27.9824,0.0052,0.0011
13322,89334,76012,20016,2154169771.0095,1538714645036590244.9673,76013,7.4009,0.0006,0.0032
20626,34347,13721,25686,2142390907.8533,1543617284819217215.3069,13722,29.3692,0.0137,0.0048
1596,94473,92877,9945,2143786361.9479,1539304723009639703.1277,92878,7.8795,0.0031,0.0011
3732,43196,39464,26308,2149065236.7866,1523472729947119168.3324,39465,8.9153,0.0028,0.0035
1453,79472,78019,21790,2141554836.6149,1543970601155208508.6453,78020,8.6649,0.0033,0.0011
21144,47265,26121,22301,2153946930.967,1539348246012177572.7122,26122,10.0697,0.0014,0.0052
923,4463,3540,28712,2164803022.8481,1514318569115006236.5841,3541,9.9222,0.005,0.0105
31725,53561,21836,21740,2139967070.8323,1519908518136406927.0816,21837,16.7034,0.0059,0.0037
8411,55731,47320,10879,2150497011.5055,1539055713913955341.6942,47321,2.6643,0.0007,0.0033
6824,50046,43222,21145,2139031918.7619,1533681467181032565.8275,43223,10.0782,0.004,0.0007
3508,45498,41990,25733,2149100633.3457,1528717087694964916.3067,41991,10.1315,0.0025,0.0032
10533,14589,4056,23959,2162018611.4508,1520673064075683320.7642,4057,2.767,0.0071,0.0116
7070,30485,23415,25580,2140300758.4409,1522728598784174151.9735,23416,8.8295,0.006,0.0027
29072,68727,39655,29636,2166506715.1514,1527820844997317312.6034,39656,24.2294,0.000,0.0101
28346,65236,36890,12856,2131471795.8428,1544310819711360439.0147,36891,11.9707,0.0062,0.0002
19023,51300,32277,11743,2134894447.6621,1549224516807435191.421,32278,12.7047,0.0072,0.0005
22767,83563,60796,3906,2135418958.2644,1537187349801384636.1217,60797,13.075,0.0053,0.000
395,13523,13128,10163,2126819758.5327,1520539965435072257.5546,13129,17.8966,0.0102,0.0028
5788,13968,8180,11620,2155125672.0961,1499294723016823942.1145,8181,35.7684,0.009,0.0109
15663,50713,35050,31055,2139904899.222,1538601354268573716.8642,35051,6.3573,0.0053,0.0014
134,6425,6291,10271,2160041145.205,1552264224338552658.1007,6292,3.4422,0.0024,0.0084
20789,113952,93163,11716,2146016976.169,1540787269721629596.1177,93164,5.8791,0.0018,0.0015
20852,88764,67912,18992,2141068088.7345,1533516664007602180.2683,67913,8.7005,0.0039,0.0002
23116,60728,37612,27200,2141702288.4907,1533525650187872291.1214,37613,4.2803,0.005,0.0014
19159,28927,9768,9240,2133320636.6505,1554549387374529263.4791,9769,10.0856,0.008,0.0017
16913,57504,40591,10814,2145114346.9143,1544492925401642307.9692,40592,4.5777,0.0036,0.0024
31001,66558,35557,2380,2150446054.9862,1535060670858403975.2185,35558,8.0305,0.0019,0.0048
5035,86178,81143,27685,2143372656.0702,1533903504911434636.2249,81144,7.5315,0.0026,0.0006
18708,116764,98056,29651,2154071364.6721,1539545168022619976.5631,98057,10.5291,0.0008,0.0032
29202,45200,15998,18055,2200063988.636,1531111653939664291.7857,15999,43.0454,0.0002,0.0186
31882,101455,69573,2499,2138355063.3766,1540206437429588802.3304,69574,24.1174,0.0049,0.0005
9280,95184,85904,649,2143281172.639,1541616905187886256.1737,85905,10.0534,0.0034,0.0009
12946,30625,17679,12126,2123925362.0991,1527552272554905600.7345,17680,18.7391,0.0113,0.0002
30931,54436,23505,11535,2153309507.3431,1520380533295332674.0326,23506,16.1696,0.0025,0.0049
2048,96693,94645,29599,2152477356.6427,1536840600148260209.5549,94646,9.0271,0.0003,0.0034
29809,31446,1637,27608,2142851836.1422,1494749555854360032.2356,1638,7.9291,0.0163,0.0124
27009,123957,96948,20271,2141524386.5768,1548792773649591082.2302,96949,16.9557,0.0045,0.0013
14330,49208,34878,8333,2140439788.2282,1530368080595624180.9218,34879,6.8447,0.0047,0.0013
21537,79503,57966,4878,2148394766.4765,1541157054766973849.7224,57967,10.8257,0.0026,0.0027
15439,53362,37923,5932,2156925075.8626,1527032770352991745.2796,37924,7.4664,0.0016,0.0054
6515,50248,43733,9366,2156017850.1252,1526828994304975551.9619,43734,8.0908,0.0025,0.006
13117,37198,24081,5909,2145549964.2415,1534038412158621197.1023,24082,4.0461,0.0038,0.002
11674,95586,83912,14247,2155154989.6024,1535995662167303031.4387,83913,8.0944,0.0001,0.003
29339,97228,67889,22546,2137874528.241,1530654865612986521.1829,67890,12.6191,0.0047,0.0007
24594,47376,22782,30587,2146651330.1286,1546948638260855605.7244,22783,7.1553,0.0034,0.0034
26766,92604,65838,2432,2156468705.5653,1534997856070033758.3549,65839,16.0341,0.0005,0.0062
30205,109106,78901,3156,2138342434.6503,1537267422259124300.3182,78902,9.9347,0.0043,0.0003
14082,50326,36244,15638,2145683104.7271,1534115936277511472.6116,36245,9.9709,0.0025,0.0021
18603,70970,52367,30376,2147924395.3063,1527983068622155214.6555,52368,18.5172,0.0032,0.0032
12079,102372,90293,26313,2148944881.0511,1539693150294495930.4499,90294,5.8915,0.0016,0.0022
16205,22904,6699,10874,2145348794.4433,1551497604898279659.3399,6700,21.2372,0.0132,0.0075
24874,38532,13658,24118,2150176989.3557,1526156936579425798.1139,13659,8.1443,0.0038,0.0062
32766,51537,18771,21222,2151351704.3677,1551744588594830649.9374,18772,13.7391,0.0045,0.007
8953,49383,40430,17014,2146285110.8301,1546516911261195534.1469,40431,6.3845,0.0028,0.0019
8577,23495,14918,18731,2128888258.3252,1544929653883794484.3838,14919,8.6955,0.0104,0.0013
19240,100813,81573,27798,2143086431.9381,1529166567398863418.5545,81574,10.9792,0.0042,0.0018
8485,9764,1279,10176,2060812774.3,1528534968658222153.21,1280,14.9963,0.0437,0.0053
19955,80500,60545,16397,2150150944.09,1549680776327109111.5756,60546,9.3439,0.0023,0.0036
20466,71777,51311,28164,2158748449.7239,1544451514721639669.7696,51312,18.2116,0.0009,0.0062
6829,39431,32602,8865,2137813644.2777,1538760272415808070.5222,32603,14.5521,0.0051,0.0012
20203,102866,82663,399,2139506248.7988,1535091388320558807.2033,82664,7.6562,0.0039,0.0001
2853,60603,57750,1383,2139971887.2537,1536930544851868921.708,57751,9.3451,0.0045,0.0004
308,64075,63767,7816,2145295221.4872,1550154434369867853.9001,63768,10.4197,0.004,0.0019
18100,117638,99538,12242,2157253859.1871,1534282847068095294.5033,99539,17.7524,0.0001,0.0045
16754,109993,93239,26057,2155061445.36,1535387694238753416.2385,93240,17.0518,0.000,0.0034
17390,68450,51060,1645,2152707998.1359,1539113701188340365.0128,51061,6.0452,0.0008,0.0034
13935,73886,59951,2498,2151814648.282,1533780570417813367.7426,59952,6.2145,0.0008,0.0026
17240,37394,20154,31947,2145608688.4214,1541385220624068618.0332,20155,3.9747,0.0056,0.0027
13941,29791,15850,25128,2150655091.2731,1552666695582112108.4645,15851,8.7211,0.0038,0.0062
25257,52458,27201,25332,2153034887.9528,1540254475855679189.4001,27202,10.6059,0.0017,0.0053
9687,77900,68213,9261,2156253829.2627,1546472896479043255.7616,68214,22.710,0.0015,0.005
17383,68202,50819,6377,2158407867.4732,1538997098976172766.461,50820,18.9863,0.001,0.0064
16967,29692,12725,29973,2152934194.1862,1543520921262048905.9351,12726,4.3471,0.002,0.0049
21839,27175,5336,32452,2135024792.2194,1528887019445177470.1405,5337,8.9113,0.0083,0.004
5011,12276,7265,21629,2121091092.0065,1541307909591805764.5038,7266,6.2349,0.0141,0.0014
5826,69702,63876,16790,2166652369.0526,1531881749709491516.3915,63877,23.0788,0.0005,0.0079
8280,88027,79747,14276,2142555452.502,1523961608507731590.799,79748,10.3553,0.0042,0.0015
23905,122213,98308,19515,2141845140.9904,1540552823605928887.6455,98309,11.1374,0.0028,0.000
28793,75108,46315,17083,2160846451.3211,1534051220999450885.2055,46316,14.1678,0.0004,0.0051
20760,82161,61401,9392,2158905291.5267,1541150354729578233.8821,61402,7.1611,0.0002,0.0062
23291,59792,36501,12795,2127063120.6081,1538655471874588474.9706,36502,12.9786,0.0081,0.0002
31164,98034,66870,26360,2148771184.4315,1536340746309210868.0354,66871,5.0066,0.0012,0.0017
28079,47865,19786,12889,2138366983.8879,1544844610712504528.3107,19787,8.5086,0.0057,0.0019
18492,23153,4661,3029,2126435622.9775,1516907057512382584.3768,4662,3.7215,0.0122,0.0039
5202,68734,63532,27708,2148261544.1912,1533429591814212548.6441,63533,9.0761,0.002,0.0031
11208,23922,12714,31046,2154192011.1608,1529271286138360782.2843,12715,13.681,0.0052,0.0083
15569,31625,16056,859,2137445947.1216,1544193050581951870.7619,16057,5.4793,0.0066,0.0028
31018,88791,57773,22911,2135157234.542,1536435491190100248.5774,57774,12.0665,0.0053,0.0004
29209,71692,42483,9098,2130593315.9657,1545509390637070265.0675,42484,15.7139,0.0062,0.0004
30374,78738,48364,12967,2147478323.2754,1538908260315715602.7056,48365,8.4191,0.0016,0.0014
11159,32241,21082,6453,2146827153.9417,1523728042511643840.3346,21083,8.7921,0.0049,0.003
17496,103331,85835,15198,2137497291.4495,1542585127488610612.3091,85836,16.4541,0.0058,0.0011
30133,107152,77019,28957,2162201218.2243,1534082588531340736.5416,77020,19.8331,0.0001,0.0068
31938,98300,66362,30704,2154266149.1891,1528446761852542698.3068,66363,24.0914,0.001,0.004
27700,121885,94185,3883,2152891297.9927,1539179727665741838.7323,94186,2.9407,0.0003,0.0025
30225,105105,74880,9338,2139261671.5723,1534416650488314234.8602,74881,10.253,0.0039,0.0008
6202,29803,23601,14519,2163595962.465,1536058870592624580.1358,23602,8.7593,0.000,0.0082
9159,33772,24613,952,2159620577.945,1535930203195343742.3306,24614,8.281,0.0002,0.0056
17658,36559,18901,7374,2149998232.0481,1543795777049539971.9511,18902,4.303,0.0024,0.0042
22969,30424,7455,17266,2155349017.6888,1511843231123024725.6135,7456,5.0617,0.0044,0.0077
18176,99644,81468,30477,2142262236.2055,1534008251449672356.8545,81469,2.5448,0.0028,0.0007
14795,34291,19496,2652,2137997310.477,1531141324556420525.3904,19497,17.4286,0.0077,0.0026
17232,70548,53316,27978,2150670876.3023,1531233458648908667.2777,53317,7.9849,0.0014,0.003
18754,71781,53027,22031,2141335329.0359,1521235344838165579.4991,53028,13.6057,0.0053,0.0022
12150,51170,39020,17330,2162183259.0847,1543336705775412160.1703,39021,14.6432,0.0001,0.0084
31355,52496,21141,32737,2126397817.9054,1542774061922690383.7536,21142,17.2614,0.0096,0.0006
24134,69140,45006,2825,2131727618.0592,1529682225092972349.056,45007,11.0214,0.0079,0.0004
9161,76079,66918,7397,2153553388.3771,1537349161960348104.5666,66919,19.0926,0.0016,0.0033
19249,29805,10556,18614,2153673382.1778,1526824014196124138.6228,10557,4.9108,0.0034,0.0063
16931,29240,12309,12023,2153795326.1911,1551608332747091820.779,12310,5.924,0.0025,0.0063
31031,52586,21555,12492,2146914850.0552,1540160587809941791.7005,21556,21.9686,0.0082,0.0041
20276,33294,13018,8403,2167104997.8756,1532261743139936819.1413,13019,10.3214,0.0013,0.0095
20071,100153,80082,196,2154096826.4899,1540481442249429903.7393,80083,10.9489,0.0006,0.0036
31835,91372,59537,2966,2135460718.7554,1528307464842406920.6388,59538,13.5816,0.0061,0.0005
22561,92690,70129,6130,2156932263.4585,1539478589043841116.1067,70130,14.5941,0.0009,0.0061
27013,29811,2798,14350,2142841070.2801,1567324213200062421.1034,2799,7.3503,0.0108,0.0063
27626,92949,65323,757,2158707312.7395,1527199973841827131.7584,65324,17.3237,0.0019,0.0062
30330,119287,88957,24695,2145892401.6404,1543033583077413311.1318,88958,4.7258,0.0022,0.0013
30886,51966,21080,7195,2140937908.9422,1534223593840472392.8592,21081,1.5287,0.0041,0.0013
25224,88984,63760,6803,2143017422.9623,1542467229328632527.4381,63761,7.9682,0.003,0.001
1493,65592,64099,14967,2151049485.9367,1533566971533980566.9217,64100,6.416,0.001,0.0021
13289,40240,26951,15404,2137125116.9883,1547475521729082586.2238,26952,11.5365,0.0066,0.0024
18440,76885,58445,14195,2151892894.537,1532810199169620554.8492,58446,6.7645,0.0013,0.004
12687,36045,23358,32454,2155304184.3342,1559996798293337424.408,23359,18.3805,0.0027,0.0072
11302,15867,4565,8514,2156951805.3327,1493804711021964586.5251,4566,10.1856,0.0068,0.0115
4429,70189,65760,9943,2161440922.1158,1536999644630501720.9651,65761,15.6219,0.0001,0.0057
9871,94266,84395,18895,2146484558.412,1543523715472891962.2913,84396,10.6312,0.0026,0.0019
25091,83984,58893,23872,2145187324.786,1532437533161127693.2761,58894,5.6226,0.0026,0.0012
24877,73859,48982,1752,2152456088.4935,1535942145493756236.3616,48983,12.2023,0.001,0.003
4930,60152,55222,31403,2136041516.0814,1538274442221824325.799,55223,12.1787,0.0057,0.000
7402,78985,71583,27086,2157331829.5903,1535743999361135982.8489,71584,11.0153,0.000,0.0038
10435,89191,78756,24019,2150021459.5779,1540590268915943530.3601,78757,2.7637,0.0012,0.0023
30197,59919,29722,27860,2166470321.5957,1544730082370098061.301,29723,11.299,0.0001,0.0082
30087,105084,74997,11985,2148622110.3218,1543367260298612653.9319,74998,17.9379,0.0022,0.0036
17208,81630,64422,12780,2146901263.6883,1536123068095423511.9132,64423,1.5079,0.0013,0.0011
8247,107953,99706,7108,2151570106.3572,1537390930144694901.562,99707,5.2961,0.0004,0.0023
7571,82108,74537,28175,2154517613.1839,1543691050403686467.6048,74538,6.8617,0.0006,0.0046
15576,51099,35523,17004,2147293848.5084,1528226328836055302.6914,35524,6.008,0.0022,0.0026
27573,51866,24293,23224,2138368579.0711,1541376012692502474.7325,24294,6.3862,0.0055,0.0009
17052,79066,62014,14541,2150153367.8332,1540002162102764634.0365,62015,9.7194,0.0012,0.0028
23555,90675,67120,6055,2154518419.3517,1546700254338974193.1714,67121,24.8916,0.0023,0.0052
433,8201,7768,17077,2137705585.1515,1514522199990030493.0738,7769,5.9785,0.0098,0.0051
22000,26289,4289,15399,2186161954.8035,1585823239760979110.3803,4290,13.5065,0.0034,0.0198
30855,41072,10217,3689,2155564319.2612,1543494530239174034.9438,10218,13.5114,0.0035,0.006
19947,49231,29284,15556,2129912458.6522,1536189650075791105.1431,29285,16.7864,0.0093,0.000
8828,73943,65115,20930,2147099078.212,1536916163130442462.4025,65116,3.3301,0.0018,0.0021
13853,67566,53713,23629,2146412616.7828,1540921966037639924.7284,53714,10.3707,0.0025,0.0021
4652,32971,28319,18968,2152612350.0763,1526662385196197489.2942,28320,11.0057,0.0031,0.0048
2783,12459,9676,32485,2177161252.4382,1535710934639683968.3348,9677,11.2725,0.0002,0.0138
5083,76998,71915,16644,2146429844.9556,1538549358028598621.5186,71916,8.0163,0.0018,0.0015
10297,40814,30517,2182,2159814168.8824,1540373916012434361.0684,30518,6.2667,0.0006,0.0076
19191,29141,9950,20548,2143709046.577,1537695011060172121.3075,9951,2.1313,0.0053,0.0032
19099,64356,45257,19635,2133517762.8865,1538685743676513917.3248,45258,19.1982,0.0057,0.0002
22736,95604,72868,26251,2144934717.0561,1540849451148856340.2116,72869,2.3204,0.0025,0.0012
24600,109004,84404,28813,2149353077.3102,1538301571196614693.4354,84405,4.2544,0.0015,0.0022
25291,36360,11069,22056,2158378216.476,1520355246833301965.7253,11070,6.3351,0.0027,0.0083
9506,20095,10589,7119,2138521814.3929,1534769829890739552.2652,10590,5.7377,0.0068,0.0014
29047,103520,74473,3861,2141198339.5975,1550716785637058503.2069,74474,22.8172,0.0046,0.0022
30343,34486,4143,25344,2152056658.7973,1522216695199007121.2697,4144,12.2052,0.0087,0.0131
23244,84369,61125,12074,2155445999.3295,1536206171647931318.1393,61126,9.5877,0.000,0.0033
11023,56096,45073,17009,2161159970.5859,1551640068271151376.6646,45074,12.2743,0.0004,0.0068
24120,37214,13094,24541,2135862269.631,1539191539619722806.941,13095,4.1983,0.0062,0.0013
22362,67247,44885,31030,2142906392.7681,1541960748370857224.3762,44886,20.8965,0.0034,0.0018
28777,103276,74499,18140,2144598826.2792,1536654759624192615.7258,74500,4.7568,0.0019,0.0007
24471,108988,84517,23262,2144303798.4864,1537255641109845204.1459,84518,7.9959,0.0034,0.001
17133,45116,27983,8050,2145812969.8819,1540896395606096014.2711,27984,9.1604,0.0028,0.0021
15925,18764,2839,12265,2136267714.0014,1522200800368613970.6014,2840,4.4296,0.0097,0.0049
4187,19927,15740,5808,2158186253.6859,1529824481959693086.9697,15741,4.2483,0.0027,0.0071
12318,58787,46469,14202,2148164968.9311,1531478145723994249.6239,46470,2.1431,0.0014,0.0025
1617,25767,24150,30850,2144664849.1051,1557585925574209650.3519,24151,21.2107,0.0049,0.0043
23622,83905,60283,19053,2155142205.1789,1542687532743910971.2096,60284,13.9823,0.0013,0.0057
25477,59449,33972,32757,2152399995.7723,1538327639366528075.9562,33973,19.2651,0.0038,0.0044
22949,24304,1355,922,2151956105.4882,1539555251056871519.7838,1356,25.9428,0.0137,0.0179
7068,24137,17069,27412,2152122978.5969,1550372822181871908.0498,17070,8.8713,0.0042,0.0063
11544,69840,58296,15689,2134894730.1949,1543842691643656923.207,58297,13.038,0.0062,0.000
14450,71873,57423,4841,2130961622.0528,1552355071723045767.2985,57424,34.1369,0.0087,0.0016
10319,45508,35189,10462,2144658481.5236,1542119989514722771.3926,35190,18.5924,0.0035,0.0029
18519,89872,71353,29966,2151851439.5628,1539898071993672106.5205,71354,9.4139,0.001,0.003
2403,14091,11688,2328,2144552187.8723,1552116116466200403.9797,11689,15.7602,0.0078,0.0064
15082,31587,16505,5700,2162700026.5815,1543905699187066318.3877,16506,11.0458,0.0016,0.0081
318,75303,74985,26779,2146020305.3053,1536966283190123369.4258,74986,6.2811,0.0019,0.0011
24251,55364,31113,29232,2138361272.6101,1535572323415778583.5474,31114,21.4879,0.0086,0.001
32589,73473,40884,17831,2137130317.6526,1536118964134451616.8846,40885,15.7892,0.0053,0.0013
12792,25945,13153,27165,2144902516.1626,1548719303140745700.7932,13154,11.5496,0.007,0.0043
20525,101769,81244,32397,2154288053.4908,1534543833442455881.7318,81245,10.2824,0.0001,0.0037
3273,60378,57105,10610,2144222933.9142,1535917705712304693.5208,57106,4.3893,0.0036,0.0007
18703,95498,76795,16819,2139691628.7705,1543938552015458780.9038,76796,12.1061,0.0044,0.0003
1564,81611,80047,21437,2144115420.9931,1542728701629297147.5153,80048,13.2506,0.0041,0.0014
27232,28010,778,30566,2096926225.6085,1471169388168454412.7517,779,6.3171,0.0287,0.011
28154,82897,54743,30730,2156039097.2735,1536760664846078567.0331,54744,13.0117,0.0013,0.0059
6535,8739,2204,8427,2115281659.863,1493971895373029552.3032,2205,8.6676,0.0217,0.0079
24577,95189,70612,8296,2145379667.9809,1541167421798140655.0515,70613,3.4174,0.0021,0.0008
23916,34651,10735,6192,2156094977.9501,1550222757158297271.8418,10736,4.9766,0.0028,0.0074
7402,72073,64671,26943,2142960917.7909,1531098521635913443.726,64672,13.4167,0.0033,0.002
30159,113342,83183,3448,2150246181.8916,1536745702330706076.666,83184,16.5695,0.0011,0.0031
32597,62188,29591,18550,2179307909.3551,1529193889828001569.9208,29592,35.4321,0.0003,0.0155
24214,84448,60234,3763,2146018951.6313,1544210400613615564.8715,60235,4.8156,0.0023,0.0019
23548,52164,28616,11227,2172796189.9441,1532812677359261189.7936,28617,16.1657,0.0003,0.0106
22709,60352,37643,7299,2161453127.8923,1532626825727110067.3576,37644,9.2769,0.0002,0.0059
13000,93244,80244,5936,2149992858.0093,1538762307849824023.1823,80245,10.0499,0.0017,0.0031
6033,53510,47477,22522,2155053024.0105,1542759949243996635.0603,47478,13.1956,0.0005,0.0053
8806,49915,41109,6796,2169025768.3601,1539668791694906538.111,41110,14.9243,0.0005,0.0082
7366,78456,71090,16313,2151479384.6472,1532529077293170235.8037,71091,16.0944,0.0013,0.0041
13791,42761,28970,7458,2152729843.5237,1537518139410769465.2353,28971,3.0955,0.0015,0.0039
26019,78062,52043,28580,2148441301.943,1536912301052673248.9204,52044,8.0224,0.0021,0.0022
15985,42854,26869,10120,2144411459.348,1528019869763981219.101,26870,10.1018,0.0041,0.0022
29994,32909,2915,26089,2152799259.393,1522896593390269360.9107,2916,5.914,0.0062,0.0107
23657,66481,42824,11373,2146178414.8452,1543159351988033469.2835,42825,2.9751,0.003,0.0022
166,94019,93853,22272,2150798365.8699,1545502714285406042.2765,93854,6.5448,0.0009,0.003
3809,60408,56599,8924,2156311340.7124,1535566774043515683.338,56600,7.4531,0.0003,0.0045
21521,62076,40555,27694,2172163688.29,1528437066043754684.1914,40556,23.7174,0.0012,0.0105
30482,78867,48385,32081,2137359855.6902,1547918412189072085.8574,48386,26.3534,0.0062,0.0011
2558,95570,93012,16681,2151752198.0096,1533536125550120396.4412,93013,10.8642,0.0008,0.0025
14918,20623,5705,7173,2153393262.2921,1509401240098706116.9306,5706,13.8632,0.0059,0.0095
10571,78413,67842,12536,2149299343.4924,1533352925841371156.6036,67843,2.129,0.0015,0.0024
6891,88295,81404,1699,2142454217.0583,1543188881569555090.6285,81405,15.6381,0.004,0.0008
4427,58275,53848,11434,2152762571.5952,1532119746632693623.4994,53849,4.8515,0.0011,0.0034
2757,28674,25917,23171,2154643320.5951,1539949606600634262.7948,25918,3.781,0.0016,0.004
8332,93993,85661,31753,2138831271.445,1537746467927529043.0218,85662,19.2312,0.0036,0.0002
23455,97079,73624,17666,2148477421.899,1530304522855002128.5934,73625,15.642,0.0024,0.0024
16005,19665,3660,21233,2099576681.2248,1520905304190907053.8558,3661,11.1489,0.0244,0.0024
491,71323,70832,9724,2146327758.8288,1532532298556418827.88,70833,12.1227,0.0024,0.0013
26776,71899,45123,994,2143894755.2117,1544405375304944133.7845,45124,3.9705,0.003,0.0013
17744,112935,95191,23680,2150186298.4787,1544887643636379783.542,95192,16.5337,0.0017,0.0032
6957,29741,22784,21562,2152319437.3128,1551330382547984128.2364,22785,21.5701,0.0045,0.0076
21694,91873,70179,13129,2149728868.8657,1534541772132839715.9641,70180,5.0722,0.0012,0.0021
7839,88007,80168,1473,2139336344.449,1545303796737772001.159,80169,20.2439,0.0041,0.0011
3861,95255,91394,28096,2149950864.7886,1528162047566390403.2523,91395,7.1555,0.0013,0.0029
12153,19311,7158,27889,2096649116.1407,1514457659476006902.2318,7159,21.9823,0.0222,0.0006
4413,89372,84959,24990,2147756962.9719,1538782018389560449.5162,84960,4.5891,0.0012,0.0012
7132,67068,59936,18946,2146274391.4176,1532447921237914213.275,59937,17.4909,0.0039,0.0027
7050,21672,14622,12013,2131711396.2428,1571387306542648832.7866,14623,22.8002,0.0123,0.0022
3358,32499,29141,541,2148997272.6303,1535697215136459113.3404,29142,7.7554,0.0017,0.0035
31023,124678,93655,21607,2145190059.0032,1538740696377655713.832,93656,7.5225,0.002,0.0011
26989,39936,12947,4767,2127787468.753,1522927725891254458.295,12948,5.9221,0.0105,0.0007
17769,78141,60372,17899,2148631136.4868,1546747496003065879.3063,60373,13.574,0.0022,0.0024
30490,34888,4398,762,2168982284.3762,1528349804205304463.2054,4399,6.7118,0.0009,0.0153
18756,69229,50473,25601,2150996513.6116,1530131388276158572.5376,50474,9.5697,0.0021,0.0036
20241,36178,15937,819,2171885719.9447,1521802174955230855.0644,15938,22.0819,0.0005,0.0106
12692,87738,75046,14836,2147505939.2551,1542756804772135998.8803,75047,6.1797,0.0018,0.0021
5191,50659,45468,2395,2151657452.6809,1552710218757072879.5196,45469,6.8313,0.002,0.0042
512,59094,58582,4259,2147411976.9152,1552119668311888280.7727,58583,14.4936,0.0038,0.0033
29404,79662,50258,29324,2165148894.9938,1538563508508284764.99,50259,17.2107,0.0001,0.0071
7193,59086,51893,53,2151305737.2194,1548750774130161934.9155,51894,13.5537,0.0023,0.0042
21043,41642,20599,20565,2141210205.7136,1518314113778544409.1287,20600,8.2166,0.0061,0.0035
15980,18450,2470,25180,2124666057.2744,1585652049547532514.6378,2471,13.7228,0.0165,0.0064
13337,113289,99952,2838,2144248894.2961,1531816543876844913.7034,99953,5.0958,0.0029,0.0008
5976,78272,72296,25089,2144396413.7001,1544306786619735961.6082,72297,4.5904,0.0035,0.0015
31064,121552,90488,7618,2151577256.1124,1543152803859768357.8259,90489,10.5157,0.0011,0.0032
769,22104,21335,1818,2126541130.1674,1544124786691047446.7389,21336,27.0309,0.0139,0.0013
531,93438,92907,32385,2146302477.4579,1534652643789964677.6683,92908,6.4707,0.0021,0.0012
31881,102072,70191,25641,2140347073.4239,1536645892092309423.3096,70192,6.5214,0.0042,0.001
4714,16342,11628,4248,2179248451.8695,1548567434861282628.0966,11629,13.1854,0.0005,0.0134
13796,83552,69756,15878,2154631665.8935,1542906025060251027.6123,69757,5.595,0.0001,0.0037
17362,80720,63358,18986,2155581062.3885,1540704637337522132.9905,63359,5.7694,0.0002,0.0036
18161,84579,66418,6291,2152194495.2344,1536116348868618017.0267,66419,6.9293,0.0005,0.0026
4802,87000,82198,15583,2150265171.9375,1539489750113515259.3268,82199,12.9772,0.0014,0.0032
1643,98201,96558,5417,2141444265.3739,1539111707247903360.5208,96559,7.2403,0.0042,0.0003
26467,51391,24924,20490,2147239090.7899,1539848438058973098.8616,24925,2.7021,0.0028,0.0021
29170,98461,69291,7467,2142639068.4478,1541102075530789900.4917,69292,10.4888,0.0029,0.0004
17283,52321,35038,1901,2145641309.2483,1533152341724600412.8661,35039,7.1914,0.0029,0.0023
11216,56338,45122,12034,2152369907.8892,1532702503512822511.6252,45123,8.2754,0.0019,0.0042
2402,76241,73839,17401,2156098512.986,1545425430043777830.4062,73840,8.2991,0.000,0.0049
11563,110036,98473,13327,2150089153.3503,1539947029884863725.5887,98474,6.8192,0.0014,0.0022
4935,100416,95481,28765,2146622447.2722,1544216287280678342.7966,95482,11.9377,0.0029,0.0022
18226,59611,41385,26659,2133361495.2757,1544084889126966202.5876,41386,13.9325,0.0071,0.0002
10783,77078,66295,3020,2150480162.3119,1529175384459080211.5933,66296,5.2545,0.0014,0.0026
19024,95073,76049,6084,2145327753.2614,1525922090561419584.5095,76050,10.5796,0.0031,0.0019
29383,93092,63709,12445,2140091590.0548,1541616301161272959.9333,63710,4.3147,0.0041,0.0012
20456,33661,13205,15433,2170356066.4269,1525564484466032596.4268,13206,23.923,0.0013,0.0129
8436,26037,17601,6743,2138100239.2434,1521855261482870577.0375,17602,10.4345,0.007,0.0024
28603,122703,94100,31926,2157407528.2309,1539186907223031484.8479,94101,12.6003,0.000,0.0038
23484,120106,96622,13125,2139569325.3378,1540665745596218831.3305,96623,16.8831,0.0048,0.0006
17762,106617,88855,18004,2144766262.0181,1529427385912145735.3332,88856,8.0437,0.0031,0.0013
2664,46634,43970,24305,2159266413.9992,1530428453894240115.8257,43971,11.4606,0.0007,0.0055
21770,82094,60324,22142,2150880442.933,1537722814989246314.9405,60325,7.9132,0.001,0.0021
10534,91230,80696,7646,2144969128.9336,1535083576553582754.562,80697,12.5682,0.0026,0.0013
2453,36197,33744,22444,2154466733.5843,1536059421597250188.8999,33745,8.4486,0.0021,0.0046
8376,94579,86203,27809,2150449249.1917,1533998923753260728.1552,86204,7.8455,0.0014,0.003
30911,89530,58619,30017,2144460973.3519,1528941615095824770.1089,58620,6.6837,0.0035,0.0014
18919,110520,91601,1758,2156073739.7672,1534044210746940701.8466,91602,9.2442,0.000,0.0038
12946,107365,94419,25002,2153547255.8281,1537540616280872477.0613,94420,12.0973,0.0005,0.0041
10641,35156,24515,17683,2154976143.0451,1535173241351002686.0568,24516,3.1169,0.0007,0.0039
13991,102691,88700,20103,2147727966.584,1537789573087223577.763,88701,9.3545,0.0015,0.0019
20693,43212,22519,29677,2122289395.7345,1550307935046637052.249,22520,26.2865,0.0106,0.000
30894,111728,80834,13495,2153029924.0248,1538083530397050879.554,80835,6.8155,0.0002,0.0028
14186,59722,45536,16716,2133171285.8331,1546236784982109445.4222,45537,23.6063,0.0059,0.0001
1111,5874,4763,2881,2124744586.0793,1577080875784267360.2872,4764,10.345,0.015,0.0051
9904,10273,369,14296,2079433776.7108,1531534367453343761.7677,370,4.4254,0.0383,0.0088
30010,44674,14664,828,2134998868.9012,1527057987955323229.8352,14665,8.5987,0.0076,0.0027
30098,98763,68665,3170,2133153734.1659,1533078288673427966.4041,68666,13.6066,0.0058,0.000
14358,22022,7664,32377,2132065976.3534,1546125341019798840.4649,7665,8.9479,0.0078,0.0016
2178,78692,76514,20196,2152494854.4449,1536582291149786128.5983,76515,9.7235,0.0007,0.0034
1196,99110,97914,4157,2139230222.5764,1530224977323124775.2726,97915,13.8379,0.0042,0.0004
12577,64409,51832,17676,2149693663.0772,1537732551033137486.0045,51833,7.5829,0.0018,0.0026
17661,110031,92370,263,2151820115.7693,1539318599274532387.5482,92371,13.3251,0.0012,0.003
16657,100014,83357,25422,2146174066.1014,1525800396905246291.7563,83358,14.3895,0.0035,0.0021
25201,116420,91219,14069,2154386117.5804,1533104590028558008.6517,91220,13.0114,0.0003,0.004
16855,31967,15112,24194,2144574241.0172,1528911051613484527.117,15113,4.7457,0.0043,0.0025
26437,43149,16712,15784,2134260472.1304,1542554358540878718.218,16713,5.0973,0.0058,0.0005
12229,80964,68735,23990,2149970138.7291,1536670655392881929.5514,68736,2.7144,0.0009,0.0016
9479,15755,6276,7309,2117447932.0236,1560122604804452433.777,6277,7.3089,0.0154,0.0013
4605,75570,70965,18851,2144836640.9342,1526403616639608853.8159,70966,12.073,0.0036,0.0018
16543,23559,7016,21880,2127847054.064,1534326834707106062.0208,7017,3.0095,0.0093,0.0016
2381,71224,68843,19526,2149983959.7823,1540233890455510983.7093,68844,9.1832,0.0017,0.0031
17011,50220,33209,26387,2154601189.859,1542052155649327075.5837,33210,7.8962,0.0008,0.0044
12755,55970,43215,14310,2156176981.9087,1536712971056593606.4161,43216,7.911,0.0006,0.004
1926,71081,69155,9046,2144770792.0826,1535502464089432974.1821,69156,7.7059,0.0026,0.0017
195,10213,10018,19854,2168074212.1477,1511790480992037299.0761,10019,20.3524,0.0003,0.0111
25447,62451,37004,18463,2139260231.3115,1531973845916367376.7876,37005,12.0566,0.0066,0.0006
16763,83117,66354,15460,2160342936.4552,1543045369391635989.834,66355,11.0797,0.000,0.0049
28957,74193,45236,31642,2154332878.7231,1546021107448479255.8124,45237,13.506,0.0011,0.0042
4666,8476,3810,28731,2162943461.1971,1484633169031739800.3057,3811,14.9183,0.0073,0.0165
27402,102035,74633,3572,2130638467.8026,1520678392100005403.4985,74634,24.7678,0.0085,0.0004
19860,52208,32348,29484,2140225466.8763,1528250959759363447.4198,32349,14.4464,0.0052,0.0014
1088,98168,97080,12172,2143286498.6132,1534072746476453162.0736,97081,6.5688,0.0025,0.0003
12892,92030,79138,32030,2150206056.053,1541147594515092026.4852,79139,5.1866,0.0013,0.0025
26822,118225,91403,25131,2145938816.3258,1542487677578084635.8333,91404,6.7511,0.002,0.0013
20667,78548,57881,28179,2162181324.9959,1535512161865611996.2644,57882,10.7445,0.0003,0.006
21498,49360,27862,30970,2156130757.5474,1538107740188928108.9674,27863,4.9732,0.0006,0.0054
6462,22898,16436,2104,2165459054.8919,1544626174188135856.5516,16437,7.574,0.0015,0.0101
23523,72997,49474,26002,2151464753.7285,1536185054451541001.9233,49475,3.1929,0.0008,0.0036
4477,15360,10883,22667,2156191141.8668,1517947471968343101.1482,10884,8.7246,0.0033,0.0091
26383,61551,35168,15739,2164766590.164,1531932969535923138.2029,35169,15.3534,0.000,0.0076
30253,104450,74197,19957,2147517760.8589,1532683531079385814.0317,74198,6.6464,0.0022,0.002
15195,23524,8329,7088,2149109193.937,1545863676613807349.9265,8330,8.4768,0.005,0.0077
1697,60993,59296,2530,2145296501.8872,1539116499727843689.5729,59297,3.7942,0.0022,0.0011
32490,96838,64348,21166,2155590667.8798,1544469149271420301.1605,64349,11.6068,0.0008,0.0055
19426,44282,24856,16662,2169990443.2196,1541309414806209955.7468,24857,9.6969,0.0004,0.0093
19625,42823,23198,18149,2111488377.7264,1525289291930888390.7306,23199,25.9555,0.0136,0.000
11755,46982,35227,31306,2150360946.437,1534798619360047085.5206,35228,1.7532,0.0016,0.0029
13276,24328,11052,29120,2137402920.9411,1566078829272286828.3681,11053,12.5214,0.0103,0.0061
7454,66856,59402,24196,2141113744.4686,1539008239288806926.103,59403,5.313,0.0038,0.0005
26688,74476,47788,31848,2146038003.0962,1529522237850758159.4144,47789,4.9143,0.0026,0.0022
18298,110938,92640,30691,2141078156.4751,1542136458989251673.274,92641,7.1296,0.0034,0.0002
2329,53524,51195,7153,2154672870.5656,1527745358595932704.8866,51196,11.9407,0.0011,0.0047
4420,47242,42822,13356,2133319491.535,1539809030708708675.288,42823,11.8764,0.0069,0.000
30052,97046,66994,12389,2135452094.573,1534693608074103487.8848,66995,13.7133,0.0072,0.0002
31625,49738,18113,14870,2112803624.8066,1529227193142489431.9026,18114,30.4635,0.012,0.0003
10075,103020,92945,31604,2151189340.0457,1533957520026605813.7415,92946,6.4353,0.0005,0.0025
18833,96226,77393,11029,2147403311.889,1529694673957612735.1607,77394,10.2974,0.002,0.0021
17759,77769,60010,13681,2145825853.6458,1545335129927860500.3305,60011,4.659,0.0034,0.0024
25264,35816,10552,17825,2132722739.9774,1556062923899076385.8497,10553,8.7651,0.0083,0.0023
3139,74333,71194,18028,2141631774.1099,1529376693496530975.3534,71195,6.1258,0.0043,0.0009
8334,74412,66078,5587,2144435349.2185,1532332753510232853.1762,66079,6.4441,0.0029,0.0014
28536,47184,18648,1500,2147982643.2225,1532370074034827236.3542,18649,12.4617,0.0041,0.005
20385,120211,99826,30907,2153079419.1778,1535777589765476141.9013,99827,9.5767,0.0001,0.003
24688,74043,49355,13043,2139016144.1443,1543699552987739710.3362,49356,5.3667,0.0048,0.0009
13533,101094,87561,29406,2137421419.4685,1535236057303818176.5745,87562,20.2655,0.0051,0.0003
28054,49557,21503,14011,2148309692.5476,1539213917219809884.2954,21504,7.5875,0.0029,0.0039
30673,112497,81824,4394,2142846017.9634,1541241631001603184.3615,81825,7.9177,0.0037,0.0005
1119,56764,55645,20218,2148911164.959,1534569069471922066.9251,55646,6.5209,0.0014,0.0025
22744,44212,21468,7006,2129514450.1504,1535579890343026489.8859,21469,10.186,0.0091,0.001
29904,72215,42311,9649,2159622603.7394,1538672001636095518.8832,42312,6.3556,0.0002,0.0055
23718,27812,4094,20577,2130864910.9192,1558949913610293123.7148,4095,9.0095,0.0107,0.0023
24064,108468,84404,3308,2145037797.9946,1538509046428538691.7334,84405,6.0448,0.0023,0.0008
3492,26197,22705,24070,2130666019.099,1533682050668643068.1944,22706,31.0903,0.0095,0.0018
6991,76271,69280,14706,2150745866.5038,1554353927844417008.4651,69281,24.386,0.0031,0.0051
4126,64785,60659,18801,2149122355.9306,1531256373478490431.9381,60660,8.6072,0.0016,0.0023
30214,58201,27987,15467,2150923824.894,1532708474010695089.1639,27988,9.4627,0.0033,0.0057
13693,105659,91966,28811,2146216728.8607,1528969809045056413.5404,91967,8.4119,0.0024,0.0012
3426,11191,7765,29256,2200863532.5373,1545763559830827602.4745,7766,20.7171,0.0004,0.0205
4454,55551,51097,5428,2151238464.1751,1528838649739173153.2315,51098,14.0982,0.002,0.0035
22432,65743,43311,28723,2137711187.3323,1528926437723862517.5119,43312,12.2607,0.0056,0.0012
31099,63671,32572,14632,2141673164.2137,1540627357465245293.1232,32573,2.9336,0.0032,0.0012
18910,105690,86780,12676,2144682152.5744,1543185391141764855.8929,86781,12.3727,0.0027,0.0014
10905,56511,45606,19616,2157672947.3752,1546790446514617401.4068,45607,14.6644,0.0012,0.0063
15127,66515,51388,5418,2147672318.5531,1536271607340878736.2287,51389,4.6869,0.0015,0.0015
19559,78661,59102,7804,2141504381.7114,1543191131425949931.1916,59103,9.5778,0.0038,0.0011
11563,56866,45303,7010,2144176352.5853,1536473987492511374.1945,45304,12.4709,0.0038,0.0015
3664,93000,89336,26462,2145568240.1573,1539466912216563039.2832,89337,12.8141,0.0036,0.0019
2824,25778,22954,22642,2125164612.3445,1541451221693163999.3054,22955,20.5567,0.0109,0.0015
30356,41721,11365,9476,2149799967.6886,1541604892646472342.787,11366,7.2688,0.004,0.0046
25719,86730,61011,24792,2144390666.9717,1539090622972440116.295,61012,4.7515,0.0028,0.0014
17737,78759,61022,31346,2147012207.9071,1534377754835552665.0696,61023,12.744,0.0024,0.0022
11803,24898,13095,4344,2141970017.9594,1535849176864870245.9596,13096,8.7334,0.0051,0.0026
22191,103593,81402,11101,2140304634.7825,1535718511985067163.0097,81403,3.0754,0.003,0.0002
9756,51268,41512,7297,2161354742.0948,1532727488042135687.3259,41513,20.0461,0.0001,0.0058
3111,40288,37177,3481,2155789898.6548,1539652639354711824.9441,37178,8.7785,0.0014,0.0051
2754,10922,8168,1144,2100266723.7038,1521260019526340201.1849,8169,20.3302,0.0183,0.0003
16248,90139,73891,2263,2151031021.4058,1547300638143079394.3893,73892,6.109,0.0016,0.0032
5002,74628,69626,29258,2150329446.5115,1540066505002744835.2946,69627,2.050,0.0006,0.0021
387,91359,90972,31265,2144717797.3594,1530172089637507006.7145,90973,7.5267,0.0036,0.0013
24346,70169,45823,25847,2151479732.8073,1536221275760733130.0271,45824,5.9735,0.0013,0.0033
17331,96642,79311,27065,2138682756.9291,1537742195732164535.7239,79312,11.0062,0.0038,0.000
15768,34229,18461,5699,2144119050.2223,1540022745654386569.9041,18462,2.8235,0.0043,0.0022
14138,86880,72742,28989,2150477624.4034,1542769969677780668.0636,72743,5.6896,0.0012,0.0025
10801,75832,65031,19982,2138452335.0805,1532250147966231575.1098,65032,14.7546,0.0044,0.0002
13817,71559,57742,10052,2142080434.3013,1537212507764766533.6739,57743,4.370,0.0029,0.0002
13266,32514,19248,18077,2140851407.092,1514456752252402785.0353,19249,9.4975,0.0062,0.0031
14839,61517,46678,10966,2153199509.5558,1541459402669285343.4567,46679,4.7345,0.0012,0.0048
9237,20667,11430,6761,2136954314.0984,1522271582627537410.1727,11431,10.3722,0.0086,0.0025
1122,40420,39298,2744,2143583589.5452,1522455533992004961.749,39299,9.7077,0.0039,0.0026
30405,84113,53708,22807,2143688896.0199,1538823900516252388.3451,53709,8.8196,0.0037,0.0014
20202,39319,19117,4486,2162430764.0791,1559523036442928973.4643,19118,13.784,0.0019,0.0079
13992,16609,2617,5420,2136711250.3541,1570708279933313244.0614,2618,18.7566,0.0154,0.0118
13541,90036,76495,22340,2141862811.0511,1536701713171942627.8369,76496,10.1273,0.003,0.0007
1075,62549,61474,3011,2138379263.544,1532577515060880988.4605,61475,16.9548,0.0053,0.0001
32664,58587,25923,77,2140160397.1963,1538377173079426013.6505,25924,9.3144,0.0061,0.0009
7078,90139,83061,23327,2146440553.4575,1540632308973970074.9418,83062,6.3029,0.0016,0.001
31978,37379,5401,7726,2132145135.229,1550521210882963130.2743,5402,4.4066,0.0127,0.0022
3918,12721,8803,1295,2153083683.4664,1549462929767289045.8445,8804,6.3098,0.0053,0.0064
28659,47452,18793,3418,2149274226.113,1537626028151455944.918,18794,2.0464,0.0023,0.0026
27408,93397,65989,3288,2141557485.6314,1532758077593301847.9551,65990,5.9807,0.003,0.0009
30381,34563,4182,10525,2149554349.3682,1539920244159564367.263,4183,1.8496,0.0061,0.0072
20231,97129,76898,13199,2143790352.8663,1535254502019337582.4824,76899,6.8046,0.0024,0.0007
7273,14785,7512,32582,2103142101.8657,1526867353253259112.6183,7513,11.5253,0.0181,0.0004
1957,87497,85540,158,2151012084.5227,1543207318238347226.112,85541,20.4292,0.0014,0.0042
15462,39491,24029,31326,2167334537.7449,1528758198194801523.8413,24030,21.2398,0.0022,0.0103
27082,28796,1714,28573,2215165749.3271,1535582846664278448.7519,1715,7.5865,0.0006,0.0249
2383,87638,85255,24336,2139914071.4544,1535515490671031541.7024,85256,10.742,0.0035,0.0004
15996,42362,26366,4650,2164021576.0312,1519196838883843879.1819,26367,18.3269,0.0015,0.0078
15590,105061,89471,24722,2143619001.4571,1541888375090219313.1752,89472,16.5705,0.0029,0.0008
23279,61205,37926,20630,2137322953.983,1530647924623068224.9212,37927,13.4372,0.0066,0.0016
22780,58625,35845,18011,2154500121.3266,1530998898402562500.3843,35846,6.9761,0.0004,0.0042
14983,47260,32277,11661,2157068680.5457,1539632353791690495.0253,32278,13.3215,0.001,0.0048
18145,97560,79415,5309,2137298622.209,1538095470393180309.6706,79416,10.537,0.0059,0.0003
21821,33717,11896,19402,2153016333.1953,1529676859929959251.8859,11897,12.0879,0.0026,0.0052
1715,100198,98483,1761,2158851950.0583,1540519172192543705.9559,98484,17.6674,0.0002,0.0058
27396,69831,42435,7782,2154779240.7849,1540264489617331457.6801,42436,28.0737,0.0024,0.0049
28359,119766,91407,9327,2145349331.2227,1529989867541931860.8064,91408,9.1018,0.0024,0.0012
15243,19295,4052,30834,2141466667.606,1541605182670209244.1386,4053,2.3947,0.0073,0.004
12850,42237,29387,3919,2143295492.9311,1534016140064865831.2556,29388,4.0403,0.0042,0.0012
20921,57501,36580,6503,2147386782.3124,1533935226325779431.5699,36581,2.8594,0.003,0.0021
2242,78207,75965,13556,2146686225.7151,1538368205325621678.424,75966,7.6801,0.002,0.0014
23314,44459,21145,14279,2138279890.2691,1532935969159965775.9064,21146,9.7791,0.0065,0.0019
18074,32848,14774,25443,2155816118.5925,1544098793507319338.4277,14775,6.6002,0.0019,0.0072
19600,26372,6772,13104,2167816767.7257,1540507631912001450.0051,6773,5.058,0.001,0.0103
21014,103398,82384,31321,2147487789.8856,1536239542133265850.5703,82385,5.5707,0.0018,0.0016
3959,64894,60935,6761,2144466110.0212,1532655134373259823.3219,60936,2.2334,0.0023,0.0009
8782,70610,61828,23687,2143297807.9511,1552941692393842927.7883,61829,12.9854,0.004,0.0027
19401,58644,39243,6538,2139360828.9961,1531141117091840323.9159,39244,15.450,0.0069,0.0021
25414,31471,6057,25917,2144089004.9731,1559557641075888189.3629,6058,4.783,0.0086,0.0062
16664,100373,83709,26801,2152390404.6715,1551088535515534038.2669,83710,8.5983,0.0016,0.0039
31424,61988,30564,5063,2129429989.995,1520902186579152747.4244,30565,16.8766,0.0095,0.0003
2928,78981,76053,16406,2147184619.7367,1531031947910010025.5349,76054,7.038,0.0015,0.0018
14379,30269,15890,18599,2160064565.7675,1546490995785245585.8741,15891,13.7068,0.0019,0.0092
31282,129325,98043,8767,2149817071.2235,1525398302383466525.0247,98044,12.1363,0.0021,0.0036
6375,47438,41063,5161,2151271972.3938,1538271182351194817.7647,41064,10.438,0.002,0.003
19491,34967,15476,13652,2145373268.4219,1529458809698602072.1189,15477,11.0205,0.0042,0.0046
30416,38162,7746,30963,2168571805.6355,1527547403565259084.0873,7747,7.3036,0.0039,0.011
26274,34020,7746,14652,2141915705.6413,1518904971799413064.8163,7747,6.7352,0.0097,0.0036
12900,93094,80194,3375,2145589281.9409,1542960820093990494.2505,80195,7.7283,0.0024,0.0013
10905,89824,78919,14,2144083480.5078,1534276744164893475.4344,78920,6.7501,0.0025,0.001
28664,32814,4150,14870,2147204364.8371,1539308083242824052.7829,4151,3.3763,0.0057,0.007
20052,84623,64571,18798,2145355429.5831,1536458239681833357.0563,64572,4.1944,0.0024,0.0009
5093,66378,61285,18960,2146980731.5913,1538846881472453780.7542,61286,11.6129,0.003,0.0014
12587,26854,14267,7983,2159804196.8748,1566890320496936666.2797,14268,20.2059,0.0051,0.0111
2911,76894,73983,14898,2149032887.8529,1525069914928690938.1254,73984,15.0601,0.0018,0.0032
26272,111092,84820,23330,2136686176.9988,1526883636329132179.1989,84821,26.7535,0.0053,0.0009
25761,114683,88922,19132,2152728111.3313,1537099189777190695.3171,88923,12.9742,0.0007,0.0042
13390,49534,36144,3549,2152182830.8451,1530099940684257748.6694,36145,5.9871,0.0015,0.0037
19676,96310,76634,15038,2151337270.0108,1540181878687197601.7216,76635,6.5151,0.0004,0.003
16101,58076,41975,29612,2160151231.6734,1540709823346160115.9432,41976,8.3814,0.0002,0.006
19081,48014,28933,15122,2134730312.4974,1548148700074588466.8664,28934,8.5177,0.0069,0.0004
18529,65870,47341,221,2140615966.5245,1550818576009848472.6819,47342,12.7263,0.0043,0.0015
21671,94369,72698,22818,2152771735.9461,1543895482233712651.07,72699,8.8253,0.0009,0.0036
105,72394,72289,10094,2153997011.523,1549628183684510982.7919,72290,18.5793,0.0017,0.0039
22287,63583,41296,19168,2163132855.3788,1533330864462533973.4389,41297,10.6778,0.0002,0.0065
25676,28466,2790,26730,2110056110.8058,1552844792395494790.0103,2791,13.2944,0.0179,0.0044
21825,38226,16401,23098,2122568712.5616,1551045639977754456.4097,16402,17.1332,0.0146,0.0012
23939,109017,85078,24750,2157401992.1407,1534192969186813596.4876,85079,9.6535,0.0003,0.0043
3551,6857,3306,503,2120288665.5552,1510399476958118598.2095,3307,9.8761,0.0214,0.0052
21282,52513,31231,11637,2150630881.959,1539417874145911729.1868,31232,7.2818,0.0012,0.0027
13973,107579,93606,14421,2145568566.5183,1537525596092340440.2005,93607,7.6652,0.0021,0.001
7109,18635,11526,18790,2160769771.8537,1522151558443992099.8624,11527,8.729,0.0011,0.0081
7977,101677,93700,30847,2141599277.7361,1529891150435604783.8208,93701,15.8748,0.0034,0.0012
2826,59724,56898,26535,2156958613.6245,1527880130351345782.304,56899,13.6542,0.0019,0.0059
16917,44472,27555,19045,2133950881.4544,1536866948199345351.8026,27556,8.0165,0.0073,0.0012
24200,103425,79225,29449,2141857724.5877,1535615128248344464.8471,79226,13.5957,0.0027,0.0009
6386,17038,10652,2575,2176059256.9384,1536905554014360066.1456,10653,7.8552,0.0003,0.0118
14064,55522,41458,29897,2145374658.5986,1537285678133153650.809,41459,9.5502,0.0031,0.0016
29362,116458,87096,23847,2139147386.3581,1544546675986873522.9894,87097,22.2653,0.0056,0.0005
29719,43712,13993,12479,2133939672.3541,1551540482825820139.6938,13994,7.0224,0.0082,0.0023
8103,44118,36015,18150,2138590367.8065,1545940598691870014.4652,36016,11.750,0.005,0.0011
25758,33484,7726,5953,2112943178.6388,1533346193453361579.58,7727,7.2192,0.0155,0.001
31685,69978,38293,3381,2157763555.1423,1554719710621443885.8988,38294,16.0223,0.0015,0.0068
12589,78474,65885,11400,2150091009.5606,1543558420522515703.9776,65886,2.8372,0.0013,0.0025
17845,34078,16233,11246,2154550240.7845,1545066222581128136.489,16234,13.5054,0.0028,0.0065
16409,70457,54048,1249,2149495288.0766,1533697534456602940.4155,54049,2.6442,0.001,0.002
1688,15158,13470,12813,2113424588.5952,1541604393978949312.3118,13471,15.769,0.0144,0.0015
16538,98745,82207,3735,2150772457.3474,1540068372167464511.3999,82208,2.6377,0.0004,0.0026
960,42366,41406,2230,2141595504.1195,1555280589346342416.3553,41407,13.4132,0.0041,0.0039
2091,37220,35129,25892,2146383293.0527,1540520975463874018.2563,35130,4.5145,0.0028,0.0017
18639,36289,17650,22424,2149150460.4101,1535679970039831572.6544,17651,3.8244,0.0028,0.0039
4716,83674,78958,16392,2139114409.0317,1542677432987885872.9908,78959,11.8124,0.0036,0.0005
27677,91324,63647,3637,2150996999.1099,1545903272629148255.4723,63648,8.3763,0.0017,0.0028
5752,7780,2028,29789,2134687846.8245,1531344364703331573.0367,2029,11.5708,0.0156,0.0066
18441,76182,57741,27307,2154810837.3215,1542208058927114862.2397,57742,7.4505,0.0004,0.0036
21339,114087,92748,18983,2146215852.259,1539705814456984091.5683,92749,5.1766,0.0018,0.0011
6844,81929,75085,19108,2154814694.7305,1532426491226335555.1458,75086,5.5453,0.0011,0.0046
2636,58315,55679,19680,2142577368.5023,1528887604186688356.2707,55680,8.6074,0.0041,0.0015
9715,85965,76250,21078,2140990654.7819,1540261968232982896.979,76251,8.1402,0.0031,0.0011
24382,59100,34718,13852,2135966695.534,1520742976274119002.2539,34719,16.2186,0.0063,0.0021
15711,93378,77667,21289,2140111080.7575,1535398314216769947.9495,77668,23.2471,0.0047,0.0006
24684,97284,72600,11299,2154327532.4293,1537772272102334872.3054,72601,4.1624,0.000,0.0033
24162,108410,84248,11545,2147461487.9776,1535351639972177142.7289,84249,5.520,0.0014,0.0016
29862,107711,77849,275,2152579760.3913,1541955086573980185.4343,77850,11.3314,0.0019,0.0037
14138,104519,90381,2396,2153163426.9225,1541366682386489621.1305,90382,12.9421,0.0013,0.0037
7649,43757,36108,18466,2157565408.5237,1530708460320675136.5064,36109,17.4366,0.0002,0.0054
28909,116992,88083,6907,2148670908.6691,1536879019952323413.4971,88084,4.8822,0.001,0.0015
2169,48590,46421,6483,2149558089.244,1547311922319490621.1114,46422,4.6519,0.0015,0.0029
26207,44339,18132,2456,2155028438.853,1525725657956973988.2077,18133,5.1738,0.0021,0.0059
31066,113382,82316,13184,2141114353.5676,1538151690735171366.5811,82317,6.0576,0.003,0.0001
16476,110363,93887,13285,2142979622.2089,1532452402597130790.4918,93888,8.8571,0.0038,0.0009
9373,80597,71224,27471,2146535280.3683,1539592083952036962.9369,71225,1.9889,0.0013,0.0008
22229,54545,32316,23903,2150461416.0933,1536641714526264759.8135,32317,12.5438,0.0021,0.0032
25183,105313,80130,9195,2141727018.1456,1539456771177673725.8496,80131,4.3557,0.0025,0.0001
23165,121309,98144,2428,2150739377.1328,1534484845973706999.3729,98145,5.3261,0.0009,0.0025
25318,109703,84385,9619,2143023867.3347,1539882364414561112.6587,84386,16.9242,0.0048,0.001
6090,12910,6820,10368,2159157240.3439,1541389891037708898.8294,6821,2.7995,0.0012,0.0079
18129,30130,12001,28134,2160206773.5393,1542846984705965028.5944,12002,8.8725,0.0013,0.0091
23882,60950,37068,27404,2139738326.8541,1532558814770307024.5592,37069,4.5651,0.0045,0.0006
32254,72388,40134,30273,2153937931.8995,1539479464639233560.6443,40135,8.6251,0.0009,0.0054
18174,28056,9882,30232,2160425915.1929,1528763609542146000.0751,9883,6.669,0.001,0.0083
19400,101705,82305,255,2146906523.4689,1538535972056663919.5859,82306,3.7019,0.0016,0.0012
16200,78544,62344,23834,2140148227.6071,1547318884028033345.9132,62345,10.450,0.004,0.0013
31335,127570,96235,20280,2150117577.1582,1547942990982864912.0557,96236,12.6864,0.0018,0.0032
3794,70795,67001,23021,2131088239.8714,1533428138683709833.3382,67002,18.2112,0.0063,0.000
30815,128605,97790,25449,2148407064.6049,1539962889026902714.0538,97791,0.675,0.0012,0.0017
8747,93428,84681,30055,2135991855.6103,1540442006811611851.1997,84682,17.5033,0.005,0.0005
26600,63945,37345,3587,2136760434.9354,1537063838176500514.9265,37346,12.1371,0.0061,0.001
9226,95253,86027,16640,2148713583.8762,1536772699581774852.6317,86028,7.3744,0.0017,0.003
17340,59071,41731,8853,2148237308.6105,1542912669434098001.4316,41732,3.9534,0.0018,0.0024
11329,108634,97305,13491,2146257376.6477,1536509726736970020.5418,97306,15.5169,0.0028,0.0021
12043,29115,17072,9608,2130749977.307,1522015537836492370.3168,17073,14.919,0.0102,0.0016
17123,93879,76756,30873,2157201415.2304,1540030790740896925.039,76757,6.0017,0.0004,0.0047
14090,69325,55235,14750,2158322227.3387,1538013577313364092.1434,55236,10.2614,0.0007,0.0054
22954,26940,3986,19329,2128586464.2659,1552278791083170833.1829,3987,7.3774,0.0124,0.0033
18322,65191,46869,27441,2154710970.3087,1534055257210610109.4013,46870,3.9057,0.0015,0.0039
2930,75041,72111,14721,2155531221.1485,1543822339826785843.8039,72112,6.6758,0.0004,0.0045
26828,96923,70095,30561,2160963666.9636,1534109656260495026.7438,70096,18.134,0.0002,0.0068
11490,40410,28920,21520,2151033028.3329,1547128718827162051.9005,28921,10.2176,0.0034,0.0042
1570,38506,36936,31621,2149514316.8306,1542706437776648131.7461,36937,3.8978,0.0017,0.0034
32719,71504,38785,4621,2134703964.1481,1529724491516067432.8235,38786,11.116,0.0056,0.0005
23174,120512,97338,13000,2151042028.7235,1541295353257587848.0587,97339,7.754,0.0012,0.0027
2166,26637,24471,14650,2143342165.2274,1540958194942031791.2943,24472,5.7265,0.0034,0.0016
17481,37714,20233,21402,2167547230.0974,1523961058241875380.6253,20234,22.5112,0.0003,0.0107
32645,43008,10363,10020,2151123051.7972,1515704690106775535.5519,10364,10.9128,0.0049,0.0079
29325,56745,27420,14112,2145190265.3257,1532619344545400114.8132,27421,3.1248,0.0028,0.0019
29201,58392,29191,28632,2164573708.0695,1528339707538929267.3096,29192,20.4877,0.0021,0.0089
267,45212,44945,17948,2145469849.199,1538143239703889230.2254,44946,9.9941,0.0021,0.001
9413,20167,10754,21979,2134627405.5203,1532275013206963371.5219,10755,7.3707,0.0091,0.0021
28071,108519,80448,19642,2151621605.9314,1535519693860868505.12,80449,5.0381,0.0002,0.0022
25559,52981,27422,27330,2154251207.0275,1536418719042431584.0803,27423,8.9011,0.0005,0.0044
2825,16261,13436,15352,2134196645.74,1537452255287043181.3865,13437,4.0895,0.0073,0.0005
26576,108330,81754,13472,2148828421.5784,1532864343609518403.2789,81755,5.6038,0.0014,0.0025
9815,70049,60234,19114,2148639999.9572,1543991474479771913.1745,60235,5.3426,0.0015,0.0026
15715,33324,17609,22875,2129752660.7507,1524241860653580056.2763,17610,9.1823,0.008,0.0002
17472,75584,58112,6311,2152180224.9412,1537160717701448698.2484,58113,4.9834,0.0007,0.0035
20065,95713,75648,3921,2141636961.7972,1537596415766200134.0857,75649,7.4527,0.0031,0.0002
24774,65178,40404,4487,2145841792.5103,1545455463646511931.1757,40405,8.5474,0.004,0.003
23934,108637,84703,11773,2140638369.3141,1525155755543708687.7024,84704,14.4263,0.0048,0.0016
6854,18654,11800,23357,2138308044.0014,1539282929256255620.5817,11801,13.6324,0.0115,0.003
9422,47744,38322,8641,2149956975.1261,1539831961161729560.0094,38323,9.0334,0.0016,0.0039
23869,91331,67462,28573,2149252966.0206,1543490883785637882.7153,67463,9.0222,0.0014,0.0034
26885,57162,30277,547,2150541223.3933,1537840955516475204.3348,30278,8.1587,0.0019,0.0045
26785,59801,33016,30502,2142536145.5557,1532368276784735005.2608,33017,5.2098,0.0045,0.0011
10557,37142,26585,8584,2154826167.9452,1524097959241573261.1298,26586,9.6101,0.0026,0.0051
12070,18290,6220,15139,2165184050.8434,1532304511741743246.6661,6221,6.7695,0.0028,0.0101
20101,24152,4051,17309,2174862197.3993,1555075337621092249.0414,4052,5.3003,0.0011,0.014
13706,60076,46370,17281,2138741017.1922,1534499412942033224.7905,46371,11.088,0.0048,0.0003
28793,57600,28807,27321,2138181897.0685,1538242518945290449.2357,28808,4.5336,0.0058,0.0002
16073,46583,30510,9682,2154774362.945,1538182337777770155.9997,30511,3.8827,0.0005,0.0048
18527,68613,50086,30337,2149984913.8697,1526186346364584867.9693,50087,8.4019,0.002,0.0031
19098,66399,47301,25509,2142172333.2959,1547136462211620994.5661,47302,14.950,0.0044,0.0013
14992,91892,76900,7425,2146770828.6773,1529003975233926301.1367,76901,9.9677,0.0018,0.0027
18679,64019,45340,3666,2137821655.4078,1534955484342789689.3859,45341,4.6188,0.0044,0.0004
24279,97487,73208,4956,2141567362.4144,1538936638349505468.3018,73209,4.6733,0.0027,0.0008
13963,104671,90708,2702,2133094414.6598,1539327021900618610.3198,90709,29.8032,0.0053,0.000
18912,107588,88676,20921,2137596275.7229,1533453931402059222.118,88677,11.8079,0.0041,0.001
8208,46781,38573,8800,2146857347.3007,1541940979350232404.6835,38574,12.5949,0.0029,0.0021
5462,17205,11743,29500,2112637737.7779,1532621571096838332.9629,11744,21.6303,0.0164,0.0005
6778,106099,99321,24718,2151843745.6945,1542909767322696510.116,99322,9.3989,0.0008,0.0026
14254,52920,38666,10913,2157276689.0328,1535295222480840296.4691,38667,17.7035,0.0011,0.0073
125,13017,12892,19998,2151179128.5444,1516437159919660425.2678,12893,9.0594,0.0061,0.0079
23286,115607,92321,5310,2145698594.1142,1535986676853165557.218,92322,4.3907,0.0016,0.0011
26281,108853,82572,1122,2152912568.9866,1536655519283134356.0294,82573,5.3097,0.0006,0.003
947,39298,38351,32098,2153842668.0048,1525866522453136037.2125,38352,9.3301,0.0018,0.0049
21572,63313,41741,30728,2146353322.6186,1549538550575904399.642,41742,11.7827,0.003,0.0033
31829,100845,69016,24316,2149688916.1084,1536583904447459906.1954,69017,3.5625,0.0005,0.002
14080,30865,16785,8206,2144045006.8304,1522026150249857511.6679,16786,2.5093,0.0055,0.0042
16163,78131,61968,25242,2125646014.3193,1536201202427563031.678,61969,27.0337,0.0076,0.0003
4123,49830,45707,13352,2155081539.2537,1527610883414393289.7887,45708,16.0005,0.0019,0.0057
25109,107288,82179,29494,2143954278.8792,1535251813255441712.956,82180,1.435,0.0023,0.001
32744,88231,55487,10067,2148864502.8149,1542122728498538478.4703,55488,6.4619,0.0016,0.0025
4907,18876,13969,5341,2199835780.4804,1519795738347897218.3196,13970,47.6648,0.000,0.0195
22257,89368,67111,12366,2147043616.071,1538539495787561358.1447,67112,6.134,0.0018,0.0016
30970,48187,17217,8076,2129372760.1421,1518443937088644516.3102,17218,12.840,0.0093,0.0034
31557,122794,91237,16311,2145099445.0275,1535799477901765280.3025,91238,5.7212,0.003,0.0008
17611,98135,80524,12243,2146128040.3062,1529433035394741535.5122,80525,7.1868,0.0021,0.0018
26898,72282,45384,29621,2132541352.7174,1540398660104157501.1009,45385,13.0388,0.0069,0.0006
8350,23795,15445,13593,2148210764.4367,1528028822286071690.5771,15446,4.6613,0.003,0.0047
18551,29138,10587,7399,2148772124.7089,1503457026583156191.0568,10588,14.707,0.0071,0.0083
13860,45137,31277,4839,2146193277.2898,1538223973005918357.9137,31278,6.1886,0.0027,0.0025
22088,81932,59844,15697,2142943074.5586,1546728083249620388.1894,59845,16.160,0.0051,0.0019
18971,105110,86139,26446,2155427426.1399,1536139696517584072.9993,86140,9.5625,0.0006,0.0055
31486,108172,76686,26772,2134927763.475,1539184949225432248.1612,76687,18.0125,0.0071,0.0004
8484,24921,16437,507,2153083291.2282,1523153617301032351.3111,16438,18.8178,0.0029,0.0054
16476,66166,49690,13898,2145421241.3511,1540636039047021785.6029,49691,18.8278,0.0043,0.0029
1834,15675,13841,62,2161032458.4377,1530935838710754854.7797,13842,3.4324,0.0006,0.0063
7475,95384,87909,21020,2154158855.6393,1541436879064304661.3338,87910,8.9589,0.0003,0.0047
24179,58794,34615,28127,2127338721.1113,1552848894119037714.2634,34616,24.3853,0.011,0.001
7544,89073,81529,20657,2161035769.2698,1532900176812815299.6625,81530,29.5843,0.000,0.005
16146,55632,39486,459,2142848239.0215,1532207668282912256.4339,39487,5.8921,0.0041,0.0017
4890,79475,74585,26755,2152219306.8644,1533794764177513503.7091,74586,17.6935,0.0014,0.0046
9316,86645,77329,25961,2144157508.3437,1542962880657338329.3104,77330,8.0929,0.0023,0.0009
9876,48136,38260,29385,2132252612.5621,1524451508575072885.6754,38261,15.6658,0.0067,0.0004
13306,91885,78579,14336,2146467185.4818,1545418145449981840.5572,78580,10.447,0.0019,0.0015
16649,79955,63306,31671,2144670040.2856,1549836994193504741.1396,63307,8.8493,0.0043,0.0025
1283,81009,79726,14054,2146404141.6589,1541302881435400718.7778,79727,16.1972,0.0035,0.0019
948,4469,3521,19815,2161175818.3109,1477853273566314696.7338,3522,15.666,0.0102,0.0175
29388,73101,43713,22638,2158809127.5236,1541384651098089363.6613,43714,7.8286,0.000,0.0044
30929,98718,67789,6193,2152725228.7953,1536044983916587824.9018,67790,15.4703,0.0014,0.0043
29147,103182,74035,5714,2141710131.5291,1542185275540118685.794,74036,7.8616,0.004,0.0006
6778,105605,98827,31694,2142599253.3931,1534312678034829264.4924,98828,6.1174,0.0032,0.0007
12923,108370,95447,18134,2153968857.8262,1530163249843068211.3183,95448,8.1764,0.0011,0.0033
24447,36672,12225,13498,2150705157.0727,1543456288900032001.9297,12226,4.8568,0.0026,0.0048
20299,26700,6401,26956,2170340992.0242,1534657860252770840.202,6402,18.4936,0.0029,0.0167
19700,53098,33398,18867,2132696415.4314,1535529037493445003.3636,33399,21.4423,0.0065,0.0004
20000,74030,54030,20301,2134943244.1394,1547805159693742574.45,54031,12.7451,0.0059,0.0008
9931,57349,47418,856,2154403161.5226,1533956413520160884.0278,47419,9.5801,0.0016,0.0044
12036,48898,36862,31195,2138669096.8063,1543373059997018129.4402,36863,6.0469,0.0049,0.0011
26367,78218,51851,6056,2139504170.5565,1549844718995351349.5711,51852,11.4404,0.0048,0.0013
29217,114085,84868,1947,2155327588.3744,1538418674330520575.2417,84869,14.9284,0.0002,0.0037
9881,85099,75218,14531,2145054823.3362,1548504484170251512.1794,75219,10.1344,0.003,0.0019
21981,57353,35372,21422,2152533164.2411,1534812996028230967.5906,35373,4.2951,0.0009,0.0037
26292,37745,11453,29256,2153618991.3841,1529538075762524708.671,11454,8.6332,0.0037,0.006
4568,99287,94719,22937,2145620389.7162,1536703477604423934.6357,94720,16.9354,0.002,0.001
30439,93733,63294,31978,2142750022.2547,1539719867747244121.4527,63295,2.0217,0.0029,0.0012
999,98843,97844,28947,2129508490.5662,1535911950638607208.2324,97845,28.0686,0.0071,0.000
16775,41701,24926,15783,2155878579.5392,1528057923980044523.0249,24927,10.9339,0.0009,0.0051
20306,46115,25809,17595,2139822747.6923,1544873619563379424.671,25810,5.1833,0.0054,0.0015
3934,21716,17782,10015,2148496282.2345,1545636936315225729.7584,17783,5.9568,0.003,0.0045
12336,104888,92552,20406,2149036419.1768,1535182254092446822.6574,92553,11.2996,0.001,0.0015
4696,35213,30517,30491,2157670831.0781,1546533755011982446.3609,30518,4.1403,0.0003,0.0051
25339,121772,96433,7643,2146018698.5227,1534064603900110769.718,96434,8.4298,0.0028,0.0016
23139,117244,94105,14280,2139805786.7554,1531145446661707618.6192,94106,7.8726,0.004,0.0005
23188,115699,92511,29591,2150087194.9888,1534326260852622291.8198,92512,6.191,0.0014,0.0021
28819,37919,9100,26242,2143459328.5277,1523718667161080092.2343,9101,4.0618,0.0057,0.0048
2804,90999,88195,14415,2151721311.9297,1538785318310579014.6953,88196,3.2669,0.0006,0.003
9325,64135,54810,4146,2155387180.6945,1531638437908065205.7895,54811,7.2871,0.0005,0.0042
26114,36415,10301,12078,2120969060.2222,1534778690331514416.8393,10302,10.0075,0.0142,0.0003
12795,20549,7754,13134,2124363509.909,1542186777172566535.4065,7755,7.7932,0.0133,0.0024
29049,38507,9458,7469,2113821379.8838,1512495154084168117.9399,9459,24.4684,0.0148,0.0001
20987,71934,50947,3249,2141962020.6384,1532241981364194752.7416,50948,7.8919,0.0046,0.0009
655,92575,91920,22011,2151943282.002,1551026723099485752.0114,91921,17.9956,0.0019,0.0034
5383,32994,27611,15355,2157243003.0654,1524413673851100823.8725,27612,8.7542,0.0021,0.0058
30937,127490,96553,6194,2153491825.4047,1538978054740821808.9242,96554,5.459,0.0006,0.0029
10711,103923,93212,1053,2150989084.1254,1544797001216946823.9696,93213,11.7005,0.0013,0.0036
14899,29538,14639,5609,2144933557.0781,1541503460213627126.2709,14640,6.7188,0.005,0.0032
18306,29403,11097,28462,2165955875.5519,1527727263749407722.4189,11098,26.0409,0.0041,0.011
25801,92859,67058,2876,2160432980.4884,1537800155306512600.8344,67059,12.4044,0.0002,0.0061
13756,30666,16910,6568,2155570682.0051,1549685425435663304.542,16911,2.5958,0.003,0.005
7579,59897,52318,20982,2143417863.52,1525090049608731414.0834,52319,13.410,0.0041,0.0018
9101,56272,47171,21213,2153783120.0664,1537973294165573896.0655,47172,4.8964,0.0013,0.0038
31230,121894,90664,25943,2145266485.5515,1537790907811664217.1768,90665,4.1567,0.0016,0.0008
28819,43020,14201,5159,2147293668.4142,1526851773521287998.7055,14202,15.5173,0.0067,0.0057
19821,115108,95287,19544,2148114548.9274,1537119195147092842.236,95288,0.6565,0.0009,0.0015
22211,58398,36187,21813,2135891600.6778,1527855658164408586.2278,36188,6.2324,0.0066,0.0009
22028,69531,47503,31344,2141142316.311,1541133291945208112.5184,47504,5.2439,0.0038,0.0008
28223,53430,25207,17745,2136707575.1369,1541581368551433904.5561,25208,10.9146,0.0061,0.0015
5516,101123,95607,16388,2148301971.0294,1538523568740192805.7852,95608,5.4516,0.0008,0.0015
27770,75412,47642,1152,2152831824.375,1535372371599164445.0926,47643,6.4983,0.0011,0.0034
9772,91753,81981,21336,2153237383.6936,1537941423108114408.26,81982,5.9647,0.0003,0.0028
31247,55696,24449,12788,2144753407.3336,1539380103656218908.7159,24450,10.7811,0.0055,0.002
23330,60993,37663,17142,2159117130.2052,1554983395074452211.3245,37664,10.6179,0.0017,0.0069
32552,95115,62563,25577,2141745470.4897,1542942934280629920.4368,62564,3.243,0.004,0.0013
8301,106686,98385,29226,2149815398.0868,1539554154520107295.8855,98386,4.5624,0.0009,0.0018
29411,71457,42046,15170,2145765269.5154,1544277861974144786.2154,42047,12.3741,0.0054,0.0029
9737,101322,91585,15336,2147053205.9722,1541627767230238810.6088,91586,4.1825,0.0018,0.0017
7777,83571,75794,6918,2136324985.4377,1534437405161163111.4004,75795,10.6325,0.006,0.0005
32136,47267,15131,13401,2159767841.702,1539027911099670645.6879,15132,16.6111,0.0033,0.0076
27244,101103,73859,10421,2147698723.5534,1540127982946932893.8206,73860,5.106,0.0017,0.002
22074,109894,87820,11888,2144770648.572,1542017271242854554.1494,87821,6.4054,0.0031,0.0014
28574,47227,18653,10938,2149613779.241,1539678427635371761.0456,18654,2.7806,0.0021,0.0033
14702,36591,21889,7042,2134185212.5277,1539382357815192561.4742,21890,8.7752,0.0064,0.0011
10956,89214,78258,32523,2151986126.7749,1530678728641337825.8682,78259,9.0254,0.0015,0.004
18876,50849,31973,32037,2146766805.7084,1535237799667980024.6074,31974,20.1804,0.003,0.0046
17037,82662,65625,32290,2142794734.6258,1533568889929319931.5295,65626,7.3676,0.0037,0.0009
3296,14405,11109,30672,2128842236.241,1550944787217359977.113,11110,8.1517,0.0089,0.0038
17295,65446,48151,2123,2135068658.664,1535137203488900296.0199,48152,18.755,0.0069,0.0014
12580,92773,80193,32299,2147820469.5906,1543622805218826370.6932,80194,5.4257,0.0021,0.0021
26262,51330,25068,19082,2155232216.2403,1550060409372142326.408,25069,5.238,0.0026,0.0052
27595,96313,68718,14153,2153843789.6432,1534661878027517960.4957,68719,14.9789,0.0003,0.0049
29295,31325,2030,30969,2158736159.001,1544411061903799121.5303,2031,12.7436,0.0073,0.0138
31523,58934,27411,31427,2151582337.8563,1539125757861545918.2649,27412,4.5063,0.0012,0.0036
16749,67104,50355,32149,2159641774.7025,1539317441218330570.4291,50356,20.2391,0.0006,0.0062
28929,108471,79542,10202,2152626102.3796,1542660898049999540.8096,79543,5.8187,0.0009,0.003
31893,111768,79875,18316,2149134002.7656,1537592238626030579.0844,79876,2.1729,0.0006,0.0015
930,24195,23265,9287,2130650240.8058,1549599029131877463.0657,23266,11.0265,0.0072,0.0007
2483,7951,5468,6425,2158599706.4911,1566164351808701350.6057,5469,11.1315,0.0067,0.0154
1647,18683,17036,2673,2147579606.8965,1537668407288549380.2393,17037,7.1855,0.0034,0.0056
10125,11541,1416,18547,2136869964.9485,1506179988152677734.4427,1417,8.686,0.0206,0.0149
17708,46317,28609,5076,2152152773.6109,1543657555112367905.0805,28610,4.3779,0.0023,0.0048
26489,91573,65084,24383,2151074023.4021,1543207735217805916.3706,65085,9.226,0.0012,0.0035
21390,106157,84767,12290,2159919713.1308,1542209590104132224.2979,84768,14.9041,0.0001,0.0053
29167,116591,87424,15751,2158246468.2327,1536752351255693715.907,87425,8.1602,0.0005,0.0046
12253,102333,90080,31059,2149519228.4325,1534765063623509243.7895,90081,2.282,0.0013,0.0018
32558,96060,63502,24424,2142690318.7043,1534802886061464356.0589,63503,7.7806,0.0028,0.0004
17359,116324,98965,1824,2155707541.6324,1539169992416149063.7898,98966,9.7352,0.000,0.0035
6526,103047,96521,28855,2149915680.1726,1540234076486511219.1608,96522,6.8279,0.0011,0.0024
20810,61052,40242,31345,2138447746.2226,1524203601106748591.8213,40243,9.2251,0.0045,0.0021
14688,53514,38826,31290,2157096755.7877,1528246458315981848.1273,38827,12.4691,0.0008,0.0069
9118,22924,13806,1621,2147445505.1497,1518608626511277485.07,13807,4.6155,0.0051,0.0052
21657,67819,46162,14464,2152358775.4762,1549286824584238740.6817,46163,4.9909,0.0015,0.0049
10326,30007,19681,24669,2171895552.0123,1516557162157328958.5677,19682,25.8516,0.0029,0.0145
14056,41134,27078,26693,2132137400.4905,1532632866109106005.4654,27079,10.4993,0.0074,0.0008
22389,50823,28434,3773,2153568802.4863,1532979606531602819.49,28435,7.203,0.0012,0.0047
18927,102617,83690,14642,2144780824.6645,1537789559282926094.9436,83691,7.5737,0.0022,0.001
16440,103640,87200,22889,2133628317.4787,1540220396584527498.0537,87201,18.4427,0.0053,0.000
13215,87060,73845,25331,2145731227.7374,1540492148754340117.5672,73846,13.0378,0.0024,0.002
25790,106772,80982,5502,2148487929.3326,1545305480115169719.8881,80983,7.4721,0.002,0.002
25002,58782,33780,11703,2134866694.5093,1533440152968651789.6511,33781,11.8521,0.007,0.0004
3477,61497,58020,20742,2144422562.9602,1538182193593038149.1748,58021,7.6159,0.0027,0.0015
13928,93639,79711,9432,2143243515.1178,1530598632727229068.0421,79712,10.3749,0.0045,0.0012
12999,86424,73425,23184,2149395567.9878,1539069606338749074.2626,73426,2.3578,0.001,0.0018
29877,74509,44632,23594,2143607861.6348,1539642364816044247.2659,44633,15.9397,0.0029,0.0024
4545,39842,35297,24002,2137649527.9742,1530072372008616309.8058,35298,4.7733,0.0047,0.0006
15457,104540,89083,16344,2146026480.6781,1543315639259699548.3411,89084,7.3821,0.0024,0.0018
18508,62848,44340,8094,2156120947.7857,1529925666270566967.0633,44341,12.5561,0.0003,0.0051
32245,124651,92406,15629,2153836622.2555,1539208904227177504.1996,92407,5.2997,0.0001,0.0027
31694,54389,22695,25525,2155348941.3082,1519050901654168703.8036,22696,17.574,0.0027,0.0078
23427,75044,51617,15021,2157859928.6461,1531770565503600833.4076,51618,11.2326,0.0002,0.0059
28028,54098,26070,13101,2146357429.2411,1536051650902810493.8191,26071,12.0849,0.0036,0.0036
4389,98430,94041,16868,2146576175.9338,1543872169324384990.9527,94042,8.8854,0.0026,0.0022
805,90594,89789,8966,2149641065.7751,1532894066201233823.7922,89790,4.9858,0.0011,0.0019
7620,12075,4455,24434,2078061934.6526,1527899895222630943.5176,4456,17.868,0.0287,0.0004
23098,123069,99971,16296,2149515642.0407,1535932840143850034.6852,99972,3.2229,0.0005,0.0012
30449,51849,21400,2286,2145719875.3537,1533875061849259198.3236,21401,11.3895,0.0044,0.0035
7911,88597,80686,6089,2165653033.3944,1540839603505085381.8026,80687,22.1946,0.000,0.0062
12170,81588,69418,16281,2145141515.205,1537328805238611909.3696,69419,6.1523,0.002,0.001
8898,74680,65782,6031,2149134746.6475,1536931348033199948.5819,65783,8.3521,0.0012,0.0029
23761,93263,69502,28886,2138284595.0322,1542943471641001214.5798,69503,12.3542,0.0052,0.0002
10928,51907,40979,10450,2163460662.7996,1538068716116302334.1348,40980,9.8524,0.0002,0.0074
18379,65446,47067,11782,2140308109.0962,1525454166663178175.6227,47068,9.5222,0.0042,0.0013
16890,95124,78234,15954,2148838630.316,1536795350702905382.3528,78235,6.2735,0.001,0.0015
16147,39462,23315,13386,2177306178.2116,1528777133166207603.8091,23316,23.8565,0.0001,0.0107
5896,82958,77062,11376,2141525897.3646,1536068006256703779.9605,77063,17.2735,0.0053,0.0007
2803,35186,32383,12849,2152571356.1482,1538190288886846955.3239,32384,3.8501,0.0011,0.0028
23600,107722,84122,4378,2142160272.6642,1534512372426880360.3372,84123,4.3855,0.0034,0.0004
29598,104751,75153,22726,2145132000.0081,1543302507491609900.854,75154,12.0264,0.0034,0.0025
25193,81197,56004,172,2131727817.1346,1550845294495994833.7364,56005,36.7419,0.0079,0.0009
23002,101608,78606,13311,2135094146.6092,1544895801543035651.6815,78607,21.2447,0.0049,0.000
19713,30829,11116,9338,2143993064.1798,1563323310977580818.4834,11117,5.8893,0.007,0.0055
29668,119410,89742,9975,2154000120.7222,1536764203509694574.8083,89743,8.5969,0.0008,0.0034
31564,67787,36223,28556,2153885268.0936,1548367928837900457.1343,36224,5.6652,0.0012,0.0048
185,91165,90980,4503,2138745525.3303,1545187827858798598.7006,90981,12.0985,0.0045,0.0005
9786,95353,85567,24442,2156932305.5942,1533265579328075632.1873,85568,13.4713,0.0003,0.0048
3783,96996,93213,24555,2144995155.0229,1541354020367180000.7064,93214,13.6876,0.0027,0.0012
2102,96365,94263,26551,2148927152.4721,1538209886442218093.3422,94264,9.7239,0.0012,0.0019
24604,44189,19585,27991,2155037542.486,1551520359850319658.4648,19586,5.4952,0.0021,0.0064
13497,97062,83565,12679,2149660535.3179,1535408145220351051.7138,83566,1.9416,0.0006,0.0016
14429,96472,82043,9838,2138604073.9799,1536430749588674520.1658,82044,7.6815,0.0038,0.0008
23082,24904,1822,16300,2080337242.2057,1491504065722553464.4267,1823,9.6394,0.0339,0.0017
22454,87093,64639,15282,2149811791.2149,1541201826908855348.137,64640,10.8505,0.0013,0.0029
30107,65552,35445,14195,2159906293.6723,1531288667214618405.0915,35446,10.0096,0.0007,0.0064
13828,74251,60423,26457,2148396735.9425,1535587814924044861.6544,60424,6.6192,0.0013,0.0017
25106,92587,67481,13707,2150276144.8896,1541413227482896274.9157,67482,13.0722,0.0016,0.0025
26814,76781,49967,26083,2151242932.0437,1538992485792370638.6851,49968,7.018,0.002,0.0028
15126,58961,43835,26514,2153570062.2656,1534922226623550129.0067,43836,4.2205,0.0004,0.0033
30066,86794,56728,12227,2147570816.298,1546319402811028256.5082,56729,6.2682,0.0029,0.0023
26523,96435,69912,12408,2146720470.9419,1540881951456537826.1686,69913,5.1782,0.0019,0.0012
20394,68369,47975,21821,2141559426.5025,1532744205562501790.2882,47976,12.5737,0.004,0.0018
30026,110936,80910,28628,2151947980.535,1532335193486387018.0913,80911,5.7133,0.001,0.0028
8147,57614,49467,31429,2159576477.1984,1551243340732815124.0559,49468,15.526,0.0019,0.0067
19252,77499,58247,1009,2133007822.5614,1530502119506591390.1969,58248,8.4596,0.0062,0.0002
1993,41167,39174,24813,2152299219.2037,1534269068767841875.9443,39175,8.3629,0.0011,0.0041
3778,43561,39783,3626,2152697579.3045,1542800180718714378.9152,39784,6.2986,0.0016,0.0048
10147,73563,63416,30876,2144978112.1904,1542169888465919428.0676,63417,6.5977,0.0024,0.001
3505,48311,44806,6014,2142700555.9774,1547186612645389111.1637,44807,20.922,0.0048,0.0025
278,24060,23782,403,2147751925.9812,1545645497399918973.0227,23783,1.3831,0.0027,0.0032
4190,32385,28195,14459,2153490267.2943,1549158541293406911.2487,28196,3.9957,0.0014,0.0044
12661,59038,46377,15433,2146314963.8919,1537776347798266896.8203,46378,11.1764,0.0027,0.0022
11105,41358,30253,16848,2157596532.7194,1538124447587711677.8406,30254,4.7026,0.0002,0.0045
23733,42749,19016,17111,2138792980.585,1533913939551871597.4133,19017,6.9015,0.0049,0.0003
26988,30551,3563,25090,2132214449.6908,1523539308664601705.6771,3564,6.0476,0.0106,0.0049
9060,42737,33677,17405,2136324763.7267,1541457659829673174.4676,33678,12.3203,0.0056,0.000
18248,104703,86455,29320,2145208796.9709,1538805270554125626.7088,86456,10.0229,0.0023,0.0014
30179,124288,94109,26219,2146465639.8762,1535162559475104767.3583,94110,8.7289,0.002,0.0011
21978,23276,1298,4227,2085215036.2664,1538696756275544943.401,1299,8.2682,0.0259,0.0007
20004,66924,46920,28310,2152118108.3089,1542777541093012705.1173,46921,17.3091,0.0018,0.0045
30170,87598,57428,32335,2147627746.1256,1544275963715576367.3124,57429,10.5715,0.0025,0.0026
9839,11104,1265,24371,2246618431.8412,1457068245137881992.6328,1266,14.7742,0.0052,0.0434
19869,38715,18846,11718,2173652473.3291,1564531053559294210.4363,18847,22.6201,0.0027,0.0122
21035,104788,83753,19887,2146662273.5349,1537566369949494717.6905,83754,4.9448,0.0024,0.0016
30215,62719,32504,28450,2162167372.9651,1538626384455476217.3565,32505,8.6261,0.000,0.0056
25608,96691,71083,29816,2147910751.1176,1543235962773092503.3028,71084,13.6301,0.0025,0.002
6055,20378,14323,9822,2149852376.5271,1513868871538244987.2884,14324,6.7087,0.0046,0.0064
12539,71778,59239,29276,2146310911.3274,1539925945006786842.7509,59240,6.8347,0.0013,0.0009
18631,111024,92393,20175,2153689542.4985,1542511073789962314.1862,92394,8.6293,0.0002,0.0038
21178,104652,83474,204,2144757000.4679,1536868580710593633.1507,83475,8.8964,0.0021,0.0008
2285,28096,25811,21936,2135819228.1939,1541140359939768995.7914,25812,17.8941,0.0063,0.000
20153,85130,64977,6580,2147642065.1849,1532531968523198970.6842,64978,5.5662,0.0016,0.002
19442,79069,59627,14589,2133954958.9012,1535803582269483458.3924,59628,17.1632,0.0051,0.0002
10910,110563,99653,13839,2151751737.646,1535876195919612667.1944,99654,4.2858,0.0004,0.0033
12282,87355,75073,9056,2147973220.3522,1536503439882112101.0536,75074,6.0087,0.0017,0.0016
11597,22058,10461,30411,2154449010.759,1542439422097463479.0411,10462,3.0684,0.0015,0.0066
9653,11772,2119,19076,2179744721.5604,1530840126223746810.7671,2120,9.5506,0.0054,0.0197
24563,48597,24034,6413,2129085543.2104,1529592053867853385.7121,24035,10.8423,0.0084,0.0008
24254,103652,79398,18220,2149050263.7093,1531950170891195024.7193,79399,5.3737,0.0013,0.0021
23512,75948,52436,25209,2146744162.6296,1539311110748026962.1707,52437,6.6556,0.002,0.0015
5254,70393,65139,11150,2144027239.0132,1538209827618072148.099,65140,11.7965,0.0045,0.0009
21730,74615,52885,31338,2153780646.4019,1531730181229649451.8981,52886,13.7061,0.0014,0.0046
26604,30330,3726,26721,2155052293.5192,1520547249163350004.8066,3727,6.5864,0.0089,0.0129
29118,87017,57899,11664,2149102731.8222,1529783719581816096.4718,57900,8.4911,0.0019,0.0025
2783,88886,86103,28593,2146831157.3571,1538166493246066787.5878,86104,7.215,0.0016,0.0016
2267,5148,2881,6461,2137461914.484,1506326976257650931.0166,2882,6.3234,0.0133,0.0075
9781,78316,68535,10609,2144371621.8882,1532341155205229928.3005,68536,5.7718,0.0027,0.0013
28836,96653,67817,23757,2148376084.9334,1537433735976816749.831,67818,5.0426,0.0011,0.0015
26568,123289,96721,9053,2151830241.1657,1527437589556885386.6005,96722,14.7556,0.0012,0.0029
23892,70916,47024,5147,2157259931.0041,1535212478821416707.8827,47025,10.8256,0.0001,0.0039
19899,94125,74226,32118,2149097267.5886,1536370146308017165.8417,74227,2.8344,0.0009,0.0016
4589,52665,48076,12871,2148009130.7604,1540666606771872306.58,48077,9.9838,0.0033,0.0018
2938,98166,95228,17215,2157413207.0584,1538307921289751872.058,95229,16.9137,0.001,0.0042
2178,101897,99719,25734,2150808370.141,1540432233609407885.2979,99720,13.6619,0.0011,0.0022
19498,35444,15946,13886,2132501926.4449,1542476517273738525.9552,15947,9.7343,0.0072,0.0013
30587,101087,70500,21231,2142919824.9631,1538081663447089677.6362,70501,12.0064,0.0025,0.0003
31543,122439,90896,30688,2147757792.8972,1537884924086428349.0637,90897,3.7281,0.0017,0.0015
19395,40680,21285,5954,2148029057.8616,1558886252082873071.5664,21286,9.631,0.004,0.0046
15144,41076,25932,5135,2135865063.3349,1543151566740667389.0299,25933,10.0135,0.006,0.0021
10189,70372,60183,14254,2146537692.9279,1549522584156681658.5453,60184,9.3767,0.0031,0.0033
12830,25784,12954,32300,2135280674.9677,1535671234423822513.8631,12955,9.9058,0.0085,0.0012
8155,85451,77296,6654,2145669628.6325,1534410237225151519.5576,77297,7.3036,0.0026,0.0019
17419,56046,38627,2753,2143575393.3565,1536256784500123818.8484,38628,5.3089,0.0032,0.0016
19617,108508,88891,6059,2151113795.514,1534559402773242081.8085,88892,6.4723,0.0004,0.0025
11848,102727,90879,20262,2151797237.2239,1543172004640339286.7766,90880,8.8011,0.0007,0.0026
27812,78505,50693,18674,2152596923.4022,1537562497639003474.9836,50694,13.8256,0.0025,0.0039
17895,96267,78372,25791,2146366155.4763,1542108832235972872.2128,78373,3.9053,0.0019,0.0011
25206,124762,99556,30894,2159255477.4765,1541102592337573801.3847,99557,18.2027,0.000,0.0055
8836,48740,39904,21443,2136195275.0237,1536991152623506785.3134,39905,11.193,0.0058,0.0001
22041,36907,14866,9119,2160724792.644,1550727098144775484.3556,14867,10.1255,0.0015,0.0085
25322,122985,97663,8250,2151631592.1815,1538970471084587462.3019,97664,7.0548,0.0003,0.0025
23910,64485,40575,9885,2148867563.3801,1539390615788308614.4249,40576,5.1039,0.0026,0.003
18617,84602,65985,13697,2163224619.1002,1538265394201155466.7974,65986,15.112,0.0001,0.0054
20677,30338,9661,22332,2151613741.1887,1542447029725836232.623,9662,8.2251,0.0032,0.005
317,26335,26018,31469,2141775529.6004,1534832516384784640.5746,26019,3.0547,0.0038,0.0007
10661,61947,51286,14529,2140906740.2049,1542865960832000768.7876,51287,10.3866,0.0049,0.0013
22441,121209,98768,17144,2153031357.7368,1540594972252255376.4984,98769,2.8274,0.0001,0.0029
21099,115177,94078,4889,2150379790.0745,1545703042814827951.7283,94079,9.9627,0.0012,0.0033
4026,83676,79650,7264,2149685520.2369,1540847377467365206.6607,79651,4.1998,0.0019,0.0025
8132,102862,94730,19623,2155208789.1887,1527067525498008958.9307,94731,15.0233,0.0015,0.0043
8824,37368,28544,8924,2158276003.164,1535652766447447273.1494,28545,8.5361,0.0011,0.007
30153,120433,90280,13340,2144999260.2281,1537901549959526826.6143,90281,6.4696,0.0026,0.0007
19837,81763,61926,4669,2154066728.1036,1538380931319885241.3008,61927,8.3962,0.0005,0.0032
763,9686,8923,22128,2137981497.708,1540260277543892863.6653,8924,8.0844,0.0079,0.0024
32016,45018,13002,26387,2142820877.0147,1555584858664195643.9396,13003,11.4044,0.0078,0.0058
14405,58010,43605,4766,2145210628.3469,1535957477038610337.4227,43606,7.1055,0.0034,0.0018
29171,31780,2609,19888,2137130089.6686,1528425997304595744.1894,2610,10.7072,0.0115,0.0076
14046,78185,64139,1513,2149671693.1577,1523069659298281951.8376,64140,21.173,0.0025,0.0044
19752,87767,68015,13620,2150643621.5757,1536039545160190758.6357,68016,5.7167,0.0012,0.0026
4671,66363,61692,2948,2146828325.309,1533965902954036837.6253,61693,11.4993,0.0019,0.0032
15944,41975,26031,14707,2153280530.2867,1528301218064263627.3557,26032,6.522,0.0022,0.0047
2174,80061,77887,13680,2147670164.703,1538368522178734367.0675,77888,18.1857,0.0021,0.0026
31745,112130,80385,25859,2146591867.0515,1541462440680107505.086,80386,6.2797,0.0018,0.0014
26040,114611,88571,14844,2141531874.2268,1540004710056268331.8179,88572,10.1581,0.0044,0.0008
2613,9975,7362,20805,2190984182.1791,1521146014759363288.2288,7363,26.4936,0.0012,0.0199
24597,36739,12142,24033,2157337051.881,1532835179049273465.7679,12143,5.049,0.0016,0.0071
2005,12052,10047,32331,2164220150.3535,1567553748421672780.426,10048,10.000,0.0032,0.0132
13336,81122,67786,22954,2139939806.7938,1543450381573504051.3748,67787,9.862,0.0038,0.0009
20777,102470,81693,7258,2141871279.6872,1534404609330717404.479,81694,8.3939,0.0034,0.0009
32279,72209,39930,20581,2151851769.3123,1538809721726773546.3118,39931,8.1695,0.0012,0.0029
14846,78388,63542,2041,2147596801.5801,1531158990112609705.8645,63543,7.1154,0.0025,0.0022
17909,58310,40401,7236,2154719934.8374,1539660621320537403.974,40402,6.9881,0.0009,0.0055
31596,111496,79900,10617,2149146739.883,1544739502135347408.0685,79901,12.0987,0.0025,0.0027
7134,41232,34098,20425,2136871217.6851,1540421353678664955.8093,34099,7.9473,0.0057,0.0012
25276,45682,20406,29535,2146438962.1003,1542466443624180793.5792,20407,2.6312,0.0028,0.0024
7901,37035,29134,24687,2137519470.7919,1539589650883029361.0416,29135,11.4617,0.0069,0.0015
24789,73888,49099,32684,2149326632.7479,1533079248457453440.2109,49100,7.8818,0.0032,0.0028
13694,64437,50743,12698,2139648104.6767,1544922087167792009.6961,50744,7.1648,0.0047,0.0006
14143,19230,5087,13555,2123067224.6824,1537234715919046154.6633,5088,2.6507,0.0128,0.0035
25979,60185,34206,4443,2144093727.5056,1531927786591840423.4766,34207,4.2638,0.0036,0.0014
10880,77008,66128,1574,2150018278.0565,1528840596083762040.9513,66129,6.0049,0.0025,0.0031
25609,71704,46095,10280,2138028559.87,1540992821737623667.5244,46096,6.7851,0.0041,0.0009
13210,79456,66246,25519,2149549204.6447,1520144956017849439.4234,66247,24.6845,0.0033,0.0046
8874,82538,73664,4919,2144732953.4223,1536984383070439296.141,73665,9.8134,0.0023,0.0027
21091,22369,1278,2322,2104798185.7091,1544338478594698164.6441,1279,7.2801,0.0309,0.0046
12676,26185,13509,703,2155304418.2763,1528921288063606263.6429,13510,6.5917,0.0042,0.0079
9453,53838,44385,32543,2147659107.2507,1534523424318696030.6535,44386,3.2943,0.0016,0.0015
32126,35893,3767,5954,2138496729.9628,1552773240802834977.5305,3768,5.1859,0.0108,0.0086
15717,62007,46290,397,2139817913.7355,1528167057283826079.3174,46291,11.2085,0.0047,0.0009
10919,15208,4289,1946,2166761931.8758,1543525302796378731.251,4290,11.5487,0.0028,0.0127
19449,86473,67024,4605,2165333274.5128,1544531702904719069.8587,67025,23.1135,0.0003,0.0088
11355,42290,30935,25784,2152747995.9184,1517956569869452893.2779,30936,20.8143,0.0026,0.0055
2614,42285,39671,6159,2147400540.9539,1545955468782800879.6106,39672,3.9558,0.0024,0.003
11217,16476,5259,18386,2144997889.7099,1539198442745961690.5375,5260,5.2491,0.0071,0.0066
24188,63467,39279,27932,2136452861.1358,1546923274777225852.9801,39280,10.0331,0.006,0.0016
9242,9363,121,30150,1975212516.2869,1543818735443481951.9259,122,8.7609,0.0933,0.0146
29289,38936,9647,32271,2164216216.6874,1520756917744538287.4471,9648,16.9054,0.0018,0.0101
10479,83274,72795,8794,2146741367.2891,1542219393825699318.3739,72796,12.4896,0.0031,0.0017
30583,118613,88030,29643,2144066578.8247,1532919942305106274.2245,88031,11.4572,0.0042,0.0014
14629,27736,13107,28620,2145657209.0557,1531434624335897528.8777,13108,3.0637,0.0039,0.0032
3591,26040,22449,13456,2146994209.2823,1534659371456972019.8671,22450,6.1087,0.0035,0.0034
5874,96776,90902,5132,2149773282.5642,1536712440870549436.0345,90903,9.1298,0.0014,0.0023
29842,72501,42659,28763,2144412310.3668,1545943772251033119.8929,42660,10.3856,0.0033,0.0015
9428,25542,16114,14154,2137848286.9077,1548033233486791906.9129,16115,8.3404,0.0083,0.002
10802,47511,36709,32640,2151715257.3641,1530679766424083128.9914,36710,6.8598,0.0018,0.0042
23995,78122,54127,23549,2138220528.8219,1529694877318150231.0796,54128,8.3297,0.0046,0.0006
32748,80473,47725,11279,2141350076.4001,1546012857519701678.0422,47726,11.0522,0.0046,0.001
20362,63589,43227,10348,2130408529.6427,1541836715430778702.4798,43228,15.2143,0.0067,0.000
253,84348,84095,7832,2145599168.9277,1529238054857045645.6455,84096,6.110,0.0032,0.0013
22004,76609,54605,19523,2145265336.0682,1541046051742642982.357,54606,8.1764,0.0036,0.0019
24962,81573,56611,21385,2147780820.3904,1538958770482906587.6006,56612,2.3779,0.0014,0.0015
32511,56407,23896,27618,2143391300.2471,1531014826600197949.5054,23897,3.1362,0.0035,0.0018
27507,91845,64338,2803,2143683923.327,1535966070459592697.0984,64339,8.9432,0.003,0.001
12210,40416,28206,30410,2130272490.0439,1528770306027090079.6163,28207,10.7206,0.0077,0.0015
5411,18074,12663,31036,2123528772.4059,1539580599720009093.6379,12664,8.1928,0.0115,0.0005
1231,9059,7828,4015,2168373469.4063,1536615363832470324.6911,7829,6.1049,0.0005,0.0089
25234,121912,96678,31821,2144618162.3119,1536357740948516527.3434,96679,5.1907,0.0018,0.0005
19646,93257,73611,11367,2153559238.2275,1528689320746798397.1894,73612,7.7304,0.0015,0.0035
19588,96252,76664,17032,2146743357.5192,1528218608523309771.8213,76665,14.917,0.0028,0.0025
17655,108603,90948,26527,2141815895.139,1542061552749306445.5006,90949,7.8762,0.0027,0.0007
21137,62460,41323,32530,2134356056.5255,1541588087412749365.102,41324,9.2573,0.0057,0.0009
20748,103986,83238,3760,2147084188.7363,1544416317891427605.1834,83239,10.6268,0.003,0.0025
8982,83882,74900,17845,2143037799.6054,1528990006141744685.8606,74901,10.5405,0.0034,0.0016
12266,58583,46317,20531,2157300325.6216,1516433979924095948.1609,46318,20.6242,0.0023,0.0066
2637,64203,61566,3378,2154585654.2468,1542921766337217864.2861,61567,11.8517,0.0011,0.0055
6761,69792,63031,10007,2149916497.2733,1530922747247421012.4796,63032,3.1985,0.0012,0.0021
6895,43183,36288,28649,2147968105.3308,1525507481943160729.7733,36289,12.8555,0.0039,0.0036
20639,86035,65396,11058,2137332403.6578,1537927507798373123.4119,65397,10.2115,0.004,0.000
32044,123280,91236,9428,2143235499.189,1538360681664855865.9551,91237,11.3665,0.0036,0.0006
14206,51713,37507,20880,2136122908.2482,1545095815189034803.414,37508,20.2685,0.0068,0.001
3839,23579,19740,15148,2159856198.7653,1527160239197896910.9848,19741,16.4045,0.0025,0.0074
8916,65136,56220,25927,2146192383.5063,1533217092785653017.1379,56221,3.9898,0.0024,0.0016
24679,96816,72137,12922,2151689686.1236,1539939195239246076.8886,72138,6.9426,0.001,0.0028
5737,53799,48062,31008,2144417260.8282,1533004598264433113.8556,48063,5.1487,0.0039,0.0019
30783,109462,78679,18179,2137675547.2218,1540875766867018570.027,78680,10.449,0.0043,0.000
25849,71488,45639,22158,2149501466.4543,1540844526988152699.5263,45640,5.531,0.0015,0.003
11303,106842,95539,30547,2151550294.209,1535727679672935813.3426,95540,25.1284,0.001,0.0043
2382,46215,43833,12422,2145192812.3435,1536361340806978117.6134,43834,4.1089,0.0022,0.0012
25188,35124,9936,24283,2172652277.6881,1532837885473302055.9648,9937,6.4817,0.0008,0.0101
13934,109971,96037,17029,2143142919.081,1537218067803632298.0766,96038,7.0166,0.0025,0.0001
24329,103605,79276,4092,2146163647.8312,1532130166895655602.0651,79277,9.0824,0.0026,0.0017
11662,78725,67063,5106,2130167000.2988,1544920763977340213.3078,67064,20.1766,0.0068,0.0005
11930,92290,80360,12562,2144807201.0657,1540537511766631796.1115,80361,7.0839,0.0024,0.0015
17916,40828,22912,27391,2155349344.6462,1510166065414139278.6132,22913,13.6723,0.0041,0.0079
19135,81832,62697,32060,2139725641.4271,1542733406237063297.6116,62698,21.1976,0.004,0.000
9835,45137,35302,4521,2137388670.9485,1534906523599943632.6491,35303,7.2594,0.005,0.0011
6853,16133,9280,9175,2150220048.3978,1564892179796972683.3629,9281,7.6675,0.005,0.0075
21053,96592,75539,18226,2150925658.9041,1539129057499890471.6972,75540,3.1126,0.0009,0.0027
24644,47275,22631,14485,2159711579.8853,1534125579682586297.5657,22632,10.3722,0.0006,0.0076
1125,79936,78811,19351,2153592058.452,1545662908951105206.5493,78812,5.640,0.0009,0.0035
20813,93057,72244,28754,2150035084.0211,1537657641124890362.2273,72245,5.0863,0.0012,0.0028
19959,67800,47841,24497,2151021139.3217,1533752303820601212.0411,47842,6.1647,0.0009,0.0031
6594,13169,6575,18719,2156223288.663,1541196822311530318.6249,6576,12.8811,0.0046,0.0079
28818,75989,47171,8526,2146714534.1833,1537318765676482582.1767,47172,4.3612,0.0032,0.0018
19225,110691,91466,32108,2146494241.3481,1538122991296303750.406,91467,5.6467,0.0015,0.0009
6295,48794,42499,3228,2140667936.089,1533820153533201399.7954,42500,9.4085,0.0043,0.0011
10331,28422,18091,18794,2136072345.0446,1562059574660600140.4427,18092,21.739,0.0071,0.0025
3103,35285,32182,9319,2153497802.3827,1538458188346132061.2767,32183,12.6716,0.0017,0.0044
7732,45217,37485,9435,2145519919.3191,1546994880813468657.0706,37486,8.8338,0.0038,0.0031
28735,63852,35117,27657,2143335272.457,1545275151788204872.4544,35118,5.9138,0.0037,0.0018
26646,56913,30267,19511,2161032682.2781,1530909786478592579.2063,30268,7.1274,0.0005,0.0065
151,60087,59936,4597,2143552235.8672,1534130085913914701.4352,59937,5.5333,0.0042,0.0007
5279,46139,40860,7185,2137662813.1901,1541376557841208542.218,40861,11.6438,0.0062,0.0008
30538,66063,35525,16990,2147487504.9946,1542265297965434315.1678,35526,3.1943,0.0023,0.0018
28917,97247,68330,8312,2136651169.8294,1536033317136691721.4429,68331,11.620,0.0053,0.0002
30672,64835,34163,16579,2147892995.9681,1534138530877791830.7416,34164,7.0693,0.0033,0.0032
2437,81822,79385,8030,2148633006.8267,1545849570178762362.4858,79386,9.8956,0.0017,0.0026
11528,70787,59259,12480,2151665427.52,1541360473220373081.1021,59260,5.2724,0.0005,0.0029
22486,119048,96562,19257,2145925358.5984,1536237042122848614.5905,96563,5.7726,0.0018,0.001
13086,16966,3880,21530,2210238083.8944,1585670203716635316.3609,3881,23.4959,0,0.0298
4978,99338,94360,32480,2139136467.7305,1544794806915485701.0657,94361,16.2722,0.0044,0.0004
25801,99333,73532,3860,2140525634.4744,1536761090723473583.6194,73533,5.6684,0.0032,0.000
17200,30008,12808,23753,2161204060.8226,1540811342371019518.7647,12809,3.1631,0.001,0.0063
14673,100484,85811,15287,2141096294.2789,1542281127473162089.8917,85812,23.6976,0.0042,0.0011
2655,94455,91800,9788,2152029293.8232,1541373121535665475.294,91801,4.7228,0.0005,0.0025
26004,43467,17463,9500,2140406654.7396,1524617942793550781.5343,17464,7.4809,0.0059,0.0027
3284,32511,29227,26392,2135655993.3519,1525985793783696724.9843,29228,13.295,0.0076,0.0017
5366,95016,89650,16494,2137108156.0181,1535027690086422198.1473,89651,8.2006,0.0043,0.0001
14245,89688,75443,31404,2162215720.9927,1540977954916839190.2799,75444,23.951,0.0005,0.0074
23625,57254,33629,5576,2161942444.1721,1533613715382741054.0478,33630,8.454,0.0004,0.0087
13839,20116,6277,28103,2153952485.0737,1554497770546117491.3764,6278,7.4882,0.0049,0.008
27608,74122,46514,21176,2142548828.266,1537362575966951624.6408,46515,4.1951,0.0037,0.0015
1792,10250,8458,23117,2150163626.4334,1565522459608918122.6501,8459,7.7524,0.0066,0.0079
5713,25378,19665,30539,2180239716.7981,1529458073682692837.0607,19666,17.3698,0.000,0.0127
11799,85753,73954,17546,2146970730.5305,1542625733955663387.6126,73955,6.0474,0.0021,0.0016
24929,92070,67141,31479,2146571062.5018,1534941805855782144.6681,67142,6.6048,0.0023,0.0013
18524,94939,76415,13518,2153555608.4782,1528454361610282127.9966,76416,21.9051,0.0007,0.0035
3073,74521,71448,23312,2143072919.0538,1536372911780124723.432,71449,6.8827,0.0031,0.0007
5285,43432,38147,570,2139075398.7088,1539923752945402086.9757,38148,8.6354,0.0053,0.0009
23480,105524,82044,26218,2149076083.5222,1531041922421661065.8813,82045,4.5509,0.0019,0.0026
27970,76611,48641,26040,2153878705.2391,1542776568472695799.5402,48642,7.7474,0.0009,0.0044
28876,107499,78623,1254,2157864456.6363,1538726016397559594.3857,78624,8.7175,0.000,0.0052
27018,123546,96528,10944,2139966963.2357,1537200142399819767.1943,96529,24.0741,0.0055,0.001
18352,84518,66166,6361,2151000690.6443,1536257977809767187.2485,66167,3.9113,0.0006,0.0029
32303,50274,17971,26578,2139517773.4341,1538416568280233195.9514,17972,5.4433,0.0046,0.0004
23725,93853,70128,13801,2137805323.4825,1542218887969348467.6023,70129,17.5703,0.0044,0.000
5051,42634,37583,10894,2155257114.4723,1541901779983144811.5285,37584,16.5521,0.0002,0.0053
2163,51498,49335,1033,2146406720.1979,1528687779854678343.4873,49336,12.6809,0.003,0.0022
5315,13070,7755,18446,2144070961.9724,1527463956716057125.148,7756,2.258,0.0053,0.0034
15998,58663,42665,5334,2159011638.9148,1537345237262875702.7046,42666,6.5014,0.0003,0.0049
17299,30152,12853,13890,2139175141.5143,1525207087311064976.1608,12854,9.1332,0.0078,0.0029
31160,32037,877,27969,2167554234.5205,1407741829156132205.0309,878,16.4846,0.0269,0.0349
5550,19416,13866,4702,2137603969.8993,1548099049194390888.0941,13867,8.9091,0.007,0.0016
30430,88065,57635,4510,2142335157.6695,1531707101536537452.085,57636,4.7419,0.0034,0.0006
25050,84640,59590,30803,2153485310.4135,1547304369637391810.7626,59591,6.5747,0.0013,0.004
12331,42328,29997,12248,2142155444.3634,1514098619612220297.1053,29998,17.9619,0.0072,0.0037
23186,114890,91704,22818,2151797624.3791,1541919922722516589.0422,91705,5.0405,0.0015,0.0033
32397,71058,38661,10009,2138657419.6399,1527360690961107889.3694,38662,7.0452,0.0055,0.0006
1057,93957,92900,25853,2144499386.9651,1535527831814212279.7868,92901,6.6656,0.0029,0.0008
16395,47615,31220,21183,2155132367.3944,1536132735818478607.4458,31221,6.9084,0.0006,0.005
13051,88140,75089,13463,2151834961.8042,1540665857264744224.7141,75090,9.6162,0.001,0.0046
20831,99375,78544,29491,2146057825.3194,1545454829862857317.154,78545,13.315,0.0033,0.0022
23332,118900,95568,16318,2141246003.7937,1535085710043928391.5875,95569,15.3584,0.0031,0.000
6841,100455,93614,7336,2152391168.9351,1540246095039604224.795,93615,7.7017,0.0008,0.0029
8359,10824,2465,27730,2212413432.0012,1558742168786084825.2283,2466,9.1359,0.0012,0.0295
7695,23703,16008,9611,2182171955.7339,1527947549117901973.8101,16009,16.613,0.0008,0.0144
243,83478,83235,31097,2145947783.5131,1537707867904334500.3415,83236,7.1089,0.0026,0.001
21291,67968,46677,27735,2137342656.3628,1544457404944918203.251,46678,20.2189,0.0048,0.0001
31608,48469,16861,20365,2152902708.2783,1527232523753292782.4017,16862,9.421,0.0026,0.0049
3242,49042,45800,14609,2143181567.7859,1544160080882450532.6356,45801,8.6116,0.0039,0.002
19662,96770,77108,1931,2154326656.4023,1531545134090449264.647,77109,6.8002,0.0006,0.0037
24589,121287,96698,6679,2142372762.7953,1542685541350855914.3762,96699,31.3008,0.0036,0.0014
8222,34720,26498,27866,2161830774.6684,1532293319317719933.0316,26499,19.0257,0.0005,0.0066
1856,99540,97684,10950,2154734890.9657,1538990404798144979.5759,97685,8.667,0.0002,0.0033
26719,27253,534,22263,2232843355.6355,1526874998931946263.8129,535,11.8361,0.0131,0.0535
7915,9111,1196,1318,2160414020.9315,1504774704497651133.6946,1197,5.4143,0.0108,0.0177
19418,30698,11280,13105,2134465520.0948,1529353511699774880.2436,11281,14.082,0.0084,0.0027
4163,72948,68785,23498,2147665701.793,1540436751810056230.3357,68786,6.769,0.0018,0.0016
313,54379,54066,28446,2148004984.9419,1525485489718194602.2484,54067,13.3796,0.0032,0.0043
30599,70315,39716,6744,2159231905.2795,1530679144531221863.658,39717,14.4938,0.0003,0.0055
12095,110470,98375,8497,2149803767.9339,1542086943634486855.7875,98376,6.6407,0.0009,0.0022
20569,58148,37579,18704,2150883184.6604,1538728418551073223.4433,37580,3.4737,0.001,0.0031
5947,9488,3541,28692,2108256303.8896,1526532649989926068.2529,3542,12.5153,0.0178,0.0034
32513,49260,16747,27458,2155961956.1262,1520073772299362415.0816,16748,11.8496,0.0043,0.0096
4335,42128,37793,26656,2150837194.4218,1536128863751312365.0827,37794,9.8985,0.0026,0.004
21436,32831,11395,11397,2118582263.0416,1533860939348293903.1841,11396,19.3861,0.0111,0.000
8638,88672,80034,25041,2143259921.3323,1537512732827019004.8816,80035,4.831,0.0025,0.001
1444,32070,30626,627,2150452080.7406,1540582681550350102.808,30627,18.8253,0.0023,0.0061
27563,124438,96875,893,2141044435.923,1530180684299668222.8342,96876,9.6023,0.0034,0.0002
14094,102357,88263,8276,2139610715.2049,1537441701431002962.3199,88264,13.031,0.004,0.0002
16737,42973,26236,8966,2135429554.065,1537969312594889851.8523,26237,6.6902,0.0065,0.0005
32039,71941,39902,26085,2140138834.391,1540976359127690027.6329,39903,8.6998,0.0045,0.0006
15887,53571,37684,1952,2133752597.3968,1532121492986079144.5509,37685,21.9953,0.0084,0.0016
24817,108923,84106,9548,2137236856.3511,1535488365167538626.447,84107,14.2286,0.0047,0.000
26150,69084,42934,3365,2153987604.8165,1544536804490435776.6769,42935,9.851,0.0015,0.0044
7717,81306,73589,14386,2142318109.3481,1542694002080818360.8703,73590,9.7919,0.0031,0.0007
4208,8948,4740,20411,2168193365.7897,1525329062636087059.2587,4741,13.1228,0.0029,0.0131
10165,104786,94621,14930,2151856779.5499,1527909764769532686.8316,94622,12.8404,0.001,0.0033
32666,53193,20527,32392,2161544523.3753,1535145806123405842.5836,20528,14.7265,0.0004,0.0065
20807,84322,63515,24920,2150085616.503,1547879866147299865.2802,63516,6.2563,0.0018,0.0029
6087,82079,75992,18728,2151184336.0795,1540037105073939483.6472,75993,11.2015,0.0011,0.0036
2354,22432,20078,29373,2163342695.8069,1519214221508900989.6257,20079,17.7374,0.0016,0.0099
7316,26577,19261,27785,2142179323.2178,1529766750314711579.7413,19262,12.0523,0.005,0.0038
26698,28495,1797,9162,2204557013.9027,1486386368279428589.6518,1798,11.9602,0.0031,0.0296
32346,52134,19788,3592,2114946132.5774,1530345092183609730.7171,19789,21.1511,0.0133,0.0006
28711,125021,96310,27398,2146128690.2897,1541337060697286728.2821,96311,6.5524,0.0019,0.0008
3107,4688,1581,5651,2122927245.8818,1479633504922389846.6428,1582,6.8455,0.0179,0.0082
2283,19649,17366,9630,2146139928.235,1536759936555910141.7433,17367,3.1536,0.0027,0.0024
30409,126886,96477,9051,2137829777.7954,1539300686901089888.0894,96478,9.436,0.0039,0.0003
20384,68468,48084,28635,2144615674.2229,1532895893912724864.8919,48085,6.7127,0.0024,0.001
23699,31059,7360,56,2121852189.4431,1558218380262089388.6111,7361,22.9353,0.0143,0.0013
4876,97171,92295,5832,2139754461.6739,1539688275058776128.9439,92296,8.2737,0.0042,0.0005
17518,33895,16377,24688,2155763770.7434,1532731611825616121.4081,16378,12.382,0.0021,0.0058
7579,32430,24851,19851,2148845230.2001,1521622400638262952.7104,24852,10.1806,0.0042,0.0042
15046,17279,2233,30773,2131714247.3299,1531240845237130485.2309,2234,10.4495,0.0153,0.0104
7317,12057,4740,11591,2114695203.3921,1559440929882196840.8155,4741,7.6341,0.0171,0.0005
23180,58496,35316,25715,2142930319.668,1537140903928847364.3217,35317,8.8798,0.0032,0.0009
5544,57436,51892,8450,2136709745.5194,1534904121756825668.7911,51893,9.8991,0.0052,0.0002
18073,45731,27658,6178,2140184366.0746,1546490997134678877.4433,27659,11.1966,0.005,0.0014
2781,83312,80531,2008,2142493070.0859,1530592261864594285.1671,80532,7.1843,0.0043,0.0007
15317,96399,81082,28923,2143130917.8716,1536837209623090069.8618,81083,3.3531,0.0031,0.0005
8188,17438,9250,2413,2160230899.7458,1529263885979080630.7772,9251,8.906,0.004,0.0084
29946,95441,65495,30768,2138437346.7681,1544249110121732295.2978,65496,9.9593,0.0047,0.0006
21549,40501,18952,12221,2150460625.4483,1533850266970237704.7439,18953,7.2407,0.0037,0.0036
21609,98807,77198,5938,2149819665.4654,1532728719695408122.8433,77199,18.2967,0.0016,0.0053
11400,88660,77260,20300,2152538018.0077,1534927853107822920.9671,77261,8.8513,0.0005,0.0032
9547,99678,90131,13085,2141602152.9432,1531379716483676780.9549,90132,5.8222,0.0033,0.0008
25511,105708,80197,5464,2153783228.7375,1532422820092763362.6711,80198,9.9624,0.0004,0.0044
1619,36262,34643,25190,2160538985.2289,1544842915911726947.2272,34644,7.0436,0.0004,0.0076
17307,112599,95292,18848,2147717662.8524,1540005793039116059.5515,95293,7.7041,0.0015,0.0015
451,90836,90385,18422,2135809547.1647,1534485235222795979.4882,90386,22.9721,0.0042,0.000
4071,85113,81042,24188,2130477123.9634,1541353069425393232.7282,81043,20.5437,0.0067,0.0004
18809,52355,33546,27041,2142061842.7434,1528832921981804013.8419,33547,4.7149,0.0039,0.0011
8545,14045,5500,13611,2136128828.7995,1517247724294620870.2494,5501,3.8976,0.0122,0.0035
25898,90888,64990,27746,2155022425.5754,1538157575352082548.6776,64991,9.5553,0.0008,0.0039
21501,51700,30199,10519,2136952773.6001,1538243758551106942.7295,30200,12.475,0.0065,0.0016
30638,41228,10590,24467,2138656685.5708,1557679069584551269.7933,10591,8.5087,0.0068,0.0036
25789,32698,6909,28579,2128766336.2109,1542768981261776889.1606,6910,6.1686,0.0097,0.0024
26819,120781,93962,9058,2145588036.4175,1534742692920456751.1943,93963,3.542,0.0016,0.0009
8486,100398,91912,27077,2153740744.0126,1527571002357487383.9873,91913,27.7406,0.0015,0.0054
24197,52269,28072,13919,2139045988.4074,1533640954098199115.1179,28073,7.4778,0.0048,0.0009
13768,17106,3338,13666,2178263402.9209,1591702837407563346.4813,3339,8.2529,0.005,0.0183
30558,48376,17818,25986,2124927399.5783,1516670482952845560.6947,17819,15.5298,0.0116,0.0009
28659,67771,39112,23629,2137408494.0401,1544981497234071027.4466,39113,8.2966,0.0059,0.0009
31362,96275,64913,4264,2156655813.1722,1528217448432762634.408,64914,7.7243,0.0009,0.0052
21784,101843,80059,27546,2149126502.5531,1549794532358645376.0699,80060,9.8019,0.0023,0.0031
2028,53794,51766,26742,2145158959.2826,1533660700696908439.8358,51767,6.8302,0.0028,0.0019
30548,66675,36127,18564,2149380930.3875,1520687997948102056.8281,36128,11.8545,0.004,0.004
29077,110304,81227,14486,2150761915.1737,1536932028957096601.138,81228,3.1446,0.0002,0.0019
23913,85756,61843,29716,2143139050.0071,1539755016836875704.2092,61844,11.4119,0.0024,0.0005
31736,77967,46231,2280,2143452009.3972,1538308674385275265.7175,46232,15.1917,0.0041,0.002
25332,111689,86357,7927,2157181161.934,1534084913683958623.1705,86358,9.0001,0.000,0.0042
17655,30877,13222,26580,2150522988.7248,1509477620919824366.8433,13223,9.7148,0.0055,0.0069
15688,63826,48138,4464,2141462339.3551,1529480565010290653.528,48139,7.5382,0.0034,0.0013
6481,99276,92795,26191,2155235399.2546,1541815888288393389.3818,92796,11.2872,0.0009,0.0035
30861,117863,87002,4643,2143594678.8687,1538386367014200983.0691,87003,3.6457,0.0023,0.0005
28270,60397,32127,6653,2148392604.1614,1538891860030637120.6652,32128,2.810,0.0027,0.0029
24833,82413,57580,11060,2145671151.1554,1535704317769665980.1721,57581,3.0265,0.0018,0.0011
5481,98209,92728,26946,2149693364.0874,1537155652992307163.442,92729,8.6875,0.0011,0.0021
8622,26242,17620,25574,2162736669.814,1535813432560726273.9041,17621,6.9458,0.0009,0.0076
22567,52280,29713,8255,2145980693.0257,1528225971655830660.2491,29714,4.1292,0.0028,0.0025
17968,114285,96317,16532,2147481781.7473,1536545045025668740.7196,96318,11.8749,0.0023,0.0012
2272,91685,89413,26357,2150360735.7589,1534031695508770438.3047,89414,2.8831,0.0012,0.0024
7169,82404,75235,20104,2160305836.1162,1543449551795141560.7235,75236,13.7161,0.0005,0.0051
2659,27792,25133,13411,2145794417.6797,1541780155279580566.7851,25134,6.1673,0.0032,0.0031
8081,67144,59063,5085,2148135709.5344,1535588106046438678.9821,59064,3.0023,0.0012,0.0025
18827,24588,5761,26548,2144569328.5267,1538624480482498275.6741,5762,8.0986,0.0079,0.0078
32189,97645,65456,8527,2163806886.4892,1541713178969825023.9782,65457,17.2605,0.0005,0.0068
9085,41902,32817,7098,2138848870.7152,1530349258510557301.9462,32818,9.6466,0.0039,0.0011
908,97690,96782,3044,2153241723.7957,1543436647422069750.432,96783,8.6442,0.0007,0.0029
1064,90061,88997,14331,2146229122.6043,1531618852007316043.6961,88998,4.0307,0.0023,0.0012
2504,70784,68280,29907,2153270843.7283,1532794095691941648.3116,68281,4.9164,0.0011,0.0033
31271,101636,70365,30003,2151440017.3623,1538688013789466602.0261,70366,7.6066,0.0008,0.0028
5988,29642,23654,17944,2140291988.9127,1546420606591214978.7879,23655,9.9375,0.0058,0.0014
1327,100645,99318,2150,2142648754.8952,1537626513331925217.8405,99319,10.2528,0.0025,0.0007
6291,96999,90708,7761,2143587660.5452,1529741248322104634.9286,90709,12.9229,0.0034,0.0011
885,17867,16982,15360,2152074543.2828,1530643236912648762.2981,16983,3.9761,0.0023,0.0047
20050,80543,60493,11250,2151360958.991,1538495443567568262.2645,60494,11.1366,0.0004,0.0026
24820,77501,52681,21101,2144649540.2853,1535795904582101852.9455,52682,7.6926,0.0032,0.0009
9507,84167,74660,18680,2145735306.8933,1540635085609609857.931,74661,11.2597,0.002,0.0016
19987,61250,41263,26403,2152314631.0083,1548590822377963314.2068,41264,12.8051,0.0019,0.004
28638,82791,54153,30163,2152660962.4867,1528850329965032401.6821,54154,10.3972,0.001,0.0041
12762,110708,97946,4580,2156303458.2178,1543814823473362639.758,97947,19.7073,0.0004,0.0042
18279,93311,75032,6588,2142102892.507,1530022123729044303.9535,75033,7.7788,0.0031,0.0013
22670,118408,95738,740,2144194373.677,1541844701838872296.0432,95739,10.4123,0.0021,0.0008
31866,71666,39800,28336,2141288348.0061,1536538036279128839.6584,39801,8.5255,0.0042,0.0012
12745,36436,23691,19795,2151301369.555,1528694501198695672.4067,23692,9.3065,0.0019,0.0037
20693,53146,32453,4067,2155043875.271,1540096477743135680.5848,32454,5.983,0.0007,0.0044
18255,93967,75712,20421,2148390661.6306,1541967216253924437.612,75713,9.7221,0.002,0.0023
24053,97675,73622,21038,2154643157.1305,1538657377825855531.7201,73623,11.5389,0.0005,0.005
27579,82688,55109,8005,2153160048.7817,1540745399693826506.6116,55110,6.7113,0.0007,0.0033
14847,113968,99121,20868,2141266443.7825,1530939458374595874.8839,99122,10.4543,0.003,0.0006
32724,79990,47266,23552,2145973038.4765,1547680577251775783.2615,47267,6.3303,0.0034,0.0022
12705,38753,26048,27278,2127372400.0845,1531438376108651467.0029,26049,13.6677,0.010,0.0006
14729,68078,53349,8608,2153596750.6555,1531946185135206299.3981,53350,6.1134,0.0011,0.003
19266,62613,43347,13405,2147212840.3111,1540342023933866243.4786,43348,3.1111,0.0021,0.0019
30015,97537,67522,13366,2150943447.0206,1537773581703028595.1534,67523,7.2191,0.0011,0.003
4955,20275,15320,27048,2115484447.8694,1543626535775084008.6062,15321,23.9975,0.0107,0.0003
13949,76659,62710,3705,2141861912.6515,1531818175286625511.8166,62711,4.9711,0.004,0.0005
25631,119280,93649,27271,2133772772.2137,1535072345389435091.8476,93650,16.6385,0.0054,0.0002
30541,70898,40357,14593,2132996506.0593,1538751155798427647.1073,40358,15.8747,0.0087,0.0005
11612,58125,46513,17314,2156789320.2903,1527119948125975317.3917,46514,14.2767,0.0011,0.0047
4583,31060,26477,8750,2135739601.975,1529950351140561597.7354,26478,5.0467,0.0057,0.0005
19893,104038,84145,19089,2140722820.6846,1539720508054389638.6501,84146,6.3478,0.0034,0.0004
5447,73274,67827,15620,2155902235.9934,1534385781397079538.0631,67828,14.2056,0.0003,0.0052
4669,90885,86216,13620,2148620943.5041,1534837373144189053.3475,86217,8.6142,0.0011,0.0012
6251,77240,70989,16196,2151785094.2118,1537842884246552397.1448,70990,3.4787,0.0003,0.0022
25263,37930,12667,6301,2155783098.9582,1533349458156683699.0799,12668,12.0986,0.0016,0.007
14591,109172,94581,13927,2150301963.5613,1531521889599021897.2591,94582,10.5322,0.0018,0.0029
26564,42483,15919,9001,2149354583.3573,1520936005929837815.7372,15920,6.4129,0.004,0.0045
30796,81348,50552,3144,2158343694.1729,1541337962336567116.0952,50553,10.0363,0.0007,0.0063
27395,67543,40148,24877,2152160213.7279,1530567098177048490.9031,40149,13.4851,0.0012,0.0033
10753,79303,68550,23992,2148950907.4664,1541647041751819076.9063,68551,1.710,0.0009,0.0015
14363,70795,56432,15387,2149147080.0147,1533662934829783309.7196,56433,11.0262,0.0014,0.0024
11742,99630,87888,4228,2141867456.3328,1536465608607538264.6151,87889,9.4295,0.0032,0.0001
28111,56114,28003,1196,2133486544.9789,1537409924681671998.8855,28004,10.6512,0.0077,0.0009
3806,32788,28982,27353,2154565855.6882,1542970672666036086.3245,28983,4.8925,0.0013,0.0042
4527,57104,52577,15779,2156941747.068,1542616405077501765.0329,52578,8.9118,0.0011,0.0047
25584,109460,83876,20612,2155422564.6158,1537096579999216215.7862,83877,10.6352,0.0004,0.0045
18348,74238,55890,3891,2140604666.5008,1539670714887574075.2732,55891,4.4394,0.0036,0.0003
6218,68886,62668,21580,2150001523.2827,1529877318057124695.4531,62669,4.944,0.0014,0.0027
8454,26666,18212,26328,2162200433.5963,1537175199061749997.4918,18213,13.6109,0.0014,0.0074
7012,15288,8276,5972,2094063243.1975,1556178856930746950.4893,8277,41.5331,0.0199,0.0002
24805,122375,97570,8143,2149440659.0342,1533143062269839922.8352,97571,11.975,0.0012,0.0021
3412,75037,71625,20726,2149345273.8635,1533970061544667919.8648,71626,2.1144,0.0012,0.0022
6977,25307,18330,8690,2142743510.3097,1521843385872122835.1417,18331,4.3972,0.0055,0.0032
26194,38420,12226,20575,2141016692.8393,1568447302102726617.2913,12227,14.3661,0.0095,0.0067
21062,102914,81852,15510,2156387314.2048,1538503225281791918.1383,81853,8.1403,0.0001,0.004
25803,104892,79089,4308,2142424783.5898,1532784859521707671.3506,79090,9.2528,0.0028,0.0007
29643,62993,33350,15053,2141255061.8978,1541902502048909916.0593,33351,10.6235,0.004,0.002
14317,79223,64906,28862,2143350968.4183,1526778157076680275.9706,64907,15.713,0.0039,0.0018
589,91522,90933,12329,2151340367.0377,1534048910748685935.4986,90934,19.7049,0.0008,0.0031
10326,27602,17276,23675,2135584353.9564,1558372827279647241.0473,17277,13.6669,0.008,0.0042
23594,86567,62973,27656,2141600410.9851,1541143354811689159.5291,62974,8.1225,0.0049,0.0005
13566,100113,86547,21040,2140529894.9755,1538178430900424553.1362,86548,16.4739,0.0036,0.0002
3630,28258,24628,4881,2145976457.748,1541270606437487576.7759,24629,4.4282,0.004,0.0031
29522,71107,41585,13924,2154434856.6569,1547762647352148692.4549,41586,11.1701,0.0016,0.0045
15346,104863,89517,23019,2158230040.4663,1541185106067799102.7747,89518,11.8708,0.0006,0.0049
1592,72037,70445,5807,2139613565.5457,1541705554347963295.3472,70446,11.3145,0.0036,0.0003
26086,70739,44653,6335,2144222837.1248,1534211747477288926.1309,44654,7.4672,0.0024,0.0012
16969,91559,74590,30446,2149992383.8205,1534099565103013037.3984,74591,9.1795,0.0012,0.0029
19483,107414,87931,18095,2156318435.8686,1535475928490641636.0258,87932,17.3975,0.0003,0.0048
12551,87662,75111,31109,2146213917.7763,1541315233152468194.703,75112,4.3303,0.002,0.0015
21873,112199,90326,14272,2152113454.2733,1537760512691030624.1907,90327,8.7221,0.0003,0.0035
22849,85109,62260,27387,2141062006.9069,1538169476021272697.5249,62261,19.4291,0.0049,0.0015
20405,104432,84027,4418,2138100017.6708,1537833083098963279.6596,84028,21.2926,0.0037,0.0006
20606,30168,9562,8176,2116329870.5096,1534647909200389714.8637,9563,14.8664,0.0164,0.001
28525,91606,63081,32236,2145794566.0945,1536545701880829016.5684,63082,15.8296,0.0027,0.0029
14740,73645,58905,25350,2149511461.8601,1530444452072853872.7345,58906,5.3247,0.002,0.0025
25885,112345,86460,4624,2152716381.2859,1533555790459393276.1939,86461,12.0456,0.0002,0.0027
31055,69540,38485,30322,2139824102.5084,1543965958396663574.3587,38486,6.5234,0.0038,0.0004
1419,54421,53002,8025,2162347484.5325,1536255618479693986.053,53003,15.1775,0.0001,0.0052
11050,39188,28138,32700,2139767419.094,1538704121781539147.0465,28139,5.1512,0.0048,0.0008
27859,91704,63845,14307,2150615598.9482,1539647803941576118.4867,63846,9.6504,0.0013,0.0039
14779,96106,81327,28274,2150531172.573,1545491300454935999.2982,81328,16.5062,0.0022,0.0037
8894,30599,21705,15901,2156123027.2912,1535793010309934083.5047,21706,6.8989,0.0024,0.0058
43,97973,97930,14244,2144948821.8455,1543412929486068270.7359,97931,7.4097,0.0028,0.001
9083,85108,76025,10800,2146650045.621,1537868327787127952.4207,76026,6.9118,0.002,0.0018
1997,75431,73434,26480,2159871074.0639,1540444214966555412.0983,73435,12.5962,0.000,0.0056
15110,111364,96254,23912,2148862108.376,1539113546338278309.8902,96255,5.8254,0.001,0.0017
3869,60255,56386,2099,2151455187.6249,1531776939169753533.4685,56387,11.9455,0.0022,0.0031
4679,83176,78497,5838,2160553330.5532,1535402891615685779.0067,78498,17.4689,0.0001,0.0051
27154,81165,54011,31331,2138011999.0508,1535216610491879842.4488,54012,7.7703,0.0042,0.0001
15288,74244,58956,25465,2137331874.7926,1524929877320574387.6021,58957,22.289,0.005,0.0018
30385,77713,47328,3571,2154329750.9544,1546070185961150030.3543,47329,8.9648,0.0009,0.0049
30340,113158,82818,2692,2159529471.3112,1536554330008898134.9226,82819,14.3446,0.0003,0.0046
4268,6393,2125,17928,2149172226.7437,1483222773842802068.4832,2126,7.001,0.0099,0.0145
4116,101593,97477,14862,2159895345.1288,1532423024677162562.3899,97478,19.0935,0.0001,0.0051
7143,50147,43004,10265,2160646587.9683,1536802598417132769.9519,43005,7.0148,0.000,0.0049
21606,81907,60301,20810,2146252304.1903,1540766931059810872.1272,60302,21.8223,0.0032,0.0016
28640,86544,57904,32363,2143565509.9289,1537086586678267931.6892,57905,10.3659,0.0032,0.0007
27196,100913,73717,14308,2145197858.7448,1534223114904291212.7754,73718,1.7165,0.0024,0.0011
13783,74891,61108,2602,2162378548.3437,1532838252195234901.229,61109,14.9836,0.0002,0.0058
7039,47775,40736,21302,2145779751.5602,1533781779596961498.8604,40737,10.393,0.0036,0.0018
17510,81051,63541,9446,2155394066.5867,1541213700983479756.9511,63542,17.0876,0.0007,0.0055
20798,87369,66571,28815,2149135478.2525,1545726705809775379.8243,66572,11.6411,0.0037,0.0034
3036,20370,17334,29851,2141175853.9117,1534809330969636420.3649,17335,15.1782,0.0053,0.0037
17482,93257,75775,7342,2145755935.7162,1541897397408015569.933,75776,14.6105,0.0027,0.0025
13593,75831,62238,6646,2160611828.9177,1544012448678056286.5395,62239,14.5538,0.000,0.0064
16540,102781,86241,24088,2147648274.2439,1539301859006829851.1328,86242,9.4663,0.0013,0.0015
17232,32272,15040,22428,2128570412.7053,1552094131306032160.8259,15041,15.7972,0.0102,0.0013
27247,40504,13257,28244,2139685486.3665,1521558505787028165.7255,13258,8.2741,0.008,0.003
8672,42715,34043,12462,2149001460.1575,1531813298964654836.2966,34044,12.0337,0.0033,0.0038
7936,51039,43103,28163,2125776069.4079,1531131031440561460.5325,43104,16.5488,0.0081,0.000
24455,46814,22359,24687,2155171017.2646,1536906430016085765.8468,22360,8.3516,0.0014,0.0041
21493,109587,88094,15525,2142735986.7133,1531251708696725485.3224,88095,11.0653,0.0034,0.0007
12397,69142,56745,26739,2143303914.533,1532715383310365533.3004,56746,6.5512,0.0033,0.0007
10062,36452,26390,11475,2144515086.6846,1543753891195941309.2339,26391,13.7626,0.0034,0.0021
5747,50454,44707,12001,2156145632.3281,1534534920785473208.4553,44708,10.4192,0.0008,0.0051
479,15413,14934,12286,2151188469.2678,1539545753241973363.8388,14935,2.8061,0.0022,0.0043
420,5810,5390,25379,2171482318.1784,1568059502408218334.9242,5391,10.0872,0.0045,0.0149
27410,72953,45543,15008,2150348268.2476,1533539025324865398.1794,45544,20.6913,0.0024,0.0032
5960,97942,91982,14524,2149576982.5382,1528092178630729139.3616,91983,11.5931,0.0014,0.0031
1040,85402,84362,4383,2137579118.5456,1526593881533937077.0804,84363,23.0144,0.0059,0.0012
23884,59390,35506,31622,2150898436.5249,1544987137526248097.059,35507,12.8837,0.0028,0.0045
24862,32001,7139,19341,2133306296.4221,1536159512102673051.9879,7140,7.0895,0.0098,0.0028
14831,16579,1748,6943,2185439085.2636,1562703799215067618.8871,1749,19.6671,0.0093,0.0265
17786,19736,1950,30261,2133399564.6632,1539318120667880221.9097,1951,4.5625,0.0134,0.0076
13122,65103,51981,29258,2153889006.2896,1540008037763166026.226,51982,2.7163,0.0006,0.0029
5564,53786,48222,14385,2148749626.0192,1546250825112720235.1624,48223,5.5331,0.0025,0.003
29597,127763,98166,578,2140760912.7857,1534633459761522132.5876,98167,5.8704,0.0031,0.0003
1111,70086,68975,5702,2134596675.2917,1537482509980549654.1806,68976,12.3984,0.0052,0.0006
7141,16271,9130,3107,2137970903.8369,1548677033379058382.9173,9131,7.6301,0.0086,0.0037
2205,12509,10304,15233,2154228826.368,1549191499205727983.7575,10305,3.9207,0.0033,0.0063
15387,106534,91147,19252,2144736228.7454,1541335512322858156.7762,91148,11.2818,0.0021,0.0009
31132,78696,47564,8144,2136050213.6783,1549847709068969115.0528,47565,14.623,0.0064,0.0007
22555,92570,70015,4561,2144593536.1143,1546979707607069735.7191,70016,9.6418,0.0032,0.0016
20205,37586,17381,24434,2140018032.8906,1526267916133060916.7646,17382,7.873,0.0058,0.0026
22185,88173,65988,20231,2154922730.7399,1529882356266428469.1494,65989,10.6639,0.0008,0.0038
7900,42186,34286,21340,2140098673.1723,1556198829368588525.4151,34287,23.9225,0.0068,0.0025
6172,70641,64469,11403,2148067584.5392,1526465727146968054.3656,64470,15.235,0.0034,0.0029
1104,78945,77841,25397,2148920420.7733,1533819406265890432.3921,77842,10.0325,0.0011,0.0022
466,95662,95196,15775,2140622018.6517,1537811140423582625.3087,95197,6.4909,0.0032,0.0005
19931,42900,22969,10404,2120790313.6968,1525761956672882276.7488,22970,17.5425,0.0122,0.0012
19325,28532,9207,11335,2144132229.5226,1538920372853860253.6726,9208,6.2327,0.0051,0.0065
13037,103890,90853,7077,2151656057.1816,1529133986083682241.6389,90854,21.7373,0.0016,0.0038
7769,96925,89156,3422,2157403325.221,1533297281811275567.0041,89157,8.8226,0.000,0.004
22390,89559,67169,21321,2137549254.3643,1536347934350187963.2369,67170,12.8673,0.0059,0.0002
5974,89689,83715,16273,2144796472.4957,1527780636356980342.7856,83716,16.5741,0.0027,0.0018
3134,59173,56039,27181,2149592832.6292,1532970126277976062.7125,56040,5.1901,0.0016,0.0023
29641,53879,24238,27785,2140695914.7496,1512408873933205432.7933,24239,13.9345,0.0083,0.0043
25695,89999,64304,23062,2155161153.8045,1547321781105125594.1293,64305,9.4028,0.0015,0.0047
1937,47693,45756,28518,2142780919.8789,1531172290630679866.4346,45757,6.3892,0.0034,0.0013
22635,58613,35978,8775,2145663013.7618,1541504372660352745.0196,35979,5.0146,0.0032,0.0022
1844,45328,43484,14867,2132116798.9925,1535906549839239851.8133,43485,11.6453,0.0077,0.0006
21696,28067,6371,25404,2100255278.7392,1543401900489708169.4828,6372,15.5398,0.0186,0.0003
21885,82766,60881,10465,2138837015.6554,1538243588289932196.4457,60882,16.442,0.0044,0.0008
29021,106035,77014,20571,2142244671.5785,1524978330090011984.3505,77015,26.6116,0.0039,0.0026
19049,69832,50783,26691,2148754418.0885,1540775178550132501.9162,50784,8.8264,0.0017,0.0037
20067,102272,82205,2053,2142498314.8752,1537644458628809001.2482,82206,10.2098,0.0028,0.0012
20073,26765,6692,8736,2175271527.996,1567940632866422600.0817,6693,8.2643,0.0031,0.0164
857,92257,91400,31161,2143681404.1381,1534666008699786598.5777,91401,5.8422,0.0024,0.0003
12536,71168,58632,2345,2139432608.2574,1532851842118442943.7829,58633,12.6379,0.005,0.0007
603,86411,85808,274,2148908326.6457,1536584251810746831.8753,85809,4.8035,0.001,0.002
30826,42443,11617,21423,2138830181.0703,1536851667064680570.3016,11618,3.8744,0.0057,0.0021
25550,70643,45093,6562,2150784198.3243,1538509286839779483.8032,45094,3.8155,0.001,0.0039
12336,19649,7313,15394,2114586719.8249,1520424725131795992.7291,7314,17.3524,0.0205,0.0006
12084,102316,90232,12455,2153131214.4769,1530189569737413792.6517,90233,17.5103,0.0014,0.0037
29987,51673,21686,27209,2158729169.906,1547655221143312253.0351,21687,9.3403,0.0004,0.0067
12052,37817,25765,32631,2157082746.3299,1533221291229009249.8478,25766,19.0595,0.002,0.0087
31969,70113,38144,24054,2137425755.079,1532281733815580350.6441,38145,5.2411,0.0044,0.0002
7914,21132,13218,20848,2146071018.3795,1546361393064817266.4239,13219,7.308,0.006,0.0039
20053,30171,10118,1743,2158901199.4914,1567169434594568013.1785,10119,9.7005,0.0042,0.0109
19898,52867,32969,8923,2143711513.2091,1544124035808667065.8645,32970,1.7852,0.0032,0.0016
11021,13565,2544,13927,2156420214.2821,1468625235711226237.9699,2545,13.2985,0.0135,0.0188
30708,70707,39999,30321,2160272591.1896,1535486164892909859.4337,40000,10.1524,0.0006,0.0054
17099,93315,76216,28904,2139048607.6435,1556105618341885645.2029,76217,32.281,0.0064,0.0028
11619,42085,30466,4576,2147175370.07,1529097326193768022.3426,30467,5.2036,0.0042,0.0027
18650,104543,85893,6095,2157878200.8994,1531654187457196001.0743,85894,12.5015,0.0002,0.0052
28451,80528,52077,3498,2142971634.9093,1536343345238936121.3447,52078,17.9206,0.0036,0.0016
24639,42380,17741,29412,2127015762.901,1519792133890806931.0626,17742,12.4301,0.0099,0.0009
8450,86326,77876,23652,2143767589.3037,1534909307523214488.5253,77877,4.1268,0.0028,0.0013
1841,4575,2734,25883,2171770602.9912,1530190173647051296.1023,2735,11.1822,0.0067,0.019
29891,46521,16630,28975,2169334230.9057,1539672614521253149.8051,16631,7.7921,0.0007,0.0094
25483,49948,24465,26201,2150213852.2442,1526816168377361623.8745,24466,4.2752,0.0027,0.0038
4367,51976,47609,11986,2159350213.4958,1544089997092219196.9683,47610,12.2017,0.0006,0.0051
1714,9511,7797,16788,2143120654.2176,1556984223542878688.7137,7798,6.0408,0.0084,0.0049
10321,12407,2086,31867,2181186823.805,1515643646302993459.0032,2087,5.785,0.0037,0.0214
12014,99679,87665,16800,2151037324.4928,1542062171919838018.0067,87666,5.4431,0.0006,0.0031
10047,65832,55785,16008,2142540298.3901,1539698366304066671.1482,55786,6.601,0.0032,0.0008
29123,115516,86393,24669,2142666793.8467,1531606612622532666.1502,86394,8.292,0.0034,0.0011
14854,111149,96295,9560,2143932807.3182,1545763049565227178.7453,96296,15.6654,0.0029,0.0015
28922,36988,8066,29262,2181934365.2269,1502565392515780153.3193,8067,17.0963,0.0054,0.0206
2688,18298,15610,2188,2121945227.5905,1547180479979261156.0886,15611,22.1273,0.0147,0.0006
31182,127016,95834,143,2148813047.3519,1533493320295853666.6405,95835,2.368,0.0013,0.0022
1737,66415,64678,15467,2159954348.0408,1539442022095313006.597,64679,15.1741,0.000,0.0064
20611,114405,93794,3640,2146139812.1337,1536883980245231618.2687,93795,6.5162,0.0014,0.001
18289,103297,85008,32117,2149069695.6713,1530221020175380886.2393,85009,4.7327,0.0022,0.0027
17438,58086,40648,19324,2140899311.2048,1543701547614390401.3465,40649,14.3623,0.0044,0.0015
23366,65809,42443,8268,2162805246.5353,1534278019649507237.8265,42444,16.6512,0.0002,0.0056
31772,126613,94841,25802,2148689366.4752,1539088251338677921.9656,94842,4.5571,0.0007,0.0016
17879,75354,57475,21086,2139077139.0564,1522284586306152020.6009,57476,19.6069,0.0057,0.0024
20414,20634,220,5941,2136154285.4796,1588890687851945658.9464,221,15.9009,0.0484,0.0317
19308,82921,63613,27134,2159039491.08,1537021902460492269.4731,63614,24.1563,0.0001,0.0045
27902,73956,46054,29384,2142543867.9578,1535240592413436888.1987,46055,6.9595,0.0035,0.0011
32442,126772,94330,9283,2147778924.754,1537838472693571215.6522,94331,6.5249,0.0011,0.0015
26083,41030,14947,16432,2163562209.3437,1520681152189627949.9821,14948,16.3057,0.0025,0.0123
23957,46893,22936,7059,2136981095.5973,1538564331569974022.0069,22937,6.0834,0.006,0.0019
9118,86178,77060,6323,2143252645.1747,1539466284480301173.4541,77061,6.1487,0.0024,0.0008
17622,104571,86949,7229,2145313858.3879,1543827460677295714.3247,86950,20.1696,0.0024,0.0016
4061,59688,55627,18773,2152600163.6251,1545219938173842287.1034,55628,6.569,0.001,0.0039
8670,102978,94308,13916,2142923574.8867,1547588075141787251.8335,94309,21.2202,0.003,0.0017
11361,78321,66960,22742,2148397109.0763,1537324894889039623.1672,66961,2.5999,0.0013,0.0015
3492,16808,13316,11172,2154843400.7156,1504781303453279785.7576,13317,17.8387,0.0069,0.0092
17049,77177,60128,9146,2150256506.5596,1543682700748574701.3666,60129,5.857,0.0017,0.0029
10404,67435,57031,1493,2143584586.3343,1535189180347547364.8048,57032,22.4243,0.0055,0.0016
12117,110262,98145,11896,2146539949.6627,1534188587435734279.0056,98146,0.8392,0.0015,0.0008
30047,124070,94023,21841,2143385441.5134,1532784188169862765.0683,94024,7.7149,0.003,0.0004
23769,92532,68763,21490,2151415349.9705,1528690899621711338.766,68764,13.4313,0.0019,0.0037
2933,50238,47305,25021,2146727473.6489,1535501342147849703.9384,47306,7.7927,0.0026,0.0016
28844,70270,41426,774,2156265364.3247,1526579316585970717.9884,41427,8.4255,0.0022,0.0047
22212,119560,97348,32384,2154411610.1735,1539937177543595456.2909,97349,10.3397,0.000,0.0035
13002,16796,3794,16276,2125744831.01,1511849810819781757.846,3795,6.7709,0.0179,0.0037
16464,91880,75416,4638,2144318432.2754,1541609564994200722.3219,75417,20.4345,0.0025,0.0013
7473,75593,68120,19173,2144749162.8821,1546878493273561117.9975,68121,10.6468,0.0031,0.002
9613,16453,6840,8992,2138284172.2641,1553445624768794722.6768,6841,15.7894,0.0121,0.0059
15401,39975,24574,27517,2151206826.2564,1531595743320432586.9291,24575,3.0159,0.0019,0.0028
8441,55729,47288,3929,2135810604.8107,1548188974426892048.8798,47289,12.9198,0.0056,0.0005
23109,45314,22205,3435,2137246775.8286,1538976097609647755.807,22206,12.572,0.0053,0.0002
5767,48676,42909,7074,2139108761.9982,1534265089615285970.7054,42910,3.7197,0.0036,0.000
18257,56982,38725,16981,2138776057.5172,1536594891989301099.5848,38726,18.0627,0.0068,0.0013
29,17138,17109,13102,2154607421.0254,1523943212384518748.3063,17110,13.9702,0.0019,0.0054
22767,88616,65849,29729,2155579116.0117,1544236146888639455.593,65850,9.6705,0.0007,0.0048
31745,128262,96517,16975,2151139929.7195,1542926528426325692.3006,96518,6.2553,0.001,0.0022
30509,47270,16761,584,2144832614.2035,1553455373050550836.8316,16762,6.3459,0.0044,0.0029
2072,99478,97406,32097,2135125465.0626,1538180384055558986.8033,97407,18.3802,0.0059,0.0001
11389,51018,39629,31679,2141093484.3767,1537134788217361772.4998,39630,15.0194,0.0041,0.001
4942,81590,76648,3974,2151971571.4615,1534635932837237306.6382,76649,4.7028,0.0005,0.003
27558,117468,89910,1246,2150649249.8637,1538248528022307423.1505,89911,6.9856,0.0005,0.0025
16144,74634,58490,2916,2134910533.5328,1543448751356999695.7245,58491,14.5049,0.0065,0.0002
9943,75880,65937,18240,2143900379.7895,1540824753826506266.429,65938,6.3147,0.0029,0.0006
1614,69467,67853,14227,2144281062.4201,1534154403193988569.4967,67854,17.5987,0.004,0.0015
28124,102839,74715,18102,2148944454.7505,1535784202244893565.8171,74716,7.1559,0.0014,0.0027
11423,53590,42167,11711,2145448405.1027,1537225604172612204.3035,42168,21.6447,0.0045,0.002
11490,60977,49487,23118,2162422565.7722,1542842761836803315.4931,49488,17.0046,0.0007,0.0062
21623,36334,14711,4645,2136412910.8083,1560207541433955399.8281,14712,12.8895,0.0073,0.0039
27770,100138,72368,26663,2151603368.6811,1535702141685274965.9519,72369,9.3719,0.0009,0.0032
1373,54604,53231,17423,2145802303.6791,1537247855411448390.8443,53232,2.7964,0.002,0.0014
2364,66002,63638,4685,2147882234.0477,1541393070114797887.3576,63639,27.342,0.0042,0.003
19822,113125,93303,8343,2146192230.071,1537985723175742072.7268,93304,1.1861,0.0016,0.0009
15717,80987,65270,1667,2148961290.1932,1545045771387413501.5461,65271,5.0713,0.0026,0.0029
10281,17619,7338,18027,2159456669.6464,1556185965152895999.7961,7339,9.8968,0.0038,0.0086
14845,39888,25043,26397,2150704853.7393,1535783995390906858.7297,25044,3.3819,0.0027,0.0048
31967,50785,18818,20010,2141022677.1548,1535036284318005770.6925,18819,8.0334,0.0058,0.0025
25600,68047,42447,847,2157027167.0424,1536955800051573428.6588,42448,8.8455,0.0011,0.0043
4504,49033,44529,16806,2128382820.5797,1541326052046216324.4644,44530,29.6994,0.0097,0.000
10807,28111,17304,9828,2143385260.5538,1537031967624327515.876,17305,5.7248,0.0043,0.0019
12433,61304,48871,16441,2137440821.6666,1523254284648350872.9955,48872,13.0033,0.0054,0.0008
12455,93085,80630,16486,2150602269.0952,1528631833827462605.6691,80631,28.7289,0.0033,0.0046
13701,38481,24780,25966,2165271182.5613,1545194239301613197.8606,24781,7.9246,0.0006,0.008
24103,87142,63039,1399,2145336030.6431,1543681982859584600.6752,63040,13.0521,0.0035,0.0015
9326,37946,28620,23555,2148104539.6471,1543568447858083467.0625,28621,8.3049,0.0029,0.0027
27519,39122,11603,2968,2132334719.1587,1560628211845161301.7109,11604,13.0409,0.009,0.0028
31122,70568,39446,9531,2162967118.0633,1553333005200713453.2093,39447,22.8508,0.0023,0.0087
5101,32359,27258,21581,2135520154.6013,1531144076665648465.8435,27259,8.2652,0.0057,0.0005
15728,111901,96173,19980,2152817950.8352,1526505864206756785.3356,96174,11.2029,0.0013,0.0036
14672,26118,11446,28703,2172086651.2201,1551113404743141207.0943,11447,7.7428,0.0006,0.0121
20780,50098,29318,19265,2126240251.226,1522244366664565375.4904,29319,18.9931,0.009,0.0008
14109,30930,16821,8929,2153500879.7002,1533860026853053526.2109,16822,5.4712,0.0016,0.005
3175,18317,15142,31451,2136956486.1413,1536609442915188609.2703,15143,10.3825,0.005,0.0003
2255,10792,8537,27344,2135163189.3463,1527607955106132481.9725,8538,10.7224,0.0071,0.0029
10252,84239,73987,1380,2148971016.4227,1526177046030165504.4667,73988,10.5068,0.0021,0.0033
3926,17955,14029,591,2158522317.7098,1521722578117724720.2547,14030,9.3451,0.0027,0.0086
23416,25648,2232,26314,2147287478.3189,1540170614163706876.1849,2233,5.7409,0.0097,0.0076
8357,44609,36252,23828,2136977009.796,1547501448723515463.0595,36253,14.9336,0.0052,0.0004
5658,79761,74103,10181,2155308907.8642,1532039385108022722.6364,74104,22.6649,0.0004,0.0041
15062,53035,37973,22702,2143788125.6337,1535360660396164430.6233,37974,13.7514,0.0039,0.0025
18073,74613,56540,4093,2153076756.1448,1537307065074426438.2584,56541,6.1438,0.0005,0.0041
26680,113113,86433,24432,2130456919.4609,1528883403030597071.4891,86434,24.8215,0.0067,0.000
3294,25291,21997,583,2156890137.84,1546064877399752886.8228,21998,8.8498,0.0014,0.0075
10835,15817,4982,21232,2146950489.4738,1562386736085028154.2565,4983,11.539,0.0099,0.0095
13847,67395,53548,30752,2155747236.6639,1532243416716189302.8147,53549,14.022,0.0009,0.0063
17665,79612,61947,28985,2154580816.1839,1534417243602604372.2508,61948,7.6852,0.0005,0.004
10610,78888,68278,8648,2134677048.2909,1551363689597557642.3105,68279,21.9096,0.0075,0.0011
10198,107215,97017,978,2152592207.9683,1544332335721517668.0672,97018,7.5175,0.0008,0.0035
11747,98747,87000,20512,2151592405.9239,1538288803129026524.249,87001,14.2519,0.0011,0.0034
6553,59196,52643,12482,2149234401.2724,1551688474901543442.1687,52644,8.6541,0.0025,0.0033
22572,89015,66443,827,2147867304.0532,1536246757775423472.7041,66444,2.1806,0.0011,0.0015
24668,67489,42821,25693,2142493831.5059,1534936466250638978.4972,42822,2.723,0.0038,0.0006
16236,32676,16440,2344,2138752772.4769,1541086959087535417.583,16441,5.1833,0.0071,0.0027
23600,25014,1414,5097,2178106738.0339,1517064844397985329.3925,1415,6.5873,0.0061,0.0173
28402,125024,96622,5455,2143464225.9556,1533858004466454872.5317,96623,3.1674,0.0022,0.0004
9255,35578,26323,13676,2126550689.2447,1536684918171651688.0979,26324,14.7478,0.0096,0.0005
28917,106158,77241,12005,2164079714.3406,1536125460340239125.9706,77242,23.5331,0.0001,0.0062
26775,114787,88012,23311,2153499548.9745,1538090152485881212.2023,88013,5.0549,0.0002,0.003
23559,117888,94329,909,2151632585.8484,1544626773250580902.2558,94330,7.5132,0.0006,0.0027
30349,111909,81560,23896,2145066498.4528,1530597679472865076.0857,81561,20.0122,0.0038,0.002
32126,63248,31122,3189,2134572335.9578,1550135822951743277.8069,31123,10.4827,0.0076,0.0015
3529,14122,10593,10484,2151551181.2719,1536220767920846415.0256,10594,5.8842,0.0024,0.0049
23228,75760,52532,7545,2150416135.4435,1541958014401619782.3299,52533,9.7891,0.0017,0.0033
18240,105314,87074,28129,2144067615.7133,1538725396723830839.8443,87075,6.2907,0.002,0.0006
4859,46306,41447,30596,2142735800.7959,1539037842259253533.787,41448,6.1378,0.0032,0.0008
9381,79460,70079,29001,2153376256.647,1532515211699589863.5188,70080,6.8763,0.0001,0.0036
15583,28083,12500,8577,2123516904.6371,1551730854494655449.7589,12501,13.2793,0.0117,0.0008
31035,82473,51438,12308,2141682386.887,1546262179761443962.3271,51439,7.4915,0.0038,0.0017
17199,80797,63598,30026,2145449021.2912,1531835746922674333.6298,63599,5.0905,0.003,0.0014
28976,49477,20501,20115,2131574486.1376,1535039296981455733.3608,20502,9.8683,0.0083,0.0004
18348,66335,47987,16945,2148520007.4832,1541844559489552378.1013,47988,3.2113,0.0017,0.002
15177,24941,9764,31768,2121703096.5699,1554653246840186926.4245,9765,15.6303,0.0149,0.0019
18013,99549,81536,21491,2145899853.9614,1544714524521816154.6285,81537,13.7688,0.0026,0.0016
7752,96811,89059,24682,2154028551.994,1536899855669989364.5363,89060,9.532,0.0004,0.0043
31820,42602,10782,14273,2154374214.6106,1572558577311461827.9317,10783,18.2285,0.0069,0.0099
31868,104615,72747,29107,2143516069.3784,1533136600392509859.9469,72748,4.8299,0.003,0.0012
16590,48160,31570,13151,2147787532.1368,1549788317613780492.8397,31571,7.2411,0.003,0.003
17033,37317,20284,27038,2171155397.036,1540848007116726638.7378,20285,33.5007,0.0017,0.0163
12537,32722,20185,32014,2146113438.8685,1516145678027031986.2437,20186,9.7488,0.0054,0.0044
20484,99566,79082,32377,2144123916.975,1536588782851702767.5534,79083,6.6292,0.0032,0.0011
5718,38460,32742,16236,2138637438.7584,1529297077806740568.933,32743,6.8301,0.0061,0.0011
5505,35917,30412,25950,2136054477.1034,1541279880235831105.0462,30413,6.382,0.0059,0.0002
7718,54168,46450,8880,2149765085.2594,1548965885921113234.0133,46451,4.2524,0.0019,0.003
32437,123218,90781,24099,2153636241.4445,1534486837061284479.23,90782,10.3678,0.0007,0.0031
6396,73219,66823,6922,2151547849.2546,1528514854275312230.2719,66824,16.2174,0.0018,0.0038
500,31215,30715,31862,2139344004.7892,1519714570050830729.084,30716,9.6738,0.0073,0.0024
32473,62675,30202,207,2160457174.6837,1535619854625404336.2085,30203,7.3492,0.0008,0.0069
27678,123263,95585,32534,2143157514.0847,1539306235881550249.8717,95586,5.1316,0.0026,0.0006
19348,115140,95792,183,2146949872.2087,1527934798255966852.9441,95793,16.1281,0.0024,0.0031
11217,22481,11264,32117,2134446278.3629,1545142085662904499.8126,11265,4.8581,0.0071,0.0011
17512,58821,41309,15486,2152075117.1658,1538384781685909285.7603,41310,13.5016,0.0023,0.004
10729,72694,61965,11257,2147873002.886,1526731797265844912.1083,61966,13.7526,0.0024,0.0026
13323,107618,94295,27776,2150346679.1863,1527927898174259124.3345,94296,14.9965,0.0023,0.0032
3095,60705,57610,5129,2142468977.9518,1539340765446826124.5095,57611,5.8702,0.0031,0.0009
8532,14027,5495,12218,2158803424.1405,1547544810574793491.6826,5496,2.1662,0.0031,0.0078
1240,92219,90979,13762,2137719741.9095,1533529876674491811.9443,90980,13.838,0.0041,0.0003
5555,71457,65902,27968,2155732961.7288,1540305427624693316.0501,65903,9.9259,0.0007,0.0041
12681,102657,89976,27425,2146203031.1964,1537467060643376065.6414,89977,4.1438,0.0022,0.0008
2851,92215,89364,23545,2147388457.8881,1545546565788122292.8947,89365,32.4312,0.0026,0.0029
5073,70885,65812,15270,2157371748.9513,1536006626834208614.9808,65813,6.2741,0.0004,0.005
16850,35988,19138,32227,2147894707.0391,1533691750369770991.3097,19139,6.5678,0.0043,0.0065
5343,91534,86191,6105,2143866085.8174,1530892994283779766.0241,86192,10.4548,0.0031,0.0012
26870,45469,18599,10761,2146377938.5546,1555076996805909680.25,18600,6.5207,0.004,0.0046
24592,87025,62433,24686,2145305983.0786,1537522744695947193.6822,62434,11.4135,0.0028,0.0011
5064,30465,25401,20871,2144389254.9405,1517016536377986695.3466,25402,10.1844,0.0057,0.004
9141,68308,59167,27983,2159685041.5919,1539777419503196870.3887,59168,13.6916,0.0003,0.0057
3499,98816,95317,31093,2151139946.6392,1533076857230469122.0859,95318,9.5686,0.0009,0.0026
10129,96300,86171,18908,2141602007.895,1531111751431086312.4688,86172,5.8167,0.0035,0.0012
18668,64614,45946,6857,2148027380.4739,1539897040686438312.8525,45947,8.0989,0.0019,0.0023
11001,43033,32032,28969,2146818370.9648,1532117949934636565.0671,32033,9.8592,0.0034,0.0035
28592,105629,77037,20654,2148129410.592,1528469926602834230.6111,77038,7.0327,0.0017,0.0027
7068,10536,3468,23922,2104439978.1828,1537378144911277677.7936,3469,11.0922,0.0171,0.0003
16961,77423,60462,31364,2145703956.1375,1535368542521992369.5081,60463,11.4016,0.0026,0.0022
19289,68190,48901,25688,2162641852.3225,1534716008715814516.691,48902,16.1028,0.0004,0.0059
30712,44522,13810,6003,2150200149.9936,1568543653901447150.1897,13811,21.5447,0.0074,0.0074
8288,55551,47263,23864,2141176411.9712,1536130449087722855.0083,47264,17.2736,0.0055,0.0018
23170,113389,90219,24847,2152400410.3647,1533640734012584792.24,90220,6.7274,0.0006,0.003
24959,43748,18789,7487,2147436253.2597,1545315419622676676.4847,18790,6.994,0.0031,0.0032
19235,65347,46112,11953,2144491224.4675,1544000651276923787.4298,46113,11.0829,0.0034,0.0024
3589,39195,35606,18430,2141057050.6931,1542331917693787368.6381,35607,8.8807,0.0038,0.0013
8038,48153,40115,13350,2131889454.7869,1537865559282258037.9239,40116,10.2458,0.0061,0.0002
28445,110125,81680,3190,2151394747.2054,1528686132906049891.4522,81681,18.8581,0.0013,0.0029
23268,50222,26954,25673,2138310852.7019,1543147192592417310.1974,26955,5.501,0.0058,0.0007
21316,57084,35768,17397,2135094153.5833,1540352578100261231.1788,35769,14.5583,0.0075,0.0008
21329,27141,5812,4817,2132119581.2778,1527166824628039332.9782,5813,5.9006,0.0109,0.003
5649,16587,10938,4947,2133589940.6446,1538137261310951170.3523,10939,8.4785,0.0073,0.0028
23941,54126,30185,6463,2155136755.7239,1543894290180004343.8445,30186,3.2494,0.0013,0.0043
20659,75627,54968,24246,2138917725.4399,1541794250384023881.631,54969,8.4006,0.0039,0.0002
11462,74199,62737,12811,2150881377.1852,1527869581544011821.6621,62738,5.1287,0.0014,0.0031
15300,77004,61704,30808,2146003734.9447,1542272786052030029.6522,61705,4.5977,0.0024,0.0016
8270,71843,63573,4694,2144600308.1486,1535592817118902670.0513,63574,3.5385,0.0027,0.0013
2051,17452,15401,11932,2155122948.6097,1515835676294744488.054,15402,10.0363,0.0029,0.007
11751,90949,79198,28349,2144774426.7447,1543219638711452951.1623,79199,19.1535,0.0038,0.0018
2684,65217,62533,11562,2137962809.2976,1527588984586523752.7322,62534,5.9377,0.0047,0.0004
23008,64610,41602,15114,2146185081.9942,1541833320685187166.9137,41603,6.1943,0.0038,0.0017
16670,61549,44879,18943,2147239462.4968,1536933080048914614.3423,44880,4.5056,0.0015,0.0023
14517,38298,23781,17312,2150144973.101,1539192466221264586.5076,23782,3.1835,0.0011,0.003
29511,45984,16473,25704,2152868240.7682,1524940372837262462.1495,16474,10.5477,0.0029,0.0057
17260,68457,51197,5529,2146242438.4068,1541495677026447475.2369,51198,9.4925,0.0025,0.0025
19833,86652,66819,5419,2147202422.7436,1534487612682863027.5115,66820,13.8901,0.0021,0.0031
26729,120488,93759,29596,2151329732.0666,1532428179023023922.998,93760,6.7908,0.0009,0.0025
10554,95374,84820,20086,2149732504.7399,1539587744964770671.7628,84821,5.6099,0.0007,0.0021
24609,25711,1102,22526,2143069797.913,1600309964700875494.1792,1103,8.2428,0.020,0.0195
13323,112993,99670,2281,2155205831.0367,1533418310876944962.8976,99671,11.0284,0.000,0.0031
12275,101311,89036,12054,2127718908.7923,1540492447300741771.7738,89037,30.4905,0.0068,0.000
3914,63008,59094,3897,2147603572.0685,1538038951773991213.2568,59095,3.9709,0.0016,0.0015
16430,41198,24768,18293,2147603060.9818,1524877044238541322.2725,24769,14.9248,0.0047,0.0053
3082,73718,70636,665,2144426409.0077,1530931652697911831.0935,70637,13.9971,0.0031,0.0018
11234,74584,63350,18755,2149783465.4023,1535988447801018853.3894,63351,5.585,0.0009,0.0017
7075,51201,44126,2123,2133082841.0416,1536010771294781991.6514,44127,10.6167,0.0069,0.0003
19179,63681,44502,19153,2137410338.6828,1550916209188942316.0228,44503,14.6786,0.0056,0.0022
9241,89886,80645,3568,2140772893.7895,1538935284512001099.1266,80646,5.0436,0.0037,0.0003
15595,103191,87596,15426,2151529475.8493,1531294933524640867.1217,87597,10.0581,0.0011,0.004
13075,47488,34413,26645,2141917125.2728,1532613865183430188.2915,34414,17.6142,0.0038,0.0014
30731,116264,85533,17759,2141288174.3872,1535658680814527235.8878,85534,7.1256,0.0029,0.000
13208,26607,13399,2745,2128491779.6899,1529149929567226832.2128,13400,15.3349,0.0111,0.0008
14816,105352,90536,29042,2149050924.6567,1538204827740401387.9845,90537,13.3625,0.0023,0.002
19485,97510,78025,8999,2149855259.3506,1539121576310320036.6208,78026,3.4058,0.0006,0.0018
12228,104693,92465,11975,2154147429.4355,1535605560815369527.3847,92466,8.4945,0.0004,0.0039
24376,123673,99297,3726,2143504419.9014,1535737610743433448.2706,99298,9.5335,0.0035,0.0007
12513,53423,40910,14098,2145803906.0323,1532896626734693199.5866,40911,1.4722,0.0026,0.0012
8748,72314,63566,20561,2157127152.1756,1542841412126421002.4959,63567,6.5963,0.0002,0.0039
8542,17448,8906,18326,2160503019.8676,1532163128317887008.451,8907,6.7392,0.002,0.0078
5144,91718,86574,24016,2140898970.1041,1539913143180510619.5466,86575,17.5049,0.0045,0.0004
23993,58192,34199,23273,2145959089.1,1545278255426821440.8844,34200,15.0414,0.004,0.003
11646,92940,81294,19610,2160026002.6381,1538155705106396365.2375,81295,11.4489,0.0001,0.0047
18085,103303,85218,8430,2130261548.2299,1538304724914377151.5754,85219,23.120,0.0068,0.0001
3819,32287,28468,17702,2127086291.5473,1530820966545326931.7998,28469,16.9632,0.0091,0.0012
31220,119059,87839,8319,2142160218.2228,1537395228965513065.5899,87840,5.7857,0.0026,0.0005
19075,48026,28951,13433,2149574376.4527,1533949759873412964.9891,28952,13.6487,0.0036,0.0033
6312,98963,92651,31391,2156667495.4792,1525367988085229289.8176,92652,40.9634,0.0003,0.0046
7307,80025,72718,18149,2132521147.9682,1528172049647676054.0622,72719,21.536,0.0073,0.0007
16472,51234,34762,10810,2173250191.5239,1523852207299918113.5634,34763,27.5865,0.000,0.0113
8318,103674,95356,27543,2152278783.0492,1532437187067071010.0227,95357,6.4895,0.0006,0.0031
13608,23208,9600,1793,2132809553.6799,1527922710381932907.1732,9601,5.9609,0.0094,0.0018
3476,38535,35059,10835,2145569878.2598,1535452642537734549.9074,35060,8.8218,0.0034,0.0019
28089,89538,61449,24348,2150933017.6764,1538811601870122728.9786,61450,8.3993,0.0011,0.0032
27027,44926,17899,27643,2153277170.7599,1520372134485885355.8305,17900,5.7085,0.0028,0.0056
2638,81595,78957,9582,2152724908.5172,1539698342054663965.1414,78958,7.9414,0.0011,0.0027
7765,12260,4495,5038,2183062885.8132,1536309151166418281.7961,4496,13.4771,0,0.0145
13623,60538,46915,1525,2140956755.6688,1538828279843690545.7695,46916,11.688,0.0047,0.0005
15451,100813,85362,12903,2142836141.6892,1547917864308083194.8805,85363,29.6186,0.0039,0.0012
12920,33039,20119,4820,2154930629.8825,1549945605770781451.6735,20120,3.1658,0.0018,0.0047
19312,92470,73158,30670,2153074652.2787,1537907264463648611.4105,73159,3.9058,0.0003,0.0033
10440,56540,46100,11304,2153702193.5411,1543511460416305070.0974,46101,8.484,0.0005,0.0041
19859,64193,44334,2675,2139656677.7627,1533327195046462600.76,44335,12.3467,0.0037,0.000
23937,27522,3585,5541,2150686532.727,1459900488292856891.5086,3586,18.3916,0.0146,0.0193
13169,80608,67439,5056,2148619402.5097,1539397860204969345.2784,67440,9.4256,0.0019,0.0017
30147,45775,15628,31392,2152011385.5236,1545711591475243186.2233,15629,8.0338,0.0032,0.0051
16631,86726,70095,19994,2149875867.4658,1538449453445485388.7706,70096,12.0723,0.0015,0.0035
17504,90559,73055,18201,2148356185.3721,1536633146587193562.0076,73056,5.7502,0.0015,0.0022
222,35479,35257,3334,2130891271.7657,1550828411176633372.1412,35258,14.4967,0.0085,0.0009
23668,112723,89055,5947,2136233152.8618,1543197743352105862.2028,89056,15.6341,0.0048,0.0003
30373,53757,23384,2978,2143120771.8083,1546592170705446739.638,23385,8.0853,0.0045,0.003
2466,72082,69616,4104,2138456922.6479,1538973059168589262.1582,69617,17.6943,0.0046,0.0006
18676,60083,41407,23353,2140243346.5696,1526463256572671779.9438,41408,9.2365,0.005,0.0013
22224,114720,92496,17791,2148185496.6341,1539631448075204752.7137,92497,6.4672,0.001,0.0017
28601,29115,514,698,2121208596.7301,1527380510331337765.1174,515,13.0366,0.0289,0.0374
16113,61091,44978,3148,2147562830.0612,1518337442910819809.3773,44979,19.8715,0.004,0.0036
5706,16025,10319,515,2147786082.4798,1545442937554277177.3612,10320,3.1407,0.0048,0.0034
20976,23627,2651,5435,2112221361.681,1534185869323168766.7693,2652,7.7478,0.0146,0.0003
32331,61443,29112,14145,2127217364.6924,1533128662568976992.8912,29113,11.2013,0.0085,0.0001
23010,39277,16267,18640,2155205719.7292,1536722668789976871.4839,16268,11.2229,0.0021,0.0066
8607,102402,93795,28368,2150839132.1358,1535873866343220558.7893,93796,5.5972,0.0003,0.0023
14559,54858,40299,28797,2140662198.5924,1539083230721809530.9832,40300,4.4288,0.0034,0.0004
28852,42203,13351,23813,2172478001.9434,1535990196489813760.7065,13352,16.4005,0.0002,0.0114
5797,66234,60437,29927,2148020159.8987,1542632479714095201.2334,60438,6.9916,0.0022,0.0023
2709,65163,62454,29930,2151290047.2161,1534810783333538822.5083,62455,3.5226,0.0004,0.003
22883,110110,87227,14511,2143447199.0218,1528726526811531093.3344,87228,13.7139,0.0034,0.0019
3455,72414,68959,23508,2140330406.003,1529886284606457928.216,68960,14.7447,0.0048,0.0014
1349,49595,48246,14185,2151165673.273,1545802171606778845.3404,48247,7.1044,0.0012,0.003
28990,81763,52773,19207,2140565331.1488,1532409470166801260.3779,52774,16.3874,0.0039,0.0012
5093,29455,24362,21395,2145450969.4763,1556563785196948231.4997,24363,18.8024,0.0051,0.0041
30828,81787,50959,14724,2151303652.5424,1535209270895690290.6328,50960,3.891,0.001,0.0027
19526,85555,66029,15770,2146178115.2557,1535587727230049824.9478,66030,6.3621,0.002,0.0011
5320,26645,21325,8503,2137491737.2468,1500631479215881277.3674,21326,22.8333,0.0088,0.0036
18680,46807,28127,15248,2144696192.5148,1548838299652600976.1235,28128,14.0988,0.0042,0.0028
16829,78471,61642,10159,2148990520.8613,1540701638519805106.8297,61643,5.443,0.0015,0.0026
29513,96023,66510,32178,2153461568.6205,1543511897341915685.9793,66511,9.9537,0.0012,0.0034
21294,33731,12437,11846,2122972032.6995,1526619256819156571.2674,12438,14.1289,0.0123,0.0002
16271,34891,18620,375,2169132015.879,1548049973519819900.8666,18621,18.0941,0.0014,0.010
20861,44816,23955,12717,2140722786.4988,1533167439928271686.8402,23956,3.2549,0.0047,0.0009
4190,52937,48747,15506,2145519271.3057,1536156161983102756.0314,48748,3.4487,0.0018,0.0014
27846,74208,46362,28650,2148819980.8907,1539323164200192019.6408,46363,10.6648,0.0018,0.0025
12562,65683,53121,13142,2158559397.2939,1533017932842982868.3937,53122,11.7946,0.0002,0.0045
12829,69232,56403,24461,2145702198.287,1536482645111071559.451,56404,2.650,0.0016,0.0011
21785,57125,35340,12150,2134461298.728,1529951515647246041.0638,35341,8.847,0.0059,0.000
14145,24784,10639,17060,2129861555.112,1560732998715422089.3265,10640,9.8815,0.0118,0.0038
29235,95597,66362,7182,2153409082.7664,1534310605833104222.0609,66363,23.8012,0.0017,0.0034
5985,96669,90684,8008,2150134031.562,1538120300089180890.7841,90685,13.5937,0.0013,0.0024
842,91793,90951,14594,2155165381.1687,1537997492503938713.6222,90952,12.8588,0.0007,0.0036
2139,44499,42360,16394,2146211985.5464,1533070027668449386.1838,42361,5.0798,0.0024,0.0017
1248,75544,74296,27344,2157346518.9268,1539666344775418036.9768,74297,16.6247,0.0004,0.0045
14862,72253,57391,9906,2134555381.0445,1544413958392031323.0177,57392,21.4663,0.0059,0.000
12120,57570,45450,26067,2146488407.2845,1542590129195198402.7291,45451,4.4819,0.0025,0.0018
22050,45927,23877,12303,2127957066.1309,1524608929968107383.1382,23878,16.8234,0.0082,0.0015
27360,84494,57134,21024,2150032140.1514,1537570954978485460.7323,57135,6.6177,0.0014,0.0026
27730,48493,20763,15755,2147048194.9856,1553776196065850741.6337,20764,5.9709,0.0037,0.0045
17235,39685,22450,22370,2160927992.1033,1528745065771102780.9928,22451,19.4511,0.0011,0.0064
10573,18068,7495,17171,2112232021.1051,1552525205729133231.7718,7496,19.0058,0.0186,0.001
24040,102899,78859,18904,2141054566.2078,1546600057537842030.4997,78860,12.339,0.0042,0.0016
11127,98102,86975,12615,2144997899.8238,1543223600537266218.672,86976,8.2946,0.0028,0.0016
27642,107788,80146,2304,2150758699.2164,1540171186609632854.4221,80147,7.9376,0.0006,0.0022
10338,50254,39916,32480,2140637658.0484,1540425378490608410.4885,39917,7.3671,0.0033,0.0009
26387,106016,79629,18026,2147780249.2798,1530319380451095731.7046,79630,11.004,0.0016,0.0025
10731,80760,70029,9233,2156720137.1141,1542870801337809453.7709,70030,15.574,0.0003,0.0043
9442,83440,73998,18654,2149274738.0426,1524852742485038795.3279,73999,15.8017,0.0024,0.0028
17398,77518,60120,27057,2144656420.6411,1529285389811454373.2341,60121,6.6736,0.003,0.002
10046,73990,63944,4210,2160829692.7725,1535620814859338038.858,63945,13.492,0.0002,0.0051
621,95585,94964,4994,2149232497.8053,1535807447516707794.4842,94965,9.112,0.0017,0.0021
2903,18546,15643,15272,2145222126.5892,1533261360083514765.1101,15644,10.8011,0.0034,0.0035
17731,90542,72811,26005,2143647347.7947,1529419970181821049.0867,72812,4.5785,0.0029,0.0009
20519,92773,72254,24668,2152110347.7896,1546342746985427274.2723,72255,7.5569,0.001,0.0033
4709,100940,96231,17213,2148594348.748,1532741400106409726.9682,96232,15.7402,0.0014,0.002
12468,83863,71395,7705,2150134164.7389,1537187176816595164.213,71396,8.1445,0.0008,0.0025
9088,80736,71648,26949,2152499558.7349,1520771280796470007.3937,71649,15.2117,0.0019,0.0042
26855,121762,94907,14330,2144930699.4922,1538463620028372440.454,94908,3.4244,0.0021,0.0011
13366,42514,29148,2830,2150616716.5231,1549362464206365724.1196,29149,11.5424,0.003,0.0041
29600,70859,41259,15728,2135452115.4356,1539381702919308712.089,41260,7.2111,0.005,0.0005
24185,63801,39616,8941,2152165692.8512,1536947920982074125.188,39617,3.3703,0.0007,0.0027
17577,28988,11411,3944,2175564063.1446,1542384729270147545.3855,11412,12.1902,0.0013,0.0147
12199,87410,75211,23080,2134372573.9972,1540934446200351915.1028,75212,14.4111,0.0054,0.0002
21727,51913,30186,14472,2166182142.845,1536715483670948182.6338,30187,12.9458,0.0002,0.0091
12549,65112,52563,7478,2136169926.3462,1538248328130835433.0792,52564,12.1258,0.0045,0.0005
3868,9982,6114,6001,2128672948.9583,1533505010071720162.8753,6115,8.9154,0.0112,0.0035
12481,20469,7988,32725,2129087820.9012,1520844960574137076.2945,7989,6.430,0.0107,0.0019
20594,88808,68214,6838,2153515336.7144,1538284992799917160.1101,68215,12.6196,0.0011,0.0051
20955,61158,40203,15800,2134089420.1569,1536729752637179282.1359,40204,8.9246,0.0066,0.0002
19451,75049,55598,6056,2141893094.6779,1547545473837752920.8006,55599,9.9376,0.0039,0.0011
27139,45171,18032,15460,2171699611.8817,1548846307522259869.8176,18033,12.7113,0.0004,0.0094
4680,45660,40980,30105,2168858114.3636,1544616917640869929.7979,40981,18.9106,0.0001,0.0101
23705,36592,12887,28356,2176170948.0723,1520029798040190332.7542,12888,14.6115,0.002,0.0134
22739,83926,61187,13427,2140322382.8005,1535620363132154232.475,61188,4.8211,0.003,0.0001
5218,65113,59895,24669,2152651373.3889,1529666711078884902.6405,59896,16.4668,0.0026,0.0059
5852,95950,90098,6024,2148648127.1528,1539182372770734102.2274,90099,5.9937,0.0011,0.0023
12459,26329,13870,26697,2175821441.4842,1535532884354777231.5205,13871,13.0839,0.0006,0.0111
13737,69484,55747,12465,2146034053.0943,1552450101367190985.2157,55748,13.9444,0.004,0.0028
20923,48717,27794,5700,2141247420.9925,1531252964946959256.0555,27795,7.6429,0.0048,0.0013
2290,25403,23113,26761,2168669732.1339,1527887317994883545.2368,23114,12.1569,0.0003,0.0095
10570,52246,41676,2524,2159860549.059,1537436579530482700.3064,41677,8.1762,0.0012,0.0064
27640,54444,26804,15220,2152801513.4079,1531324358586799385.5179,26805,6.4743,0.0032,0.0041
31959,103950,71991,19111,2136850800.1947,1530253471727619958.6083,71992,14.7097,0.0048,0.000
22890,107248,84358,1254,2157821918.5989,1537459646570224929.7096,84359,9.342,0.000,0.0053
22835,110128,87293,18286,2150912207.5557,1540297132126221423.8012,87294,3.0815,0.0008,0.0034
12138,74744,62606,7685,2146942374.3915,1532405829740776175.3206,62607,8.8221,0.0025,0.0022
31256,91942,60686,30471,2141167139.636,1534511693542460040.4006,60687,10.6807,0.0028,0.0008
9346,50208,40862,3311,2144970949.2164,1533877497463105002.3653,40863,8.1237,0.0027,0.0028
25948,88098,62150,22520,2137804309.9455,1532879188309690295.9863,62151,16.3471,0.0054,0.0004
32657,111616,78959,25960,2146429024.1788,1541151695221378236.021,78960,3.6383,0.0015,0.0013
20464,74937,54473,19270,2146308731.4718,1537856538258216496.3602,54474,12.0389,0.0023,0.0033
12078,13389,1311,5359,2187537700.622,1528024003996526415.1863,1312,7.8009,0.0033,0.0262
2229,74238,72009,27636,2132547777.7161,1549740231982544524.1445,72010,31.3022,0.0069,0.0008
9549,21824,12275,14947,2159521789.0849,1550072641974776183.2481,12276,13.0408,0.0031,0.0104
23615,108072,84457,26877,2146396797.4424,1546239712991385243.7348,84458,12.3346,0.0027,0.0023
31217,51502,20285,30379,2146245796.9792,1539975230452408858.0177,20286,3.7541,0.0037,0.0029
7995,30608,22613,4944,2128142711.9544,1554315831779973710.2204,22614,44.4436,0.0093,0.0014
5016,74615,69599,32563,2138459167.9037,1541811073594918372.648,69600,13.3104,0.0047,0.0002
16714,17017,303,5708,2025471059.5,1486323970276474714.8816,304,26.7278,0.0557,0.0032
30310,120674,90364,18639,2148082302.2623,1541581205260567176.8919,90365,7.0603,0.0017,0.002
20859,87524,66665,16395,2154897315.9432,1538830439544208699.6658,66666,10.5406,0.0004,0.004
26101,30906,4805,5293,2160128816.8766,1566856479169631907.1348,4806,12.6895,0.005,0.0101
5417,77076,71659,2837,2144636921.9757,1542351060115676335.2032,71660,11.5855,0.0028,0.0012
27618,110325,82707,4268,2145199567.3303,1529939406347233252.4072,82708,8.1361,0.0036,0.0023
25123,100018,74895,5085,2138535544.792,1542822956834526788.9537,74896,17.6874,0.0046,0.0002
14734,25837,11103,23925,2143321485.2695,1538187159757555502.266,11104,5.9365,0.0048,0.0025
1068,67474,66406,3979,2147338975.7109,1539256957128540302.3287,66407,3.0299,0.0016,0.0016
12376,13297,921,2160,2132392870.6844,1515892078008600955.6108,922,7.3133,0.0152,0.0114
9493,26565,17072,25223,2165394936.1441,1517236599275067249.4726,17073,10.1712,0.0016,0.0097
26884,51510,24626,19927,2163968655.3999,1524544806817289662.5712,24627,15.7367,0.0013,0.010
4924,43949,39025,2170,2149964336.4686,1532079326558120925.4531,39026,5.5393,0.0018,0.0035
13413,31509,18096,7008,2174676621.1672,1532196923573610774.5736,18097,13.546,0.0009,0.012
1375,81313,79938,19396,2147277521.2676,1534416240315866460.0548,79939,2.3214,0.0011,0.0013
27480,83966,56486,7142,2156552935.0053,1537985140948691880.3182,56487,8.8326,0.0006,0.0049
21136,29821,8685,18626,2148830423.068,1526441102283215383.0157,8686,7.816,0.0044,0.0058
25750,76740,50990,31123,2138177582.9302,1544888027030240929.439,50991,13.5293,0.0053,0.0004
23679,120940,97261,14344,2143329573.4732,1544496993144061607.1864,97262,6.1423,0.0027,0.0008
20519,84091,63572,29967,2160971721.3972,1539680948856029676.8296,63573,11.2849,0.0001,0.0049
23409,97413,74004,10855,2143628974.9904,1539528581477045695.8437,74005,7.3578,0.0027,0.0014
3021,75729,72708,6759,2171397048.3725,1539182424161675310.8373,72709,39.0725,0.0002,0.0098
31920,72313,40393,25041,2146952385.2394,1536969395255781747.0439,40394,12.0468,0.0025,0.0019
5393,53838,48445,22972,2138725910.6186,1527294831700916854.6324,48446,10.1095,0.0048,0.0013
5346,12137,6791,7841,2166149557.5754,1544351826904667742.5129,6792,11.1446,0.0032,0.0125
1493,45303,43810,7341,2149636764.6741,1526521210019819847.1192,43811,9.6801,0.0022,0.0035
32698,36249,3551,25895,2163085638.1126,1560955018957455354.7936,3552,9.689,0.0065,0.016
4667,37883,33216,2183,2145336877.8955,1524861972941479902.2031,33217,4.5471,0.0033,0.0035
13659,56365,42706,2350,2153931567.3143,1528639043843059455.4944,42707,6.7822,0.0014,0.0036
20437,21370,933,22999,2194945708.2109,1542158789207879274.3827,934,5.3107,0.0037,0.0254
3513,66691,63178,15914,2143187214.0751,1542338731773985824.089,63179,5.1401,0.003,0.0009
30671,56541,25870,32476,2141892550.3005,1544478098112861000.75,25871,5.564,0.0048,0.0018
23902,95695,71793,32550,2143996873.9509,1540585505827986575.8585,71794,10.4854,0.0034,0.0011
19472,63281,43809,24752,2143826725.2353,1517257657452790577.6965,43810,19.0148,0.0051,0.0028
7772,89726,81954,23283,2138171705.9498,1533793586546651385.7413,81955,9.6797,0.0046,0.000
19828,68578,48750,15194,2141196584.5763,1541438016959750547.2753,48751,18.7482,0.0038,0.0015
14584,46430,31846,30263,2169190363.2901,1538362385623027765.0387,31847,17.5752,0.0002,0.0081
15137,20900,5763,7587,2167720879.7415,1561396931926818106.5081,5764,4.9953,0.0029,0.0155
5376,34585,29209,22864,2158952787.9719,1534599936336942139.0772,29210,8.8731,0.0005,0.0053
19362,28565,9203,7639,2135837515.6139,1534362612717067850.6099,9204,17.5206,0.0106,0.0049
21239,59597,38358,30039,2138145646.148,1531323622681214756.6861,38359,8.6697,0.0048,0.0005
16717,103044,86327,18271,2148462542.6152,1537695269363846410.1684,86328,3.7616,0.0012,0.0016
2312,27232,24920,12714,2140668737.8104,1533493310449483494.4163,24921,8.5116,0.0049,0.0028
15352,106324,90972,18622,2155813456.9377,1529155500486578382.4243,90973,12.4219,0.001,0.0043
29431,70485,41054,31328,2150291912.5769,1532448613969541312.5378,41055,8.4445,0.0027,0.0031
267,79631,79364,7749,2150297108.3959,1544821910874260977.0036,79365,10.3177,0.0017,0.0028
29422,61106,31684,16105,2150134265.9839,1535105394549823767.4704,31685,7.298,0.0022,0.0026
28910,117371,88461,29937,2147700419.6751,1533945261879785951.4308,88462,3.8335,0.0017,0.0019
18160,59409,41249,26955,2142404429.4104,1522044842573067078.0205,41250,20.0729,0.0052,0.0023
31377,107592,76215,5609,2147774351.1062,1544422207421997681.2529,76216,9.194,0.0018,0.0014
4583,102347,97764,4915,2137767209.4614,1531067970060860337.5573,97765,8.7499,0.0049,0.0001
19366,22127,2761,8538,2136690017.3972,1529438596656114382.8332,2762,3.9172,0.0101,0.0056
16783,30836,14053,15578,2154046397.266,1545170921087643627.9949,14054,4.682,0.002,0.0055
27093,123961,96868,29834,2145645577.3463,1531448413975723269.7022,96869,14.6098,0.0025,0.0016
14673,92901,78228,9694,2137955937.4041,1530685926664511110.8406,78229,9.6011,0.0045,0.0009
12236,63673,51437,9904,2136913145.0739,1524599726942768242.4154,51438,8.4964,0.0055,0.0007
3043,30538,27495,5545,2148699290.2629,1535393835749541581.0285,27496,6.4497,0.0024,0.0024
26848,102869,76021,26522,2138808797.6446,1531098920609907724.9245,76022,13.707,0.0059,0.0008
26317,108458,82141,23857,2139291619.0265,1534963586526599615.4245,82142,4.477,0.0031,0.0001
23506,61051,37545,5294,2147620438.477,1533581552607841131.1429,37546,2.8468,0.002,0.0022
25209,63758,38549,21199,2152585825.0448,1537198783049639271.6226,38550,19.5703,0.0021,0.0067
14391,20184,5793,29912,2147619486.994,1505301645865642120.1493,5794,7.6062,0.0074,0.0087
20021,43956,23935,18001,2149344340.8476,1551859687018074064.7442,23936,9.9976,0.0034,0.0036
5405,48704,43299,26003,2141038137.1292,1545631705199223283.4971,43300,23.2551,0.0049,0.0015
13500,112521,99021,32125,2135943356.3553,1543443591240937298.3425,99022,21.9083,0.0051,0.0006
17498,63498,46000,17821,2144990362.2761,1531778922791856748.204,46001,8.6311,0.0034,0.0023
28550,96940,68390,29719,2151682124.4356,1530749071414077227.3843,68391,9.756,0.0012,0.0033
25414,123598,98184,24584,2142275837.5391,1536744056719387155.0929,98185,10.7355,0.003,0.0002
25400,120683,95283,5945,2151829478.8682,1532416420132070716.084,95284,10.8412,0.0007,0.0025
29347,50705,21358,27210,2137088571.7714,1543134614232803104.5734,21359,4.0388,0.0052,0.0008
30786,31633,847,31548,2190577830.8208,1545821025856958151.7509,848,4.6627,0.0058,0.0282
22938,68312,45374,19165,2160248785.0764,1526435886348541779.9024,45375,21.6766,0.0002,0.0059
13795,56367,42572,26993,2151713866.1292,1540085001108443191.4753,42573,4.8434,0.0009,0.0026
8790,62419,53629,26202,2143750557.3828,1542564702905946124.8457,53630,3.725,0.003,0.001
29130,64999,35869,17140,2148434157.4789,1518583504150879127.0207,35870,11.8493,0.0042,0.004
17911,31258,13347,10172,2174568840.6393,1531261779289432072.7235,13348,14.0604,0.0003,0.0115
25776,78028,52252,14830,2137359642.7457,1535791019997476876.691,52253,7.2039,0.0055,0.0003
31055,102114,71059,357,2155643310.0121,1540587597276249309.284,71060,6.3098,0.000,0.0041
15999,80999,65000,16379,2151199673.6077,1542782039971287980.7507,65001,4.4575,0.0012,0.0026
15265,70898,55633,2566,2153151767.8196,1532289018474577396.1968,55634,6.6079,0.0007,0.003
20846,79271,58425,17700,2158100110.5826,1525580494759962871.9558,58426,14.0861,0.0016,0.0066
2774,45686,42912,7011,2148259472.9739,1538760566303662441.5574,42913,6.1273,0.0019,0.0027
19510,108785,89275,12974,2147719741.7393,1538854794468258524.5456,89276,4.9385,0.0011,0.0016
6010,54849,48839,7340,2140723021.2861,1540041326207509616.7693,48840,10.2883,0.004,0.0007
2661,76442,73781,18296,2148793445.1634,1531435720236066391.9167,73782,3.6665,0.0015,0.0024
20469,44165,23696,4213,2122462699.0778,1529473116276506784.441,23697,21.3901,0.012,0.0003
19232,83470,64238,22805,2137839934.0825,1532989476247823198.2882,64239,14.2008,0.0042,0.0002
18679,71275,52596,11495,2148384530.5,1538872476722884729.2325,52597,3.3064,0.0014,0.0022
6389,6648,259,16873,2101993369.8385,1586956373712367745.1201,260,17.6379,0.0492,0.0279
20928,119819,98891,28440,2138639066.4749,1533582578270083059.5228,98892,9.1638,0.0039,0.0009
24387,92782,68395,25214,2154280862.169,1540064022496180443.2656,68396,7.0863,0.0001,0.0039
31251,68612,37361,4913,2152925323.1788,1526776767673447414.164,37362,11.537,0.0021,0.0046
17587,51747,34160,2234,2137649146.7334,1541385048910466075.9327,34161,6.9254,0.0049,0.0003
14104,83255,69151,20757,2147749100.3117,1533772196587692571.1775,69152,5.3441,0.0013,0.0023
26798,46884,20086,11678,2144736544.5338,1546834784972365258.0506,20087,6.8885,0.0049,0.003
5296,42360,37064,25806,2156240024.8366,1528128606748180444.7724,37065,12.6055,0.0008,0.0042
23369,81332,57963,22663,2162244643.7926,1530396038035428161.8864,57964,32.2153,0.000,0.0089
9667,94035,84368,20598,2144649909.7422,1535612328096959672.1537,84369,3.1094,0.0016,0.0008
4570,68551,63981,21939,2146375999.1152,1541377674119630266.462,63982,10.4781,0.0025,0.0021
3054,72300,69246,28652,2139756707.1535,1549117297296647038.1039,69247,14.1419,0.004,0.0012
17240,79464,62224,5056,2146924345.6176,1536983285192916887.2565,62225,9.7515,0.0025,0.0013
20115,44646,24531,15165,2136020902.3899,1536091411709204545.8738,24532,11.6082,0.0061,0.0011
24200,77431,53231,4401,2158375575.3058,1544164241668838410.2267,53232,7.6695,0.0006,0.0051
24425,104994,80569,10158,2154938941.5815,1536933414067092730.8196,80570,7.8263,0.0003,0.0033
23444,51919,28475,8905,2151518277.9562,1541686028650957285.6603,28476,6.5347,0.0018,0.0039
180,75685,75505,28338,2143748749.3472,1539930195904912857.3651,75506,2.0284,0.0027,0.0008
3036,76841,73805,18391,2143699930.7462,1541645574026964822.9939,73806,15.1475,0.003,0.0015
12217,27681,15464,24033,2146313394.8512,1518694045888201451.6163,15465,6.6071,0.0049,0.0047
8445,37445,29000,29508,2146554758.8146,1532765914379470582.3595,29001,1.5794,0.0023,0.0018
21516,57917,36401,13281,2158317078.6057,1547886901727661059.266,36402,11.966,0.0001,0.0051
13743,108917,95174,9393,2149603549.9867,1535801300954068646.0026,95175,13.2234,0.0012,0.0025
9024,88438,79414,30183,2146639756.8807,1537187772200921271.8499,79415,8.830,0.0017,0.0014
19196,59013,39817,6584,2138068603.4166,1544590138192146607.6166,39818,9.0063,0.0054,0.0014
9297,58633,49336,25098,2147236304.815,1543626824420774531.4681,49337,8.785,0.0031,0.0025
16517,66022,49505,14081,2146383400.4235,1532055613361625656.072,49506,6.737,0.0029,0.0025
20951,114290,93339,12949,2140985519.5226,1533136119919239485.5259,93340,7.4723,0.0031,0.0002
10892,44405,33513,6645,2148478579.1208,1546866894037547780.4263,33514,2.2603,0.0023,0.003
26480,87880,61400,5308,2150912229.2294,1527679253267150977.6328,61401,8.7499,0.0016,0.0035
27175,46971,19796,28189,2160653450.9516,1556329907266412161.3423,19797,12.6456,0.0024,0.0076
20363,92899,72536,21230,2150502937.0935,1529137351048028498.0223,72537,17.2979,0.0017,0.0039
22355,56602,34247,19506,2142019034.7717,1546554857994707548.5861,34248,10.509,0.0044,0.0014
1023,56367,55344,1335,2151113857.9459,1537827153908830682.8459,55345,2.8175,0.0006,0.0025
2487,42662,40175,30928,2156343567.9389,1531349533819398703.1876,40176,9.6951,0.0005,0.0047
30722,86377,55655,3490,2144356543.8634,1523664359486839190.7996,55656,7.874,0.0038,0.0019
19589,21665,2076,20077,2099175979.0274,1580984644611377430.4735,2077,15.012,0.0237,0.0033
9403,83675,74272,3655,2157292003.6434,1538453323328856385.981,74273,9.9601,0.0002,0.0053
6491,20097,13606,17634,2167061526.8434,1545812024014100301.3664,13607,10.3392,0.001,0.0109
10996,101888,90892,22134,2147848075.6323,1531760209330310182.8592,90893,6.9396,0.0015,0.0016
14251,47519,33268,27224,2157371426.8442,1535631966127151774.4099,33269,12.8627,0.0003,0.006
32213,118152,85939,31022,2149527989.185,1530712869966145992.4149,85940,10.0323,0.0025,0.0036
3639,26613,22974,5068,2157991104.4373,1526674805968396814.8108,22975,10.9914,0.0006,0.0062
22315,63542,41227,1815,2142781146.2348,1543440829813589640.3816,41228,11.7242,0.0039,0.002
11168,99708,88540,14121,2152388023.2927,1535698332238610801.9583,88541,8.2179,0.0005,0.0037
997,25224,24227,20692,2154905885.6526,1545293000193556768.1052,24228,11.622,0.0029,0.0053
19523,23284,3761,3235,2132722273.1715,1605003292458611246.007,3762,30.4363,0.0203,0.0124
15923,97528,81605,18248,2150230274.2322,1542657873750822273.1457,81606,7.4594,0.001,0.0025
6215,48792,42577,59,2154653747.6663,1532160432887148050.8947,42578,8.4362,0.0011,0.0048
16302,38132,21830,22622,2142908559.0917,1532953733984020536.4031,21831,6.6764,0.0045,0.0018
24018,88544,64526,18177,2142373352.1527,1533207053612323273.5187,64527,3.450,0.0029,0.0002
13468,93977,80509,6079,2139963926.2588,1538914058286782929.9472,80510,12.814,0.0042,0.0007
16933,69170,52237,21600,2152885361.8509,1540881571337146323.2049,52238,7.4977,0.0007,0.0038
10978,48996,38018,5781,2151538635.3939,1537094009152062541.1656,38019,10.4585,0.0012,0.0036
15398,51983,36585,8189,2155453568.6166,1532112414144455684.47,36586,10.7439,0.0001,0.0042
30618,45396,14778,31653,2147347744.4874,1535310855973098372.086,14779,1.0412,0.0023,0.0021
14245,32003,17758,27320,2159410164.4822,1563644706056937403.2933,17759,9.4747,0.0038,0.009
8021,59021,51000,21844,2138164623.7796,1535966800313059815.0519,51001,9.0514,0.0058,0.0006
11020,77103,66083,19822,2147253034.0868,1528102099385385677.8688,66084,11.4665,0.0028,0.0025
11645,101595,89950,18181,2145253639.3724,1531693278680065610.6122,89951,2.3007,0.0022,0.0013
16115,42036,25921,8808,2138222846.2129,1554577931132797606.9867,25922,6.7153,0.0064,0.0034
1946,76002,74056,14038,2136017178.5426,1538452375532359815.0032,74057,18.7811,0.0059,0.0003
22715,80002,57287,2433,2148004805.2199,1534289170044934324.6703,57288,6.0816,0.0021,0.0019
8817,92747,83930,22645,2148037303.8783,1534938088602874572.5733,83931,8.3477,0.0014,0.0021
4886,50521,45635,22967,2144345521.1753,1545180699682741758.6104,45636,6.7514,0.003,0.0021
16894,43332,26438,19137,2143399717.78,1524342201893715410.7567,26439,4.3752,0.0042,0.0023
27274,62357,35083,12721,2155253534.8244,1533647001656821581.1665,35084,7.0728,0.0004,0.005
7690,73703,66013,17204,2141867714.9608,1538559184268490973.0238,66014,10.3382,0.0044,0.0011
16819,38903,22084,9152,2153063875.7137,1549571373494999470.6485,22085,10.6744,0.0022,0.0052
19474,56490,37016,22326,2136998162.3787,1524180728211487304.1821,37017,11.8421,0.0055,0.0018
15496,108433,92937,12328,2153978035.6989,1543801355395249338.7475,92938,11.988,0.0004,0.003
16456,85119,68663,5096,2136568574.78,1544441205835157212.435,68664,17.2491,0.0059,0.0004
16594,19972,3378,25300,2153533302.1755,1500657216044146456.3128,3379,11.3379,0.0074,0.0128
31018,85719,54701,25865,2135562754.5852,1532293250678875999.0757,54702,27.1946,0.0088,0.0008
22301,65173,42872,27150,2145577553.7164,1535248469813611881.9962,42873,3.4442,0.0031,0.0015
24309,71309,47000,24354,2150960302.3207,1538275714630437567.6867,47001,7.7456,0.0015,0.0039
28657,47890,19233,31547,2160978984.2911,1542498493160351198.5777,19234,10.6236,0.0016,0.0075
11142,66022,54880,7905,2153034202.0071,1527857138118835564.297,54881,11.1585,0.0009,0.0041
27622,94185,66563,9622,2155625247.2327,1533936596775560336.6672,66564,7.5237,0.0003,0.0048
18796,107668,88872,10942,2143900707.3259,1533125312117219927.1633,88873,17.5038,0.0042,0.0014
32039,64891,32852,25647,2148527276.1608,1541654889624647618.8106,32853,12.3275,0.0024,0.0037
31124,53082,21958,7907,2172064740.2388,1530176960131327319.6404,21959,14.0444,0.0011,0.0098
27577,65109,37532,28105,2154157690.483,1525458172105332761.6828,37533,14.0689,0.0008,0.0049
1137,82423,81286,26133,2151737522.3798,1530580790256895228.0771,81287,6.2985,0.0012,0.0028
13547,79185,65638,28838,2145476372.3919,1543559913112740214.5361,65639,8.0315,0.003,0.002
19911,54403,34492,32271,2150672612.2423,1524653462304821392.839,34493,8.0678,0.0035,0.0034
21839,94287,72448,32695,2145292712.5252,1528869805733674298.8983,72449,6.9745,0.0029,0.0019
32187,100155,67968,23905,2152120317.0998,1523681726244814214.166,67969,13.3594,0.0022,0.0035
14312,32024,17712,3555,2162158456.9956,1532757159707356932.1332,17713,8.3061,0.0012,0.0072
1473,71896,70423,2654,2157671175.9437,1541142890177518176.4764,70424,8.3198,0.0001,0.0053
31855,105825,73970,8121,2146823473.7039,1542090583507224048.6981,73971,1.8986,0.002,0.0019
29565,112408,82843,15231,2144480643.2072,1530399915256724248.5587,82844,5.2615,0.0027,0.0016
18339,68212,49873,28598,2146934254.8229,1533655884896241846.2869,49874,7.2684,0.0024,0.0022
17030,104816,87786,4114,2154514041.1845,1531803122074764935.3642,87787,20.1859,0.0001,0.0038
20858,84566,63708,23764,2144046366.7399,1539666267538523580.1674,63709,8.233,0.0033,0.0011
5324,6438,1114,8349,2065072201.557,1577433937820763795.0091,1115,8.1537,0.0341,0.0029
32690,48949,16259,9392,2158112373.4838,1540492435000116336.8682,16260,10.1029,0.0023,0.0074
29690,119044,89354,25704,2145677872.8899,1529916074526223975.167,89355,9.1194,0.0021,0.0014
10691,71695,61004,31452,2145163763.461,1539209642372534271.9349,61005,4.3729,0.0024,0.001
17385,67301,49916,9860,2143006474.4374,1531798207774102880.0353,49917,7.1194,0.0031,0.001
16898,47211,30313,15813,2159770030.5812,1538804426643667940.7961,30314,10.2937,0.0004,0.0066
10528,91964,81436,5640,2138074066.9302,1529388631108871914.2853,81437,10.4247,0.0042,0.0007
8286,10650,2364,15192,2086598144.7535,1577793740786333150.8394,2365,18.9444,0.0331,0.0038
12595,111817,99222,24204,2141030780.4371,1531772192102776247.195,99223,7.5472,0.0037,0.0007
925,45348,44423,27454,2136745059.934,1544417548113538870.934,44424,11.5496,0.006,0.0015
24679,85972,61293,12392,2147006183.3526,1545196746497590471.4912,61294,5.2374,0.003,0.0028
22318,38837,16519,12351,2167015695.1755,1529548866566359511.8464,16520,15.2827,0.000,0.0095
9357,104657,95300,30252,2155345950.0821,1536469799535247447.8595,95301,8.8493,0.0004,0.0036
28085,76738,48653,18878,2157791429.7583,1540089201741359481.7754,48654,12.3187,0.0002,0.0054
5510,67649,62139,28325,2164872870.5928,1545079015265482932.6246,62140,23.903,0.0002,0.0068
28396,59300,30904,27224,2153470587.0213,1542122209031145789.4267,30905,14.9946,0.0015,0.0045
22718,51268,28550,20597,2146174743.0579,1544149996561749141.4713,28551,12.2713,0.0039,0.003
2242,26029,23787,5730,2137135742.4628,1559826811295441969.3226,23788,16.0936,0.0075,0.0026
14459,105430,90971,28592,2158158028.4308,1544363999422852741.168,90972,12.2559,0.0006,0.0046
15298,113976,98678,25753,2143370367.8514,1542412278859181054.0811,98679,13.6336,0.0029,0.0008
13163,75379,62216,22685,2138098072.8024,1549122776041115420.1046,62217,21.595,0.0048,0.0012
1569,39112,37543,6164,2145621291.4041,1554442785922607760.8306,37544,20.4329,0.0052,0.0046
5342,40914,35572,16054,2141479832.3369,1534496069860673033.46,35573,3.935,0.0034,0.0006
23565,105678,82113,10565,2142921930.8866,1536375992793525637.2169,82114,5.7651,0.0028,0.0012
17052,30311,13259,21540,2152894597.7878,1541175208904435006.1491,13260,7.2684,0.0027,0.0047
12619,95347,82728,21431,2151599915.8526,1546998830067344041.9701,82729,7.5563,0.0014,0.0033
18852,22490,3638,24218,2142274903.2688,1538329713064014570.2757,3639,10.5721,0.0088,0.0067
2214,40424,38210,10405,2157621586.3208,1531343708190962247.648,38211,10.9341,0.0008,0.0049
5234,47516,42282,3653,2154979725.045,1534635447720023580.3819,42283,6.8515,0.0011,0.0041
12382,102690,90308,8075,2154158883.9208,1535636165112004779.677,90309,7.7606,0.0002,0.0031
4660,94761,90101,22381,2147726794.5191,1539171883222814481.4384,90102,10.6179,0.0026,0.0018
29349,70507,41158,22581,2144977044.444,1542005502977641837.4635,41159,5.4918,0.0026,0.0015
21635,58043,36408,8046,2156501260.712,1534443284403075801.1191,36409,6.6928,0.0001,0.0048
5519,54364,48845,13253,2135805790.1631,1537240360085255763.1422,48846,10.1767,0.0046,0.000
9168,61184,52016,22943,2134428287.0423,1548423725970862927.6409,52017,24.2024,0.0066,0.0002
11193,26316,15123,7837,2150901392.7801,1539106872658107613.8391,15124,1.5419,0.0011,0.004
6475,60996,54521,17089,2160395916.0705,1532481341862259703.6879,54522,17.9859,0.0001,0.0051
15375,43848,28473,10522,2157843391.0995,1535837120113360105.5492,28474,9.6849,0.0016,0.0063
4663,94878,90215,13879,2157247696.1871,1533956643094609452.1399,90216,12.5073,0.0003,0.0044
7931,67945,60014,17523,2158338853.0241,1538718783443856863.6777,60015,10.019,0.0005,0.0063
5123,14959,9836,501,2136144581.2109,1536034063110376566.7193,9837,2.2019,0.0057,0.0016
19552,21072,1520,29225,2098229420.4241,1575614925890036232.1101,1521,18.5239,0.0373,0.0036
13058,70310,57252,27012,2148425939.4822,1539034398247669485.6671,57253,19.549,0.0041,0.0023
12064,65628,53564,6019,2139762434.4551,1527848646852355062.7807,53565,17.9516,0.004,0.0009
26269,54189,27920,1955,2151432299.4016,1541948439461370651.2074,27921,3.3379,0.0018,0.0033
4382,67658,63276,30193,2148637881.686,1534965507709843725.133,63277,11.4895,0.0019,0.002
26765,109494,82729,22637,2143482022.3115,1535212489748553919.6653,82730,8.2556,0.0033,0.0012
9181,102341,93160,8467,2151396963.0086,1532346273415922945.8357,93161,11.9688,0.001,0.0026
17555,102374,84819,26496,2142505899.2136,1533507617163016342.9582,84820,14.6812,0.0031,0.0015
13567,49734,36167,11547,2139284161.9694,1534175939611037864.1053,36168,11.2686,0.0056,0.0008
26959,44163,17204,3603,2124958945.2579,1545932047468863014.7103,17205,14.1816,0.0096,0.0007
22730,49685,26955,23448,2148187842.9088,1535912950071112180.7763,26956,6.2875,0.0036,0.004
3581,68534,64953,7754,2168946945.3263,1536616960779783305.5915,64954,35.2508,0.0002,0.0084
13631,22176,8545,23675,2152234961.0933,1559581993144630453.2556,8546,21.2193,0.0073,0.0089
27848,69105,41257,30289,2133133709.3862,1551550576335687691.3666,41258,18.0382,0.0077,0.0018
4938,9942,5004,6197,2133909044.3578,1564073282068072986.5203,5005,7.3949,0.0119,0.0059
6110,15716,9606,15168,2149687675.8852,1543295980702717714.5894,9607,9.7759,0.0042,0.0083
10619,52892,42273,3661,2152042326.4272,1522451999410112074.0472,42274,8.500,0.0024,0.004
10368,21321,10953,10582,2162468401.106,1566466264381250888.8357,10954,13.1047,0.0055,0.0128
31607,54508,22901,25408,2168677888.641,1543322437876856369.9537,22902,32.632,0.0001,0.0096
22289,77308,55019,23267,2151026744.1174,1537646147357932068.3785,55020,4.2943,0.0005,0.0022
12875,106199,93324,4117,2140482090.3109,1535910861142873864.6463,93325,4.0979,0.0035,0.0003
9559,24014,14455,8435,2121285347.6195,1535793950748832280.9031,14456,14.4075,0.0115,0.0001
28353,46236,17883,26059,2166397418.7771,1519382812819750453.2345,17884,22.8411,0.0016,0.0106
11218,37343,26125,10095,2165824582.9557,1550697735853678886.7597,26126,12.5924,0.0013,0.008
7563,31251,23688,27748,2148781199.9903,1536473793529242488.0457,23689,3.422,0.0025,0.0024
22454,65457,43003,11676,2154008036.166,1533003861473201558.3143,43004,7.2494,0.0006,0.0041
7681,54164,46483,3643,2144557229.0049,1543552903893726414.9838,46484,7.2989,0.003,0.0022
28961,79993,51032,1131,2172385898.8097,1546914325853590108.9425,51033,34.9537,0.0006,0.0099
24972,72985,48013,28734,2150884771.2287,1532496491666717142.7801,48014,5.6042,0.0016,0.003
20403,82210,61807,17364,2151359990.1824,1539658185773748232.7867,61808,2.4125,0.0009,0.0033
26546,58872,32326,96,2156266511.21,1535043194833653429.6993,32327,6.9437,0.0001,0.0039
28983,41422,12439,11090,2140386277.392,1538710602438896324.3914,12440,2.9004,0.0052,0.0012
21509,106222,84713,19698,2150505853.6525,1526069612827853898.7247,84714,24.077,0.0015,0.0034
32055,38687,6632,31565,2167758013.0629,1554144213578800330.3173,6633,5.6183,0.0028,0.0117
21772,82427,60655,9266,2137339959.2594,1535703399972319851.1781,60656,9.4854,0.0045,0.0007
10259,42529,32270,8892,2143335963.2988,1532408888905839622.8093,32271,4.1276,0.003,0.0014
6214,8181,1967,27566,2205758179.7276,1513349357336492757.4665,1968,9.4007,0.0066,0.0329
8613,48776,40163,31405,2156355542.9853,1542499804732717496.6217,40164,15.896,0.0012,0.0058
14510,94464,79954,29503,2147452555.6542,1543110434325588483.9715,79955,7.4061,0.0018,0.0019
29531,51487,21956,5220,2160034705.047,1540722767608579743.9026,21957,7.5605,0.0013,0.0068
31615,46260,14645,8258,2142155431.0879,1530328898898184644.3309,14646,2.6423,0.0045,0.002
32101,98212,66111,13051,2148444102.4274,1542508397248806733.0995,66112,7.9565,0.002,0.0023
22344,45516,23172,21554,2130759742.9212,1538918616773368782.7784,23173,11.4901,0.008,0.0002
24795,123715,98920,10074,2150875228.0199,1535884979176246273.1743,98921,5.9206,0.0007,0.0026
22762,89387,66625,17905,2155597592.6273,1530816111027947182.5942,66626,12.1731,0.001,0.0043
10876,79850,68974,21672,2141976231.1601,1529794930713647556.1416,68975,5.1102,0.0039,0.0011
6602,30513,23911,23433,2150595487.3976,1558439249133797398.3064,23912,11.9362,0.0037,0.0048
19226,28188,8962,28736,2172526517.4061,1530238114462791607.7875,8963,11.9991,0.0029,0.0145
14680,61793,47113,27766,2152118308.8472,1540694209996679528.4519,47114,6.8325,0.0008,0.0028
5550,72074,66524,31215,2147208011.3372,1533113044142660548.4999,66525,5.6364,0.0023,0.0013
27968,40088,12120,22264,2162343738.276,1552654655219356454.2665,12121,5.549,0.002,0.0078
24458,33947,9489,9171,2164900896.3021,1531176257595659056.6414,9490,7.072,0.0008,0.009
5922,64387,58465,87,2152742070.9854,1534931779544875543.8438,58466,22.852,0.0011,0.0059
28705,98148,69443,11020,2157365941.1592,1538553286465449090.777,69444,27.7942,0.000,0.0049
25023,86679,61656,2401,2155305290.0151,1546273253795848780.5478,61657,8.6418,0.0005,0.0043
32321,60109,27788,12292,2145186901.1245,1530841518625426590.5644,27789,9.3027,0.0036,0.0032
10523,63986,53463,25252,2146755438.1949,1539308316099203632.313,53464,3.9336,0.002,0.0011
17703,71102,53399,24528,2154012742.5936,1531250505743322629.4594,53400,25.4924,0.0016,0.0048
28988,75507,46519,25418,2141579357.5836,1534301099333951206.8404,46520,13.117,0.0034,0.0017
16276,100872,84596,14174,2145111359.1563,1541924074436257469.4604,84597,16.298,0.0028,0.0016
16682,95961,79279,22038,2149569921.5359,1541146136621530089.9916,79280,10.1974,0.0025,0.0021
27506,51166,23660,22346,2178633074.9331,1535420927581996464.836,23661,25.9429,0.000,0.0125
31748,57781,26033,11848,2118670946.4205,1534991139658672186.259,26034,19.3139,0.011,0.0002
18934,48706,29772,4611,2143203237.0809,1515951961145357347.848,29773,14.7817,0.005,0.0035
10235,93012,82777,1038,2141223475.7288,1539501177123249061.7584,82778,9.3717,0.0029,0.0008
23482,98030,74548,21478,2150518660.45,1536227867237784395.6593,74549,5.0391,0.0007,0.0029
15955,58630,42675,4743,2139876362.9346,1542231215909011679.0802,42676,5.643,0.0038,0.0003
9682,98111,88429,20870,2140608285.2554,1541347103489155755.9805,88430,8.9836,0.0039,0.0007
21464,78030,56566,25986,2135325425.8061,1523044250493724627.3825,56567,14.5431,0.0062,0.0012
200,28911,28711,26837,2147414603.8617,1523450088515930875.509,28712,6.2961,0.0034,0.0034
20896,119644,98748,12113,2150528536.8658,1539642187321060232.5931,98749,1.709,0.0007,0.0022
7207,11878,4671,25981,2129896676.8699,1486793558326622059.305,4672,9.986,0.0146,0.0083
16566,31063,14497,3312,2153842899.516,1546853002957647972.6989,14498,5.685,0.0026,0.0061
15416,48755,33339,9062,2144376057.9283,1542502049089257472.9241,33340,6.7088,0.0037,0.0011
16032,74775,58743,22150,2145206673.9273,1532901123692325186.6102,58744,3.1844,0.002,0.0015
19973,25083,5110,25803,2133664957.2266,1513835511311771731.2122,5111,5.1776,0.0116,0.0039
7566,18017,10451,3022,2151525577.5115,1516003244143541422.5415,10452,5.9971,0.0044,0.0066
13927,95022,81095,19230,2143061235.4102,1545456517852871357.3241,81096,6.9173,0.0032,0.0014
22562,103236,80674,29309,2148148341.8333,1539881849038769380.323,80675,7.3836,0.0017,0.0017
2560,13209,10649,9547,2145503528.7871,1521783829869534497.6825,10650,7.8141,0.0068,0.006
6008,84524,78516,32547,2154411652.1397,1537851254645016234.7339,78517,4.0418,0.0002,0.0028
7795,94664,86869,19628,2153991905.0586,1534909401848405818.6017,86870,6.2177,0.0003,0.0038
1862,53812,51950,11450,2141693743.2104,1541151321335072938.4331,51951,9.9658,0.0057,0.0015
12420,103840,91420,24310,2149333611.4639,1547089004443318809.4509,91421,17.7224,0.0023,0.0032
12382,39011,26629,8971,2151119719.9574,1528403644346906810.1928,26630,3.4092,0.0019,0.0036
32713,117658,84945,9149,2144975933.558,1537019146156755913.2357,84946,3.0574,0.0024,0.0008
11027,40927,29900,7975,2149187081.2391,1533758773645984569.2597,29901,2.300,0.0017,0.003
4639,63447,58808,23380,2143532070.6958,1539604774472761543.6414,58809,14.9497,0.0045,0.0011
15712,40218,24506,7363,2139404139.2584,1551872555920173861.7962,24507,13.9929,0.0065,0.0045
31659,115381,83722,13875,2141518935.3073,1535253856513024852.1728,83723,16.9144,0.0037,0.0009
7248,56018,48770,9634,2169041834.776,1539431917020111259.498,48771,18.8827,0.0002,0.0074
2022,11133,9111,13873,2139619409.1874,1554448275132881992.7897,9112,12.4583,0.0069,0.0048
9866,70985,61119,21605,2152379207.1,1539503097349612294.5801,61120,8.9132,0.0004,0.0031
1808,80049,78241,27678,2137134022.9255,1524817231119050988.5148,78242,16.2299,0.0052,0.0001
30229,60193,29964,2154,2156307177.4617,1534803889367012658.1266,29965,10.1528,0.0014,0.0052
3727,91360,87633,2544,2146819974.7463,1543327704707606562.2892,87634,3.2075,0.0016,0.0018
13195,55574,42379,2993,2145481949.0724,1527099306298271985.6638,42380,14.8592,0.0032,0.003
17744,20941,3197,10932,2171666989.1785,1476586713542285564.637,3198,14.5201,0.0097,0.0202
15363,25626,10263,16956,2144405027.938,1540471696864356038.0347,10264,4.1129,0.0051,0.003
5373,86652,81279,17737,2148784905.8433,1543298198816189163.351,81280,10.6868,0.0016,0.0026
25496,63225,37729,14978,2152703950.7649,1529513387689874471.0935,37730,6.0848,0.0014,0.0037
24666,98382,73716,1085,2139425750.2519,1533826360983819290.9147,73717,11.0611,0.0046,0.0006
25789,99204,73415,31550,2149498862.5042,1532060965953545743.3459,73416,13.3064,0.0015,0.0027
31025,91543,60518,15574,2149498359.0273,1534599548303653356.8659,60519,9.8891,0.0019,0.003
20907,57004,36097,10,2156635177.1875,1539148017641163065.9834,36098,6.2532,0.0007,0.004
26822,60438,33616,17391,2148155187.0086,1537135416760666101.3827,33617,9.5129,0.0018,0.0023
13948,62591,48643,13910,2142073937.286,1531079314764796933.5896,48644,4.5119,0.0038,0.0004
7181,84780,77599,14143,2160240642.8831,1537237228589066713.3911,77600,8.9264,0.0004,0.0046
11537,14414,2877,3820,2130924809.1748,1514176733981534492.9184,2878,4.9369,0.0152,0.0057
17830,95079,77249,19336,2150091851.1813,1541441455264421479.6372,77250,7.2255,0.0013,0.0022
9861,34900,25039,14698,2141160855.4118,1543803245808113064.6397,25040,6.6403,0.0037,0.0011
8545,45675,37130,14852,2162224747.5002,1548717309982612789.0141,37131,14.5708,0.0002,0.0064
14196,23641,9445,31998,2208407441.5927,1565173584434140707.6803,9446,26.9398,0.0004,0.0234
17131,78051,60920,29965,2147900904.3474,1548034655977228318.9012,60921,11.4226,0.0028,0.0025
22854,84775,61921,14504,2135190738.327,1536321058529402379.6387,61922,9.7595,0.0057,0.0001
16130,88565,72435,21848,2143446368.1567,1536270378145929887.5677,72436,5.9023,0.0039,0.0012
23989,94903,70914,13975,2150603882.4044,1533122594638006785.7943,70915,3.0707,0.0008,0.0025
7674,62238,54564,22892,2144172163.4146,1540988556230881573.2341,54565,5.0285,0.0029,0.0012
2210,80955,78745,5868,2144911351.7034,1547324308703435441.3969,78746,9.9655,0.003,0.002
5542,52160,46618,25561,2140584476.7481,1542286342483148408.8077,46619,8.5263,0.0034,0.0006
6284,14291,8007,17196,2128892145.1424,1532343212763435480.0322,8008,4.3461,0.0085,0.0012
12813,103651,90838,11574,2150043205.1121,1534523166706118828.6912,90839,4.6376,0.0007,0.0015
30704,80292,49588,25464,2137685693.7822,1526472343136572791.0357,49589,10.7923,0.0052,0.0006
32029,41822,9793,9450,2129787027.4914,1536749618951061567.7811,9794,10.3627,0.0076,0.0005
13015,105262,92247,30349,2138979377.3142,1539162447278711482.9542,92248,12.8709,0.0056,0.0003
29492,121325,91833,111,2142857465.421,1542970652727209747.6449,91834,11.3603,0.0026,0.0004
21294,118199,96905,12940,2138632092.467,1532991831954751670.8213,96906,15.2962,0.0043,0.0002
25175,97079,71904,5877,2157232392.1777,1541106298313639663.1216,71905,10.1923,0.0009,0.0048
22831,72690,49859,23131,2145565513.7229,1521598277461689776.7659,49860,22.6616,0.0044,0.0031
13982,72187,58205,6966,2152095650.7295,1531865672896710918.2776,58206,8.7333,0.0015,0.0045
18531,37265,18734,14159,2142273210.6029,1538156965356423687.4597,18735,24.8723,0.0104,0.0038
23525,63800,40275,26360,2155615418.8626,1529375178072329376.91,40276,3.9688,0.0016,0.0049
24287,43716,19429,15585,2140447532.7327,1532896631737840919.9061,19430,6.4152,0.0054,0.002
6030,79200,73170,16108,2139671647.3322,1537315183870630022.0589,73171,12.286,0.0038,0.0009
21705,97874,76169,10324,2149631049.6549,1535693767885175072.2856,76170,6.4336,0.0011,0.0024
24259,44349,20090,8315,2146292147.636,1551279586401719904.8373,20091,6.4468,0.005,0.0041
13057,28021,14964,21530,2165555257.7167,1556686809177837710.2334,14965,12.2782,0.0009,0.0104
15888,54421,38533,19947,2148783632.4804,1528235129049705886.3496,38534,5.9902,0.0025,0.0025
7792,19017,11225,3094,2161206697.1996,1524531355102976400.7217,11226,8.4695,0.0015,0.0082
14523,97029,82506,8148,2148362061.3525,1534482309877820106.4218,82507,9.129,0.0013,0.003
23782,59677,35895,12175,2146422153.163,1542512039314431864.321,35896,2.8258,0.0025,0.0023
11473,50559,39086,4407,2156061191.8967,1530998025121194169.9644,39087,10.4604,0.0018,0.0066
31849,43945,12096,8598,2167371542.8276,1530762877639085078.3762,12097,7.171,0.0025,0.0111
11994,97785,85791,16482,2136299321.7051,1534707962741952738.9293,85792,17.151,0.0055,0.0007
13818,101467,87649,31116,2157567472.2404,1536682677591546688.7805,87650,13.3952,0.0001,0.0051
4244,90320,86076,14392,2148358698.5481,1535326657091121682.2707,86077,9.703,0.0015,0.0021
7300,48347,41047,20937,2146622364.2059,1531650967941309859.9189,41048,3.5918,0.0022,0.0024
9034,17329,8295,5532,2152850739.2686,1552984115384737761.506,8296,4.9365,0.004,0.0109
29783,77070,47287,13590,2147578435.6973,1536129450296955382.2368,47288,3.8192,0.002,0.0013
32578,110580,78002,8377,2148466395.3671,1543562759589205880.7733,78003,10.2718,0.0023,0.003
11823,65857,54034,21124,2152980542.6391,1525002137966241300.8188,54035,10.0032,0.0019,0.0042
31874,86718,54844,6008,2143103598.7957,1539531758028781652.6303,54845,2.9039,0.0027,0.0006
26506,29242,2736,28354,2105808091.992,1508937068316483062.9141,2737,13.0615,0.0202,0.0053
10343,12360,2017,18119,2181242281.0619,1543336959526833770.9957,2018,11.2458,0.0082,0.0165
562,67758,67196,26063,2164114701.2042,1537502523231592498.9156,67197,17.2025,0.0001,0.0069
19856,55566,35710,23575,2136918012.8232,1523964520543354503.7218,35711,17.3476,0.0063,0.0014
14646,20849,6203,10065,2170143999.5529,1549228788950932554.8713,6204,11.6498,0.0036,0.012
29091,85315,56224,15855,2145815564.7412,1532069231859886978.0965,56225,7.6358,0.0038,0.0018
28006,61037,33031,26067,2146079120.6262,1547784936884328286.6146,33032,8.6791,0.0039,0.0024
13917,69909,55992,12826,2158559960.9839,1546016229987992826.7373,55993,11.6435,0.0006,0.0062
9862,95760,85898,20820,2149698392.2389,1544830435820854022.4966,85899,7.4906,0.0014,0.0028
2221,22687,20466,24651,2150837745.8963,1545046366625912999.3451,20467,10.5047,0.0026,0.0039
13497,48758,35261,4275,2146918751.5839,1550984082104530467.4099,35262,7.2313,0.0036,0.0035
2574,91246,88672,28490,2149002156.0523,1538055882687112386.6986,88673,3.4489,0.0009,0.0013
6496,101878,95382,8121,2141606215.3525,1537134268907804622.4557,95383,4.9752,0.003,0.0003
20043,62708,42665,28225,2137296530.2006,1538243660488009194.457,42666,14.1981,0.0054,0.0009
6582,27811,21229,18654,2164897750.443,1503432912629178468.089,21230,31.3809,0.0046,0.0099
15417,38177,22760,27127,2144895077.2771,1545349758556477036.5225,22761,3.4222,0.0036,0.0025
363,49814,49451,16871,2141047198.9723,1531878216932696079.8672,49452,9.8422,0.0042,0.0013
30304,67853,37549,29873,2151388402.1438,1541879879339600112.5754,37550,1.044,0.0007,0.0028
23461,85010,61549,29982,2157357899.2651,1538500821792710751.6707,61550,5.9136,0.0001,0.0039
21485,60046,38561,7395,2145267761.3912,1538258320664281766.0215,38562,8.3147,0.0027,0.0018
14947,70531,55584,25584,2142444388.2628,1537708962500696424.0353,55585,5.1413,0.0029,0.0007
25145,102665,77520,16067,2150695772.889,1531906174606163187.0781,77521,13.6999,0.0013,0.0026
14510,33345,18835,27225,2132401411.0281,1523133862923545703.7865,18836,35.2042,0.0087,0.0008
10469,74734,64265,11850,2156073702.5677,1532769297031258607.2956,64266,9.0659,0,0.0037
10389,50690,40301,4845,2143325747.1625,1531593883658297420.0342,40302,8.8472,0.0036,0.0022
24453,78322,53869,14874,2146845135.6758,1520132654284967152.4061,53870,19.5167,0.0047,0.0039
21225,110267,89042,25838,2137725485.3148,1535526936870127543.1382,89043,12.6784,0.0043,0.0002
30966,123099,92133,9011,2153014352.6893,1535740749939071518.8634,92134,8.8683,0.0004,0.0031
6541,92217,85676,8202,2152068040.5467,1543995210834815232.6913,85677,14.2036,0.0011,0.0034
6333,10272,3939,23207,2101100363.3132,1507232902237537861.7034,3940,14.2292,0.0234,0.0038
11304,105659,94355,7340,2152348318.5791,1539251644124164803.5993,94356,3.7382,0.0002,0.0032
6424,42390,35966,20064,2151230105.4617,1535319744482583169.0199,35967,5.0099,0.0012,0.0033
20367,54525,34158,29556,2140299572.3552,1533021374454406362.3554,34159,3.0329,0.0038,0.0007
28855,99153,70298,15863,2149436845.3868,1544777718200131771.3142,70299,4.8726,0.0018,0.0028
28040,77070,49030,10905,2148199340.8131,1531773622783773004.8043,49031,10.4708,0.0026,0.0039
16749,107758,91009,8643,2145430078.4473,1533848732580996260.5133,91010,6.7481,0.0027,0.0016
25057,26076,1019,8662,2158248582.0647,1545034133400936239.4213,1020,7.1346,0.0149,0.0241
16343,17301,958,1509,2164810419.3358,1512852366193801862.2564,959,2.7269,0.0102,0.0187
12985,43529,30544,14447,2145632542.9939,1535218563435447584.7726,30545,7.7912,0.005,0.0023
10211,41296,31085,776,2155001786.0772,1539316624585031062.6495,31086,10.7841,0.001,0.005
9446,77010,67564,13422,2152576468.1421,1532811480693671227.9,67565,5.5149,0.0008,0.0035
19317,24271,4954,12202,2144271557.3118,1548484936710036770.0463,4955,3.3255,0.0045,0.005
7075,83663,76588,2694,2150098921.6314,1541530109766531305.109,76589,4.4677,0.0011,0.002
17038,105430,88392,10406,2157488216.8274,1529449871823541552.8228,88393,16.4345,0.000,0.0057
22802,60349,37547,19055,2146772072.2523,1547713371797349861.3314,37548,14.2077,0.0027,0.0033
3213,29247,26034,7835,2165753878.0108,1535477618223057179.4756,26035,18.8395,0.0003,0.0082
7561,26083,18522,19865,2145528110.6249,1525364004355000311.5355,18523,2.7673,0.0047,0.0027
16348,101199,84851,19697,2154635861.8907,1532694531890361465.9763,84852,6.8333,0.0002,0.0033
4697,24243,19546,21089,2149315636.9551,1537277649903519429.4015,19547,2.8119,0.0023,0.0035
14557,73586,59029,30978,2141537427.0347,1538583663330611333.6787,59030,10.486,0.0039,0.0011
7764,73543,65779,30288,2147437776.1098,1540897258969346387.0846,65780,4.5213,0.0021,0.002
16942,84825,67883,7606,2156279501.1619,1543939961531190982.8021,67884,14.2903,0.0007,0.0041
19712,75218,55506,28015,2154260874.2293,1547500406641652668.0754,55507,8.1714,0.001,0.0042
27024,40213,13189,2661,2144991009.6092,1550168369710976211.7717,13190,5.862,0.0044,0.0035
11438,26355,14917,1348,2153746382.8189,1561061682842179359.8339,14918,17.4331,0.0043,0.0081
23955,73101,49146,11963,2140510552.646,1529682333630840875.9191,49147,4.1942,0.0041,0.001
14238,54692,40454,5357,2137601169.9411,1523697717936960783.9385,40455,9.7346,0.0052,0.0015
9295,60496,51201,32595,2158391847.9981,1537957051410078798.9896,51202,27.9659,0.0005,0.0069
25245,111691,86446,2663,2142720658.9065,1541151752922467913.6154,86447,12.8468,0.003,0.0004
8368,83977,75609,16764,2139781258.6217,1539104102211313024.796,75610,9.4895,0.0034,0.0004
3086,38926,35840,13969,2150674292.9882,1532087280436718549.6028,35841,7.0599,0.0016,0.0033
15692,20729,5037,9639,2115784957.3507,1533022063059285973.1193,5038,14.7555,0.0228,0.0024
6270,27478,21208,18531,2152793942.4434,1545274707399776016.0424,21209,16.3311,0.0026,0.007
10883,28996,18113,10574,2160950348.6534,1524650026915410734.441,18114,7.4003,0.0013,0.0078
31013,105742,74729,15917,2142335534.0024,1537664581895410106.5283,74730,6.9645,0.0027,0.0001
12260,62379,50119,32127,2145044963.0234,1536007756343021522.9234,50120,2.1064,0.0035,0.001
16273,29730,13457,5428,2156627726.7662,1523330429494888677.2472,13458,11.2973,0.0036,0.0059
9944,34126,24182,1264,2143089162.0835,1521831048722393618.5963,24183,12.7031,0.0049,0.0029
482,89738,89256,27994,2150357038.6077,1536417706761613319.8199,89257,8.5762,0.0008,0.0025
2449,27043,24594,27071,2161443439.0235,1554290033406223916.7898,24595,10.0974,0.0021,0.0078
20851,72561,51710,10414,2148151112.7924,1538142194545850619.9723,51711,7.0902,0.0016,0.0018
5277,34825,29548,3240,2146610409.3115,1547964144009180530.0633,29549,3.0274,0.0034,0.0032
3726,71961,68235,26745,2148072397.5966,1547366962828932770.1926,68236,6.4411,0.0019,0.0022
32383,122167,89784,27156,2147239652.4078,1540748400591569566.043,89785,7.9738,0.0017,0.0016
31388,49332,17944,21160,2136143376.4193,1536429251630634643.0828,17945,3.0563,0.0074,0.0013
15740,75282,59542,27882,2146758168.8558,1533890617003188697.0555,59543,11.1117,0.0025,0.0025
21349,47891,26542,19889,2142126912.8722,1557716813657307105.7809,26543,6.9631,0.0058,0.0032
18278,21335,3057,13752,2234915613.1298,1536755788404194506.2582,3058,20.7027,0.0006,0.0319
2969,15349,12380,4680,2176368608.9131,1558209379017679345.7411,12381,15.8266,0.0001,0.0135
26278,101404,75126,30033,2150455100.7069,1546446344333084810.4729,75127,9.8163,0.0019,0.0032
23683,64666,40983,23484,2142844019.8127,1545244192985677581.7169,40984,4.5741,0.0031,0.0013
14976,56166,41190,27861,2134318200.5256,1532296631284382877.3368,41191,11.8455,0.0057,0.001
24676,29332,4656,5220,2186546529.7943,1581892508014451527.749,4657,16.3771,0.005,0.0204
23687,39187,15500,29256,2157139111.51,1527122360052889866.4332,15501,14.7697,0.0019,0.0079
6446,101179,94733,22548,2141694280.0604,1542115712710958879.544,94734,8.7467,0.0029,0.0003
23445,92824,69379,24690,2156277263.6484,1537656927543778585.8599,69380,6.346,0.0004,0.0043
13744,109983,96239,28953,2142558508.4732,1548094736801452646.7798,96240,15.1866,0.0032,0.002
30329,96421,66092,14754,2145819660.6062,1533607156921607857.6864,66093,5.6885,0.0019,0.0011
24532,38226,13694,13882,2126253619.1263,1525554981270296420.2481,13695,13.8577,0.0128,0.0008
24208,47156,22948,31225,2154105019.5215,1548643613502416655.0185,22949,8.0158,0.002,0.0054
28631,38033,9402,23763,2125318498.3664,1514103541021061439.1006,9403,7.4996,0.0106,0.0029
17561,91172,73611,28365,2146808873.9674,1541869823394285711.4749,73612,6.3305,0.0017,0.0017
8452,60035,51583,19388,2144074987.2618,1543084208589384100.893,51584,5.0238,0.0028,0.0011
22679,80256,57577,25815,2151908507.2917,1536802475279847364.2815,57578,4.1811,0.0011,0.003
4013,21477,17464,25102,2125651633.9983,1528211724440356382.6101,17465,13.1743,0.0106,0.0008
25476,84207,58731,17249,2152643920.033,1534604906485671775.3269,58732,11.6668,0.0014,0.0044
28618,119168,90550,2802,2155474347.0313,1540429674294643702.304,90551,8.1825,0.0002,0.004
18335,84737,66402,15310,2140581905.291,1529971322367824969.5864,66403,7.6775,0.0034,0.001
10755,102217,91462,25721,2143367227.3035,1542671221155414428.9536,91463,14.6203,0.0036,0.0011
27829,109851,82022,14833,2141752550.7911,1539817208893627807.5867,82023,20.3492,0.0034,0.0016
9991,84525,74534,23451,2154207549.9539,1532984498849158197.421,74535,12.5508,0.001,0.0032
16252,95732,79480,3340,2138931866.5616,1536704082779346537.0312,79481,7.0841,0.0035,0.0002
18578,23817,5239,11564,2131118355.1824,1562631975851744616.4698,5240,14.6689,0.0138,0.0046
17989,56504,38515,3702,2152153864.383,1542926993718100083.3468,38516,6.9458,0.0013,0.0038
16902,36749,19847,14407,2165161743.4815,1505753822572970341.1154,19848,34.2284,0.0041,0.0124
30266,121745,91479,11475,2151605885.6878,1541892069003432215.059,91480,6.5276,0.0004,0.0026
7280,90717,83437,9979,2153690510.9413,1533970121925309810.6071,83438,4.9114,0.0009,0.0037
24787,87522,62735,26525,2138133077.7045,1552025064444407754.5678,62736,22.0536,0.0059,0.0009
9734,63622,53888,1824,2155107838.1875,1546815555402033680.4237,53889,11.9236,0.0007,0.0044
30411,71674,41263,22108,2152839931.051,1534972850347735192.6952,41264,11.780,0.0015,0.0035
32044,38400,6356,7645,2139487872.0823,1564003546787424078.2193,6357,12.319,0.0118,0.0101
14964,103058,88094,21188,2152765623.9896,1545522895107299249.9013,88095,11.5108,0.0011,0.0034
24472,97159,72687,17478,2149986036.8568,1550843454968620526.6935,72688,20.8005,0.0024,0.0033
6292,12139,5847,17986,2156900540.0527,1535002791603659356.8693,5848,5.273,0.003,0.0071
18683,73894,55211,6834,2148003716.8346,1532994592181341511.4148,55212,5.8754,0.0024,0.0021
14788,65288,50500,10022,2154575397.5531,1550394976245019588.1353,50501,12.4183,0.0018,0.0044
28808,70052,41244,11791,2156587228.5467,1544510179729928481.3754,41245,5.2167,0.0003,0.005
10002,62893,52891,26118,2136402517.5222,1540880428030694795.1402,52892,13.095,0.0065,0.0004
24589,88772,64183,13667,2151213727.8445,1531997428681821827.46,64184,7.3597,0.0008,0.003
17174,66923,49749,11135,2145656586.5264,1531592693006412881.4023,49750,6.5953,0.0038,0.0021
26676,40283,13607,23220,2181755440.8804,1526515559904971488.3446,13608,22.5519,0.0007,0.0116
7676,39963,32287,19600,2147670362.8261,1538772239736851586.1566,32288,3.8553,0.0028,0.0031
20520,79935,59415,6160,2149697600.9299,1536986611289810106.9106,59416,18.396,0.0022,0.005
1289,41604,40315,14681,2135376405.3672,1546683304309633958.5838,40316,10.2469,0.0062,0.0002
23061,88091,65030,22670,2149876925.2585,1540880046275351394.893,65031,4.513,0.0016,0.0024
2129,18171,16042,21110,2148668039.91,1540158514346878585.2831,16043,7.1455,0.0029,0.0037
24064,72861,48797,11645,2142780450.6378,1531523451911271427.398,48798,4.4303,0.0039,0.0009
4489,19134,14645,31207,2113527748.0927,1521145294546473212.5865,14646,25.4215,0.0139,0.0001
388,59310,58922,21173,2157133441.6645,1528594518042339817.2135,58923,9.5324,0.0008,0.0046
1676,8754,7078,29496,2132585700.0843,1534424437743543232.2352,7079,2.9252,0.0075,0.0005
14951,45012,30061,1296,2142354765.3808,1551422192161016600.142,30062,13.4987,0.006,0.0029
13584,19800,6216,25061,2175682654.6001,1560881295550038907.7597,6217,14.4719,0.0024,0.0173
9568,76485,66917,29960,2151764517.8942,1547343710549272253.7251,66918,7.9257,0.0015,0.0029
200,40084,39884,3162,2143719003.2386,1539336580675462671.6215,39885,2.655,0.0031,0.0016
5847,27832,21985,19685,2140187151.333,1539655264815589491.0095,21986,6.6004,0.0041,0.0011
6609,49153,42544,17122,2154406188.152,1544707791368728008.3906,42545,8.6128,0.0016,0.0049
15877,18166,2289,685,2155024924.6179,1510077528737057542.3278,2290,4.1986,0.0081,0.0122
30806,100358,69552,1682,2159336144.8859,1544683483999272004.5981,69553,13.3032,0.0001,0.0049
2989,5389,2400,11752,2122972370.6185,1558234362796032055.2447,2401,7.460,0.0163,0.0047
32689,111635,78946,27290,2148370681.3284,1537533313255734088.5944,78947,3.7333,0.001,0.0018
31146,122962,91816,17073,2154568719.2496,1536525784182036991.013,91817,6.7312,0.0004,0.0037
13620,46749,33129,16945,2143973167.5344,1541079385131437091.4317,33130,5.2773,0.0039,0.0018
20318,46475,26157,16807,2147699660.7305,1543240122340623051.9621,26158,4.7036,0.0027,0.0036
29583,111970,82387,27495,2137963072.1585,1530218820925000796.3849,82388,8.0885,0.0044,0.0001
757,41389,40632,18716,2144533312.5024,1542355708126027469.9761,40633,4.8822,0.0036,0.0023
30585,65791,35206,19659,2145263907.2226,1541422750570374329.7095,35207,3.5972,0.0029,0.0023
25877,58923,33046,28596,2154254891.8873,1539697792058993915.2521,33047,9.3701,0.0015,0.0056
13825,16201,2376,19107,2164726891.4918,1549709968582159388.2971,2377,2.2832,0.0042,0.0121
12753,15690,2937,25838,2138203508.0378,1536001412119334422.1283,2938,16.7717,0.0108,0.009
31707,95710,64003,9426,2147113325.7705,1549836413954577898.7683,64004,8.8233,0.0031,0.0026
4698,96466,91768,9520,2145788769.3211,1538114864107969644.2802,91769,3.6577,0.0016,0.0008
11725,12284,559,9218,2171732921.1571,1605329391810299103.8467,560,7.0994,0.0234,0.0349
8417,13106,4689,15210,2118135387.0557,1538486529629685496.479,4690,9.7341,0.0125,0.0002
22393,92460,70067,30805,2151752565.5919,1526190976368988405.5203,70068,17.9596,0.0017,0.0041
18319,53989,35670,16249,2145025991.666,1531298571883281180.8322,35671,5.0615,0.0038,0.0024
17677,56021,38344,11893,2132207568.162,1532106964345787836.6267,38345,11.2467,0.0062,0.0008
10039,39157,29118,20861,2135791426.6415,1553787693215980851.6116,29119,21.6384,0.007,0.0025
15129,103130,88001,16510,2141676374.9573,1538000090284963648.0329,88002,8.5178,0.0024,0.0001
14827,106226,91399,12176,2160990295.5513,1539523436545998578.7493,91400,19.4279,0.000,0.0051
20176,62799,42623,4339,2147624259.2778,1549088889430623340.9334,42624,12.6298,0.0039,0.0024
31122,42430,11308,15464,2141670896.7631,1532298325814592248.1086,11309,3.5537,0.0061,0.0031
29091,117326,88235,10515,2144575837.0874,1528783256190679265.0338,88236,9.9773,0.0028,0.0012
31943,100333,68390,19054,2144093296.3455,1533176227929500567.9018,68391,8.6635,0.0028,0.0012
13489,113277,99788,3671,2146389760.6656,1539128160407855780.8784,99789,4.4162,0.0016,0.0009
4351,39005,34654,2371,2133290223.6468,1531163502764269254.1021,34655,7.4687,0.0065,0.0006
24466,81901,57435,14501,2146368155.6653,1540018303728955765.7965,57436,4.4181,0.002,0.0022
7747,29568,21821,27859,2153085857.006,1526047442238441479.5891,21822,8.6483,0.0035,0.0056
25915,84397,58482,16679,2143971576.4032,1533973353261417402.387,58483,3.8005,0.0029,0.0014
11067,106808,95741,2283,2137346523.5414,1546560110029618334.7757,95742,16.5741,0.0046,0.0015
6365,33600,27235,6189,2139550158.1923,1529623114682955478.6633,27236,13.1815,0.0047,0.0015
29794,41308,11514,2903,2174747428.9812,1510563864539435532.9606,11515,32.4359,0.0042,0.0186
22328,120058,97730,30634,2146401462.36,1545528072031728332.9768,97731,8.8424,0.0023,0.0022
972,52529,51557,27630,2160552538.7996,1528965598041545296.6615,51558,13.0148,0.0003,0.0063
12325,17972,5647,808,2175201209.2734,1520808635712034830.5442,5648,13.120,0.002,0.0128
163,51658,51495,722,2158915377.7977,1535477624960765169.1007,51496,17.7601,0.0002,0.0051
24741,64277,39536,9407,2151343801.9361,1539576183383273759.0116,39537,9.9589,0.0017,0.0047
8703,70652,61949,2636,2161089007.6878,1541619231620556857.4861,61950,21.9309,0.0013,0.0069
9168,51676,42508,22744,2152045062.8566,1542129015099187147.0551,42509,20.7968,0.0027,0.0063
4480,58530,54050,4385,2149927801.3105,1533504516781943736.1122,54051,7.2092,0.0016,0.0032
27081,74125,47044,18395,2151856698.1633,1543400979024374358.3469,47045,11.5728,0.002,0.0037
11073,18587,7514,25147,2153902470.0954,1558320992373785793.8311,7515,4.2106,0.0051,0.0071
21772,106660,84888,19997,2150400221.7854,1541991596283747334.0462,84889,17.1093,0.0011,0.003
32298,79643,47345,18142,2163490605.7943,1521334072188390713.781,47346,32.9138,0.0001,0.0073
18672,99199,80527,11640,2138913271.4738,1537297209833430081.5078,80528,11.442,0.0039,0.0002
24057,82856,58799,11541,2141665129.6399,1536462793180606007.4272,58800,5.6657,0.0034,0.0009
26917,28370,1453,11183,2148692208.9085,1508176751153941155.493,1454,4.2523,0.0093,0.0086
12670,60104,47434,8839,2141626060.0852,1547944536286392977.2171,47435,10.0534,0.0041,0.0024
28352,124931,96579,22055,2137340993.3383,1537262482340338775.5677,96580,10.7477,0.0046,0.0001
16755,39014,22259,9390,2133840264.6612,1514129697056693519.9514,22260,15.708,0.0091,0.0022
28431,79018,50587,7181,2158350969.7854,1531533405137703697.9473,50588,7.0533,0.0004,0.0048
28066,49172,21106,26270,2147484604.8756,1531601706308129310.4814,21107,3.4385,0.0034,0.0026
14441,85526,71085,18910,2150356970.3463,1547676827397826748.902,71086,15.4003,0.0019,0.0031
19299,44475,25176,1084,2148980881.1126,1548818512554768214.3067,25177,7.8913,0.0034,0.0039
19492,43248,23756,6029,2148108104.3209,1532081788080914695.6791,23757,6.8844,0.0027,0.003
26664,102590,75926,25557,2146733628.7179,1537353498127430807.0121,75927,8.7801,0.0024,0.002
2336,40624,38288,22166,2163170874.4518,1541067343704710251.5805,38289,9.9052,0.0002,0.0068
22447,89249,66802,22494,2143506065.8055,1532102031967625265.8613,66803,10.9208,0.0026,0.0016
32168,34890,2722,31953,2126198465.9596,1521267900800216449.5591,2723,5.1416,0.017,0.0032
23236,47452,24216,22348,2152390972.4749,1525946970198290562.2585,24217,10.3498,0.0023,0.0052
27164,125274,98110,7634,2145476164.7844,1534893584170519683.7776,98111,3.2334,0.0018,0.0005
27759,29356,1597,10864,2137907789.9806,1524822896645532126.4446,1598,2.1833,0.0095,0.0045
29457,125573,96116,14001,2152441750.5181,1533706432960299755.8925,96117,7.9533,0.0008,0.0036
28603,52606,24003,6847,2147575368.8658,1545486430309997657.3085,24004,3.5649,0.0033,0.0031
15815,93507,77692,31435,2153163217.0157,1541387227555590347.2939,77693,6.0356,0.0007,0.0028
25896,71649,45753,32007,2145946614.8348,1540617107225655709.547,45754,10.7627,0.0031,0.0037
30003,67491,37488,7648,2130681912.2579,1546437889348882376.9606,37489,16.4723,0.0071,0.0002
12659,39636,26977,11159,2154154636.1728,1547923062130779364.3153,26978,8.7594,0.0012,0.0057
9302,106321,97019,12865,2154137517.7507,1543405488168916442.5267,97020,8.3784,0.0006,0.004
7095,39855,32760,22543,2144099218.8689,1559398203292675578.619,32761,15.4947,0.0061,0.0034
26105,47417,21312,24098,2127946581.3348,1534427922728008139.1832,21313,9.0567,0.010,0.0002
13583,33017,19434,10384,2157025572.4294,1532751052778374084.3615,19435,14.8685,0.001,0.0059
12595,69542,56947,20372,2138103094.2561,1527580744770367863.7112,56948,17.6887,0.006,0.001
15042,104106,89064,27115,2142636143.1082,1537865705601848087.6083,89065,11.0496,0.0042,0.0009
4726,85040,80314,7778,2132734183.6,1534316576497335871.1558,80315,17.8236,0.0055,0.000
25361,93529,68168,12754,2149649568.5157,1541994545342895972.7076,68169,5.694,0.0014,0.0027
331,78838,78507,6456,2157414457.5,1543989345169059390.7386,78508,9.5654,0.0005,0.0043
24286,85409,61123,29641,2154479967.3941,1535214475067907545.6163,61124,10.4685,0.0007,0.0038
17345,55410,38065,24552,2160020683.274,1540238823916783777.527,38066,7.9662,0.0001,0.0049
8373,68086,59713,31247,2153707939.9128,1524146354725991977.4672,59714,13.6541,0.0014,0.0037
12560,54672,42112,21081,2135775295.1214,1539508193790288229.2861,42113,14.6928,0.0055,0.000
1128,31724,30596,26044,2145579715.1172,1543213676319948271.9218,30597,13.9823,0.0037,0.0039
20241,119497,99256,12440,2134978035.2465,1531552339578638141.6299,99257,16.3916,0.0052,0.000
728,24851,24123,23198,2147087219.5046,1551299832417591282.5912,24124,7.604,0.0036,0.0026
29136,49011,19875,13778,2126643362.8777,1536408894065620454.698,19876,15.448,0.0106,0.0018
4953,9909,4956,31351,2150124662.4777,1544407114544015486.7651,4957,4.5282,0.0041,0.0065
21364,28485,7121,6932,2142729784.0571,1526375461976287437.5414,7122,4.9364,0.0079,0.0049
27135,40893,13758,13050,2135486575.014,1568707875899946366.9136,13759,19.0226,0.0091,0.0051
32607,38079,5472,26944,2148083585.987,1571908918078990569.4661,5473,22.8113,0.0101,0.0108
4026,18485,14459,12531,2143121627.308,1551184225813177376.2574,14460,19.6614,0.0101,0.0046
25273,33032,7759,7240,2117265174.9268,1543551379481172832.3915,7760,16.9249,0.0135,0.0012
842,6154,5312,8057,2122502112.3759,1537334662224248142.8937,5313,8.4414,0.0175,0.0015
29621,75241,45620,19970,2148720570.7439,1531195369684834901.3221,45621,9.9984,0.0025,0.003
4225,97446,93221,17434,2150053655.4148,1542964089421956214.393,93222,7.6864,0.0009,0.0021
24444,58515,34071,1342,2153329362.1523,1538064439167036134.6731,34072,8.3856,0.0006,0.0034
24592,51796,27204,5621,2168592911.7437,1528916797238301636.0687,27205,20.5346,0.000,0.0084
15782,58306,42524,4604,2138786221.8519,1533229834273444115.6593,42525,9.7724,0.0053,0.0004
28600,37061,8461,22053,2148352786.7593,1525203395988075161.854,8462,4.9894,0.0038,0.0049
17499,41689,24190,20867,2159917342.1491,1533633523817506499.4534,24191,23.3564,0.0013,0.0073
13391,43542,30151,24333,2149001930.6457,1536354512681334903.8682,30152,3.7861,0.0014,0.0019
2638,69908,67270,16130,2146688993.4002,1537785017163816627.727,67271,16.0969,0.0023,0.0043
25930,62728,36798,801,2151359848.2519,1534962273492418773.257,36799,12.0844,0.0006,0.0023
4246,52541,48295,6305,2127571220.7023,1533565440449814550.2768,48296,15.2946,0.0074,0.000
5126,5895,769,19135,2112813252.2948,1471038509324827994.9689,770,9.7082,0.0399,0.0124
27758,113696,85938,20389,2150040130.5155,1542747757408407352.0772,85939,8.5426,0.0017,0.0032
3378,38223,34845,29311,2150137782.2232,1551095246181425748.5637,34846,5.6115,0.002,0.0039
18902,112487,93585,12556,2161271227.8147,1536613352960256316.0423,93586,19.418,0.000,0.0049
11001,36442,25441,3853,2149071013.1408,1529590202586139591.9658,25442,11.5457,0.0032,0.0039
18532,90961,72429,20523,2143636834.7062,1546021604082587350.6538,72430,27.6759,0.004,0.0023
31447,71451,40004,29692,2154685715.1583,1526808186328590109.3675,40005,10.8614,0.0007,0.005
19754,82220,62466,20558,2150094393.0746,1538427923824021745.0504,62467,7.6475,0.0009,0.0037
28679,120915,92236,31155,2146456122.7266,1541511473113437624.1408,92237,3.654,0.0019,0.0014
12098,77992,65894,24074,2158609168.5621,1538154961248759962.9246,65895,14.7565,0.0001,0.005
2596,6796,4200,7907,2144014278.2821,1516109111289626871.4608,4201,6.1661,0.0076,0.0059
7706,69810,62104,29264,2147609920.3195,1542057826702021094.9221,62105,9.4104,0.0025,0.0023
13971,91277,77306,10245,2147631636.2368,1536838519879683093.3421,77307,9.0875,0.0028,0.0021
9103,15451,6348,11060,2165435012.559,1518869341427824942.7058,6349,9.4387,0.0022,0.0104
15774,105538,89764,2997,2134248681.6921,1535326149936305403.7819,89765,13.4188,0.0049,0.0001
15818,48475,32657,23052,2150575485.165,1529341058097409371.0384,32658,3.6269,0.0015,0.0032
9888,41645,31757,5861,2133369112.0324,1543129547146292654.3219,31758,13.2066,0.007,0.000
22414,79610,57196,24246,2138555580.7427,1540935764698724579.7411,57197,8.9661,0.0038,0.000
20663,63212,42549,23060,2146995927.8269,1546147320319603400.6048,42550,9.9937,0.0028,0.0025
2447,77416,74969,12767,2146643002.9879,1531218879471387714.1315,74970,6.9043,0.0023,0.0016
28682,32462,3780,31488,2097256817.8286,1538623674352858506.5768,3781,11.6898,0.0227,0.0015
30452,54878,24426,22034,2127579340.1816,1525571298285077889.3031,24427,16.0821,0.0107,0.0012
5081,63228,58147,25457,2157545761.6209,1547774072078026039.0153,58148,14.4272,0.0005,0.005
12106,14065,1959,31898,2152024838.2265,1493046267127941366.3834,1960,11.6654,0.0139,0.0165
2518,88433,85915,27506,2153821989.1848,1537580683046044576.841,85916,8.7371,0.0003,0.0047
19833,50464,30631,5296,2157086930.8142,1533334079417518577.0844,30632,8.8935,0.0009,0.0047
30823,118825,88002,23719,2134419788.9869,1534635095320566270.604,88003,12.025,0.0047,0.000
2861,83171,80310,31137,2161252226.7393,1541512009155075039.6395,80311,18.8985,0.0002,0.0053
2901,83812,80911,6558,2144797313.8093,1538087409412773652.8856,80912,4.9487,0.0017,0.0005
29795,84400,54605,11991,2138682012.2368,1540298273690619243.7165,54606,10.6534,0.005,0.0008
19379,66323,46944,1765,2146806412.1595,1537438809398281820.2668,46945,2.9383,0.0018,0.0017
27474,107398,79924,30065,2152290188.1846,1543943331959851536.3092,79925,10.9194,0.0013,0.0029
31979,116411,84432,118,2141816668.2075,1537900361685750584.112,84433,6.8087,0.0029,0.0001
29404,49584,20180,6910,2141481637.9741,1538242069405948345.5831,20181,9.7218,0.0042,0.0013
21729,117935,96206,9820,2152270705.617,1536531223043209517.0286,96207,6.4028,0.0004,0.0031
8694,78821,70127,16597,2147570271.7341,1540567074028935290.385,70128,3.2283,0.0016,0.0019
10091,87558,77467,1759,2140988959.5812,1535738860435998194.4082,77468,5.2548,0.0031,0.0003
17477,57602,40125,21008,2142348672.2653,1543348002639661856.6001,40126,7.7886,0.0033,0.0014
19791,33801,14010,16762,2151948558.7053,1529760877967032883.2943,14011,5.9108,0.0027,0.0041
27058,93484,66426,31636,2147620324.4382,1542980503218882353.458,66427,5.025,0.0019,0.002
25190,27919,2729,13389,2185287643.9908,1495215009139457769.8933,2730,11.7789,0.0062,0.0212
2373,35898,33525,20685,2158941671.4506,1537565548104817619.7723,33526,12.9053,0.0006,0.0071
25039,92764,67725,1283,2151436599.1256,1530987007919909439.1743,67726,5.2775,0.0007,0.0029
22894,122221,99327,28620,2146580541.8918,1534496805116276897.0244,99328,5.8881,0.0015,0.001
26508,109057,82549,21286,2143074833.3773,1535393740821234413.6166,82550,7.494,0.0023,0.0008
3670,63370,59700,954,2143716433.9593,1537260358578323594.0881,59701,7.9694,0.0029,0.0011
23686,70319,46633,32721,2140320971.3994,1529247334784100987.0409,46634,5.447,0.0045,0.0011
5338,20910,15572,6606,2158768309.8774,1541776500212191638.8277,15573,5.0799,0.0014,0.0066
16935,18188,1253,20902,2218203851.8094,1554633101865348018.0873,1254,9.3179,0.0007,0.0369
8748,52547,43799,12372,2162211835.4211,1540774019713166852.6138,43800,13.8647,0.000,0.0068
4180,58467,54287,10673,2151919899.8731,1530115441767894379.8579,54288,9.7358,0.0025,0.0036
32755,107275,74520,30876,2149201532.7016,1545417162006482188.0703,74521,12.8936,0.0023,0.0032
4798,90696,85898,17321,2157942369.4606,1536660417609599996.2534,85899,12.8474,0.0001,0.0043
17240,100437,83197,32274,2148992144.8917,1536600197142319975.8528,83198,11.7419,0.0011,0.0017
28608,126905,98297,21378,2150380866.0979,1536855490529721100.8016,98298,8.8387,0.0007,0.0016
20722,118969,98247,32301,2144826795.6865,1537170264031657138.6465,98248,7.4487,0.0027,0.0012
1005,65701,64696,5584,2136365210.5016,1539997651445936414.5783,64697,10.6684,0.0054,0.0006
23765,119097,95332,30767,2150548073.6574,1535773049564281957.4341,95333,14.6362,0.0012,0.0028
12512,48140,35628,3697,2156708404.5889,1535443326831909100.2173,35629,5.6799,0.0006,0.0046
28951,95596,66645,26517,2145847534.3305,1538040090161319622.2146,66646,8.1618,0.002,0.0015
5348,13199,7851,23486,2134185721.285,1544934400827797167.6638,7852,11.1434,0.0081,0.0015
15930,83041,67111,29018,2148644017.1402,1534711810017459224.3905,67112,8.0141,0.0018,0.0022
1720,40145,38425,17164,2152410998.8846,1547256715669515070.0589,38426,30.7506,0.0031,0.0062
26860,43474,16614,1809,2138387083.3111,1524940020783031789.6592,16615,6.1028,0.0061,0.0019
4599,40074,35475,9457,2141543340.3511,1527355748960584096.2067,35476,8.5472,0.004,0.0023
2595,18936,16341,14977,2173062757.8831,1535642713681761169.4967,16342,9.7185,0.0001,0.0098
16092,79942,63850,15131,2155912142.7799,1526449757553918570.0486,63851,14.3047,0.0015,0.0041
12776,82161,69385,12178,2130553147.4177,1535385792101360332.8416,69386,17.8982,0.0061,0.0001
15484,50666,35182,7595,2143923520.9276,1533655045216948147.6433,35183,3.4692,0.003,0.0014
27605,53553,25948,6393,2162072949.3932,1542382791698966970.2578,25949,14.784,0.000,0.0061
19041,81444,62403,28765,2143043761.9721,1545916751144683103.3151,62404,10.8942,0.0052,0.0021
6036,27977,21941,9711,2160130990.9781,1543066860392713289.3104,21942,14.0601,0.0021,0.0063
12638,63023,50385,20211,2133851017.5834,1551234404710285135.9065,50386,21.6338,0.0059,0.0011
744,44172,43428,5888,2132601686.2636,1547943851165689413.878,43429,15.4354,0.007,0.0009
22214,121239,99025,7351,2155479913.456,1533624359015387187.6855,99026,8.0246,0.0008,0.0037
31094,56726,25632,25522,2162588751.3305,1540398571438573541.2726,25633,12.7113,0.0014,0.0087
28498,108609,80111,8780,2146471587.4968,1534913803463956978.0463,80112,4.1677,0.0021,0.0013
25104,100307,75203,20434,2155136853.9286,1541160617729390604.9729,75204,11.0766,0.0001,0.0032
15444,29254,13810,20695,2138928352.7152,1531131440500993020.7001,13811,5.514,0.0071,0.0024
4169,64004,59835,20443,2161722083.5144,1538255890002691861.9784,59836,12.4661,0.0001,0.0067
26272,109713,83441,15165,2146204125.2123,1528763395744181871.2774,83442,4.9921,0.0026,0.0016
29035,44469,15434,20369,2156406653.4062,1533072005360616586.0506,15435,2.6473,0.0013,0.005
29679,80408,50729,28344,2149387830.8499,1536240946782613305.4757,50730,2.0367,0.0008,0.0019
12383,67104,54721,21379,2151541957.9334,1527179546758874528.7876,54722,7.4209,0.0022,0.0044
26100,46102,20002,15228,2147472866.7347,1538903152065631438.6263,20003,22.459,0.0044,0.0042
27194,109805,82611,17116,2144047896.3338,1543061961784670762.1967,82612,4.0132,0.0019,0.0011
12681,62000,49319,23988,2142785801.1224,1538055398039096862.6119,49320,6.7553,0.0024,0.0008
31277,33402,2125,19163,2163998498.9995,1501806863210265157.4595,2126,9.3795,0.0155,0.0237
13384,49494,36110,8321,2138693215.9473,1528497957865037277.346,36111,8.0767,0.005,0.0012
19179,116852,97673,13024,2153370016.5552,1546373884307275622.4286,97674,8.9744,0.0012,0.0034
21640,115951,94311,29402,2145902128.6109,1524324389432413993.8539,94312,20.0454,0.003,0.0026
6437,37853,31416,28395,2133103201.2369,1537274307429963759.9947,31417,10.5142,0.0072,0.0002
16169,26770,10601,16183,2149412690.9605,1538749453444484770.6641,10602,1.2913,0.0042,0.0066
24575,36744,12169,1218,2155854618.0403,1527088790104353540.4504,12170,4.6114,0.0029,0.0059
5818,29679,23861,25153,2154687417.1359,1542516214192588055.5287,23862,3.466,0.0016,0.0056
30156,114891,84735,21152,2133064971.1858,1540158606193128075.5893,84736,15.1783,0.0058,0.0009
11657,98044,86387,19498,2150577828.5795,1529064067269319720.0653,86388,10.6569,0.0019,0.0028
2236,49237,47001,18557,2157632633.4932,1540836675084630337.096,47002,6.2972,0.0006,0.0046
25066,37941,12875,28281,2145602115.3006,1517453529778601411.0154,12876,4.5327,0.0048,0.0043
30121,40847,10726,30570,2126423782.0873,1526236641017947532.9619,10727,11.2754,0.0098,0.0013
2816,9841,7025,22108,2122895371.0935,1549792845292573224.6621,7026,4.3757,0.0125,0.0021
24867,57104,32237,549,2145681206.8347,1537997842575096054.4526,32238,7.0648,0.0027,0.003
2822,32071,29249,28312,2149530333.5127,1546753217968875979.5013,29250,5.6005,0.0027,0.0035
23689,110466,86777,24301,2144602818.9135,1532046087581082687.5147,86778,9.4148,0.0025,0.0017
19706,31605,11899,27555,2148618312.6476,1532299091643669639.3714,11900,20.3332,0.0087,0.005
25590,58570,32980,29267,2156306578.3453,1536090482215023986.7179,32981,6.5828,0.0011,0.005
24974,54079,29105,30122,2141385573.2453,1533446153946198448.7652,29106,6.7191,0.0047,0.0011
15826,70493,54667,27026,2151919850.3577,1538581993000011189.3424,54668,1.1177,0.0007,0.0028
4192,82990,78798,19905,2144716401.4545,1537464861515246984.0403,78799,4.0007,0.0033,0.0016
31580,108401,76821,31970,2146971882.846,1539004980361605197.3929,76822,6.4692,0.0029,0.0016
8314,44822,36508,22707,2144943623.1599,1539436970074868380.7631,36509,5.8533,0.0039,0.0013
1691,65458,63767,22528,2154675631.9444,1538155472329008019.1347,63768,11.3752,0.0002,0.0036
4389,12831,8442,13186,2146005326.3049,1558457978329877210.6187,8443,5.0623,0.0074,0.0059
26202,37347,11145,18325,2161729555.6159,1560844879868361029.5601,11146,11.0776,0.0048,0.0102
10155,12604,2449,28572,2163722642.202,1521702330405545120.3139,2450,6.4754,0.0074,0.0139
17884,100693,82809,5631,2148699937.7909,1534440058972804025.3394,82810,3.3299,0.0015,0.0019
27074,111376,84302,25227,2154267845.6033,1547543897683440315.2771,84303,16.0357,0.0006,0.0037
23754,31247,7493,442,2160312873.9649,1525024585846460460.7037,7494,7.9843,0.0033,0.0102
4895,8674,3779,32418,2157174049.064,1520434063568535985.2049,3780,2.1413,0.0049,0.0083
32404,127754,95350,24323,2148446439.5554,1537101150292186414.6604,95351,18.3016,0.0019,0.003
28799,96503,67704,17437,2153402587.1743,1535573312786787523.5555,67705,5.763,0.0006,0.0027
27067,63064,35997,12690,2136078613.0491,1541392039052319291.9484,35998,8.8495,0.0064,0.000
1329,66347,65018,11416,2141634052.1356,1531524385214460227.8231,65019,6.7047,0.0034,0.0009
29267,111332,82065,23828,2144828498.5921,1553296827327043901.8447,82066,27.0278,0.0044,0.0029
2519,96774,94255,22374,2143644781.8626,1545146014740754887.0128,94256,15.7275,0.0031,0.0008
3844,25365,21521,6263,2138888083.1277,1546276119263538170.1735,21522,7.2975,0.0077,0.0023
2584,33459,30875,23637,2158557052.0283,1533411037669134129.5035,30876,10.8482,0.0014,0.0069
4235,88734,84499,15666,2143476431.0667,1537247581521542885.2798,84500,18.7014,0.0042,0.0011
18036,72462,54426,5925,2138694771.0557,1528513419815384729.5971,54427,5.8863,0.0047,0.0005
13622,104009,90387,18016,2139909212.4676,1537720172135126983.3162,90388,17.561,0.0035,0.000
29480,63741,34261,28822,2152524547.246,1546291912761043464.3628,34262,9.5752,0.0018,0.0053
10783,24189,13406,30910,2151236895.9808,1541042711914346057.3592,13407,5.6469,0.0028,0.0053
15361,94974,79613,2006,2155522210.5895,1539260342882278337.5251,79614,8.7289,0.000,0.0035
14873,40389,25516,2667,2163575695.2226,1525583221172535025.3061,25517,11.9014,0.0002,0.0074
19091,101100,82009,19277,2147553512.7212,1526994863108260289.9025,82010,11.6654,0.0024,0.003
29255,56788,27533,20629,2159944123.1455,1531534088108931297.5947,27534,11.4874,0.0005,0.0064
4739,5525,786,32696,2141854335.4536,1586120281348319739.272,787,3.5195,0.023,0.0204
12400,25369,12969,25485,2129240307.9709,1527789624218247804.9997,12970,7.0953,0.0079,0.001
29863,120407,90544,19734,2155689663.0085,1548789989711644845.2523,90545,16.4938,0.0009,0.0047
4070,25828,21758,4527,2157962169.1216,1521791103658227239.2021,21759,15.3019,0.0008,0.0083
7520,19298,11778,11246,2153515053.3866,1563148406466973141.5673,11779,4.6447,0.0035,0.0084
27801,82796,54995,26710,2140014066.6012,1523434468696755509.075,54996,16.923,0.006,0.0017
9317,22156,12839,5611,2150311350.0421,1535619996457963847.9126,12840,16.0982,0.0041,0.0048
16142,93874,77732,2034,2152561422.2574,1543802874931852680.9216,77733,3.2186,0.0008,0.0035
23072,25743,2671,18347,2173842249.3563,1552742844388977544.7323,2672,3.5559,0.0028,0.0128
23949,106154,82205,29947,2156778161.3387,1530363156050784418.369,82206,11.5875,0.0004,0.0048
11390,98764,87374,20977,2153553033.4094,1533232378582031364.0065,87375,9.6534,0.000,0.0033
26006,78691,52685,5204,2147722465.7512,1533546432669076974.6754,52686,3.2969,0.0016,0.0018
18252,115882,97630,28308,2151784474.4714,1535658019265134759.7994,97631,5.3195,0.0001,0.0027
31459,38544,7085,28011,2093193878.9016,1536002059416639438.6365,7086,23.5467,0.0234,0.0001
16468,87237,70769,29449,2141078932.7588,1536405191542854129.5934,70770,17.5709,0.0038,0.0011
31481,108958,77477,11024,2158733600.9667,1536082260364902970.2424,77478,13.0957,0.0001,0.0065
31534,45780,14246,21030,2172340397.2757,1559912066158886842.4337,14247,13.3547,0.0024,0.0121
31705,101049,69344,8190,2137214831.5904,1540064396733649792.6375,69345,13.6147,0.0052,0.0006
9338,91906,82568,2282,2139858583.9135,1540289255532526319.0731,82569,21.7081,0.0043,0.0007
640,45816,45176,19915,2154503057.3876,1528565999868886548.098,45177,10.0641,0.0016,0.004
669,88950,88281,23737,2139179504.1623,1540769470748724329.911,88282,9.5552,0.0033,0.0007
21392,24762,3370,21989,2075384318.55,1536133316448711599.564,3371,14.7251,0.027,0.0004
24858,53760,28902,6174,2135324699.0406,1529916874989294818.1722,28903,10.2311,0.007,0.0002
2748,82624,79876,189,2153370838.6963,1544010441570770585.4704,79877,13.6049,0.0014,0.0034
10521,94583,84062,1688,2135695775.4268,1534062508393216388.0786,84063,16.3714,0.0048,0.000
14866,55486,40620,15227,2152551836.4088,1544923324552377315.7625,40621,4.8643,0.0018,0.0032
24071,117819,93748,17158,2148471627.3543,1534856214490695230.9814,93749,3.8452,0.001,0.0019
28501,88781,60280,27266,2139113167.4925,1528513670302774531.2371,60281,6.7786,0.0041,0.0006
12527,21882,9355,28865,2103745916.5825,1528960749099855100.7592,9356,16.1039,0.0161,0.0001
14813,59455,44642,11815,2148585013.9775,1541612128130096747.3507,44643,7.4186,0.0017,0.0028
14233,58288,44055,25319,2149461188.8321,1538206464316697404.2786,44056,2.0538,0.0014,0.0025
32395,104126,71731,30320,2148277431.7423,1534949020135127654.9598,71732,4.6404,0.0016,0.002
28491,48510,20019,26634,2148800094.2177,1527011193518873989.9148,20020,14.842,0.0034,0.0042
12589,30243,17654,9018,2142282840.3622,1533998120522345963.976,17655,21.078,0.0071,0.0032
26923,42131,15208,9206,2136898722.8636,1545362867855301510.983,15209,4.5736,0.0069,0.0018
18296,115377,97081,22807,2148277964.0217,1538509632988260473.0028,97082,13.8774,0.0026,0.0024
11751,108436,96685,14439,2151885327.6647,1528743566634677192.2134,96686,7.5192,0.0017,0.0035
6856,88873,82017,26508,2144545793.4927,1542499539291335562.8972,82018,7.6559,0.0025,0.001
19716,36653,16937,3301,2133622946.404,1540256530818347965.4212,16938,8.9526,0.0076,0.0006
23742,34861,11119,25691,2151548027.2496,1543959403001183236.3945,11120,6.0947,0.0029,0.0057
15174,52672,37498,4347,2141662947.2797,1537097828322044017.7449,37499,5.6999,0.0046,0.001
9455,11327,1872,28336,2145104019.8457,1477946639607107735.6521,1873,10.4315,0.0145,0.0111
11268,90414,79146,31013,2157051971.8848,1534338545810251903.0866,79147,17.0621,0.0003,0.0044
11300,18710,7410,9809,2113230815.4916,1548405361476692867.5529,7411,13.6389,0.0163,0.0006
26798,48263,21465,13707,2138017906.9546,1547341320161881658.7288,21466,19.4168,0.009,0.0036
24807,102245,77438,12493,2147077258.1395,1536857144172299352.3532,77439,24.1783,0.0025,0.0021
3092,101242,98150,13540,2142694159.0618,1543676121647653727.3461,98151,7.215,0.0032,0.0005
15766,99930,84164,26167,2144890502.6403,1549759077789405769.8245,84165,12.8722,0.003,0.0027
20914,64534,43620,19116,2150098412.2062,1551997725817591413.9501,43621,8.6686,0.0027,0.0043
14703,64843,50140,24882,2152954523.3916,1526656797051402815.8387,50141,13.6512,0.0017,0.0039
20613,48854,28241,30184,2142384138.0385,1550877604530682193.5895,28242,11.9374,0.0053,0.003
3730,88288,84558,13035,2147862447.8991,1539095977570103159.2503,84559,5.8112,0.0018,0.0026
6448,61869,55421,19565,2143110902.5429,1537372114524788139.7243,55422,4.0171,0.003,0.0005
21160,110917,89757,16752,2151806650.2519,1543103104625541154.2825,89758,4.1919,0.0009,0.0029
16528,65660,49132,108,2153002989.0893,1535898033298062215.9607,49133,7.4578,0.0007,0.0043
2111,14835,12724,8487,2106051252.4025,1537868256980826462.4261,12725,22.2998,0.0154,0.0009
25420,114038,88618,19252,2141831620.5108,1539524490366325235.2609,88619,12.7474,0.0032,0.0002
29701,91006,61305,8771,2142737652.0213,1540900693455681939.852,61306,5.7556,0.0039,0.0005
13455,102357,88902,28555,2139768507.4185,1539280538839629246.6792,88903,14.2308,0.004,0.000
25409,36150,10741,31241,2120203277.8772,1537961991654543474.1196,10742,13.6439,0.0106,0.0003
5508,21632,16124,18097,2141616604.3204,1521570601156910795.8424,16125,15.5287,0.007,0.0033
25138,71027,45889,2127,2148506977.3649,1529901792559391316.3197,45890,6.3925,0.002,0.0029
8086,52105,44019,152,2153578957.1087,1540051988173212419.4708,44020,8.1001,0.0012,0.0057
8096,59274,51178,28269,2145806883.5749,1544859600839123402.5703,51179,4.4567,0.0028,0.0027
22882,115382,92500,24718,2157245775.316,1540196178933541735.166,92501,14.3669,0.000,0.0039
19487,42462,22975,11849,2157482975.6337,1530518328448099374.5497,22976,6.459,0.0011,0.0062
4273,4797,524,12001,2238258973.8133,1551761443983161381.569,525,11.1365,0.0051,0.0435
27070,126663,99593,794,2155000863.0225,1541268132000312570.1808,99594,8.0458,0.0003,0.0042
24491,44724,20233,8808,2147641297.2031,1552178681719935717.2177,20234,6.7512,0.0043,0.0046
2361,93012,90651,12717,2144960638.5889,1534195673153938594.4762,90652,5.8383,0.0023,0.0013
597,74420,73823,20605,2142272635.4567,1544677307825309994.438,73824,13.9616,0.0035,0.0012
26844,105493,78649,6094,2151505215.5084,1538515391399603979.9343,78650,3.8116,0.0008,0.0025
10301,47856,37555,25653,2152779776.0513,1529940476692822465.6255,37556,5.4492,0.0014,0.0041
9714,70441,60727,27912,2150844196.7446,1536545991405011843.8067,60728,4.5157,0.0007,0.0026
23665,47855,24190,10595,2160038946.3875,1516902565229187302.4731,24191,17.2087,0.0019,0.007
18598,57091,38493,16294,2131946008.9945,1536777555023238357.8454,38494,7.0992,0.0056,0.000
2218,40876,38658,28309,2148445962.8746,1553062823309958125.5215,38659,20.3176,0.0042,0.004
6067,54496,48429,4741,2157635652.9275,1533656377183754328.9384,48430,8.4144,0.000,0.0052
7302,57559,50257,19458,2148811242.0177,1540693622108029636.872,50258,5.5205,0.002,0.0037
13501,62228,48727,1329,2143567521.7709,1551923497493280875.6854,48728,15.1643,0.0045,0.0022
1953,58052,56099,4875,2149289464.7712,1529085770008747183.5932,56100,8.354,0.0019,0.0026
29189,79442,50253,29066,2134153194.7535,1552511419300891160.2736,50254,35.118,0.0074,0.0016
18734,49645,30911,17149,2169750720.3157,1537596392160471196.8144,30912,13.5378,0.0007,0.0087
8022,24364,16342,31811,2146315213.028,1542419700670775970.586,16343,2.9915,0.0026,0.0025
22412,82108,59696,31502,2146395971.3148,1536608691764286321.2584,59697,4.1617,0.0023,0.0021
8239,61379,53140,2827,2158103991.1716,1540231284328083367.6009,53141,15.4548,0.0005,0.0048
18335,42517,24182,23096,2150772146.5138,1543448843268484983.2034,24183,26.5942,0.004,0.0068
26721,50865,24144,31540,2140516002.3731,1533043903759474809.1053,24145,4.9525,0.0069,0.0015
15312,21904,6592,8716,2135232606.5312,1526797199947776137.3918,6593,2.9142,0.0084,0.0028
29681,65102,35421,32447,2139489416.8881,1534889921373390467.039,35422,5.6523,0.0051,0.001
27157,81386,54229,17721,2142653552.9659,1533965911132540405.2895,54230,3.8271,0.0033,0.001
27633,92476,64843,15596,2141465006.2375,1543743051325582265.4915,64844,6.6261,0.0033,0.0009
984,35518,34534,7238,2144339619.4747,1533792668825710147.9967,34535,10.9272,0.0039,0.0027
4098,30422,26324,17528,2163644686.4174,1537114170344040515.8882,26325,16.9715,0.0004,0.011
20366,45093,24727,14598,2151297863.0704,1542590638127888803.6086,24728,3.9524,0.0019,0.0048
30772,102566,71794,26335,2153730614.3792,1535333942313410592.8451,71795,6.5858,0.0006,0.0029
2843,55490,52647,22402,2141933799.6188,1529160255655553871.5652,52648,11.2567,0.0039,0.0016
23482,81663,58181,12666,2141936755.6666,1529880896647223998.4536,58182,6.7668,0.0032,0.0017
32115,124250,92135,9879,2161649806.0402,1539423101331648762.3214,92136,14.2206,0.0002,0.0067
17550,99433,81883,9417,2156260234.3697,1539547782433987766.5863,81884,16.1514,0.0002,0.0038
14299,63652,49353,12683,2145899262.7625,1528925610488770229.4771,49354,11.7467,0.0032,0.0034
29271,87990,58719,28633,2147087449.039,1538133456143797667.5513,58720,12.5696,0.0019,0.0017
17187,101666,84479,20374,2146415188.0455,1535357094818663485.9525,84480,5.7286,0.0019,0.0012
19425,38426,19001,21449,2172702607.6924,1552280511150154622.823,19002,15.4678,0.0002,0.0106
21050,30410,9360,6972,2134721573.3772,1544892496168030437.3598,9361,4.8811,0.0071,0.0009
16433,114831,98398,8351,2143616568.5952,1530892242260931519.2477,98399,7.462,0.0024,0.0012
32352,100216,67864,29414,2150832188.1096,1529619172353054972.9417,67865,7.8691,0.0014,0.0032
32017,61387,29370,12677,2147772762.8087,1528082030914769412.032,29371,6.2223,0.0025,0.0023
13345,112435,99090,14541,2146276964.1068,1538098694970065455.3496,99091,7.6201,0.0021,0.001
18268,69129,50861,4544,2140804172.1564,1538632540779537696.6571,50862,14.2332,0.0044,0.0015
30890,113500,82610,2384,2145651064.3429,1539131303711245923.4593,82611,1.9411,0.0017,0.0013
2506,6851,4345,31767,2177251154.1203,1541709369167667267.4943,4346,13.6987,0.0021,0.0145
31972,83301,51329,9170,2155651997.8188,1533185304544525361.7548,51330,9.3101,0.0008,0.0048
28686,45052,16366,32001,2152614255.7662,1529099281922832568.3137,16367,3.0006,0.0016,0.0044
7327,104557,97230,10222,2146137760.5913,1543132639386434266.2733,97231,8.4403,0.0022,0.0014
18981,117851,98870,29928,2144180929.9989,1532368169544968366.13,98871,20.7026,0.0031,0.0012
28507,102744,74237,7217,2150382494.4576,1541787498239664753.6548,74238,5.3745,0.0013,0.0023
10713,14026,3313,8852,2137930896.1892,1499244416674381921.5819,3314,2.8252,0.0129,0.0078
29204,72744,43540,11622,2134445937.4727,1542703657792786927.5927,43541,14.3216,0.0053,0.0004
19282,113630,94348,6121,2151151859.8304,1535341299396427510.0182,94349,10.0939,0.0008,0.0024
2138,2672,534,29079,2208391468.6206,1564008569794813800.7588,535,7.8698,0.0056,0.0364
10286,32317,22031,12507,2155164755.8065,1534996321341826733.6259,22032,4.7491,0.0013,0.0042
18406,106245,87839,9829,2144293558.1441,1536149790111334328.4115,87840,2.177,0.0023,0.0002
22151,97695,75544,23974,2140099964.3819,1537591376786237591.5414,75545,5.7522,0.0036,0.0003
25459,62365,36906,22083,2152128896.0124,1538162626198807963.7794,36907,6.0938,0.001,0.0033
1123,89489,88366,19461,2152484732.4877,1533136796319837562.7697,88367,2.6622,0.0008,0.0029
11474,95795,84321,19155,2152186360.3195,1538325886123849055.5006,84322,5.7791,0.0007,0.0022
6030,38426,32396,3344,2140196965.5306,1536928854812543727.1191,32397,8.9501,0.0041,0.0008
16401,32380,15979,26731,2158132005.0439,1533140629475508049.9369,15980,8.0151,0.0018,0.0062
29120,115760,86640,9741,2142062205.6357,1536001955620506197.45,86641,6.4588,0.0039,0.0007
30276,94695,64419,1911,2153829085.4913,1537888448158795581.0507,64420,10.0814,0.0003,0.0035
22035,47550,25515,10139,2156679258.9921,1522403617972121893.7914,25516,7.5594,0.0015,0.0058
27315,32478,5163,21693,2146467483.8563,1537430449290401783.2338,5164,7.9144,0.0077,0.0103
416,13989,13573,25543,2130304047.0123,1509213921382703674.1854,13574,12.3835,0.0096,0.0032
30590,96030,65440,12194,2145695239.9643,1537796912293237322.2923,65441,2.2619,0.0017,0.0007
1727,40338,38611,11307,2168251889.7911,1540805636715839215.0931,38612,20.6924,0.0003,0.0101
26294,92193,65899,4318,2141402038.2389,1541271945375539604.268,65900,13.3271,0.0028,0.0003
11813,61940,50127,18223,2150218279.2613,1537641210803335266.9131,50128,5.7992,0.0016,0.0024
32660,81054,48394,7411,2145799375.2913,1541746027310186706.6002,48395,4.8546,0.0028,0.002
19118,57210,38092,10761,2140560095.3053,1550393168234080237.883,38093,12.5764,0.0051,0.0021
28502,122657,94155,5848,2146314591.3292,1533013679807209928.6549,94156,5.8346,0.0016,0.0012
3712,19686,15974,7105,2143769754.1402,1507911435100743358.0486,15975,15.6385,0.0073,0.0049
27796,38194,10398,3464,2166270053.4872,1550403703483256331.9773,10399,5.3753,0.0015,0.0092
11436,29039,17603,30158,2172172929.3378,1545208844034571171.3493,17604,12.9192,0,0.0093
28250,81695,53445,29652,2127887043.6088,1527434602345550913.3894,53446,19.6893,0.008,0.0001
14495,48003,33508,7578,2153727340.1584,1542885613013009360.7268,33509,13.4074,0.0017,0.0052
7648,87147,79499,31800,2149010206.1147,1537670497512542664.5975,79500,4.0941,0.0013,0.0016
31085,35548,4463,14400,2139794391.4355,1525704078268406633.5218,4464,9.3141,0.0158,0.0077
18324,72687,54363,3165,2131001556.8025,1535364227295879218.7038,54364,10.9849,0.0059,0.0002
2380,7364,4984,1111,2149944214.7922,1506799622316843399.3157,4985,16.8683,0.0104,0.0102
18999,27569,8570,10509,2149850105.7334,1527617185860939233.4491,8571,4.267,0.0048,0.0057
15570,92712,77142,20250,2141735700.4087,1540136733076092594.2755,77143,20.2467,0.003,0.0012
29929,53144,23215,9320,2175896243.2808,1558245744290174018.9339,23216,18.0692,0.0001,0.0118
26340,109335,82995,13329,2147561345.2103,1539240721993857821.0913,82996,0.8631,0.0016,0.001
2880,24710,21830,19015,2133316881.3421,1555011875651118809.8755,21831,13.9596,0.007,0.0019
11088,61705,50617,27397,2139712342.6665,1546411662849687743.5636,50618,11.8205,0.0041,0.0003
15332,21081,5749,6764,2135172101.7664,1514631207059211126.4719,5750,10.9564,0.012,0.0068
18013,55712,37699,21837,2137276979.7941,1537735298208688777.39,37700,12.1008,0.0072,0.0025
2480,40125,37645,10867,2167738853.8846,1541249145554041565.0011,37646,17.9082,0.000,0.0087
2165,65244,63079,24146,2150500264.6493,1541089603912261459.4205,63080,7.1221,0.0013,0.0022
175,2859,2684,16141,2202068094.333,1541766400750329133.7342,2685,10.0242,0.0006,0.023
10858,61725,50867,26544,2151029224.6446,1528565938879016264.6999,50868,5.3957,0.0022,0.0028
7360,58342,50982,10484,2131825638.9329,1545701138192400237.1419,50983,30.1595,0.0069,0.000
20760,109871,89111,14488,2157891803.0368,1539232074924653041.2982,89112,11.1856,0.0006,0.0046
12013,99383,87370,8789,2149741141.1459,1539723828269010668.1407,87371,7.5803,0.0009,0.0018
10786,97057,86271,29146,2153288270.7878,1538055315977335475.268,86272,6.1528,0.0004,0.0028
18872,51412,32540,5567,2150256219.8831,1538490957611295809.4712,32541,4.1225,0.0018,0.0032
19866,57797,37931,23332,2132813076.3748,1539678375670376876.811,37932,16.245,0.0081,0.0009
16601,58316,41715,1044,2162571738.8485,1542021323397915943.4164,41716,14.8121,0.0003,0.0085
4763,80548,75785,7500,2149173327.5373,1537368444258009354.4588,75786,20.2672,0.0017,0.0029
13860,31177,17317,10122,2138326456.1481,1534698240374752170.4642,17318,3.5796,0.0051,0.0007
2930,64506,61576,14335,2161572063.0596,1532326082185166868.019,61577,15.6312,0.000,0.0068
27996,45406,17410,24466,2158912890.509,1532112639235512738.036,17411,3.9626,0.0016,0.0063
2693,74115,71422,27592,2146451012.5507,1538092243160560345.1422,71423,8.6994,0.0022,0.0022
16854,108465,91611,5336,2151278444.7285,1536161392549158617.9677,91612,4.837,0.0002,0.002
10063,55894,45831,26212,2131424942.5662,1535922165640804773.9403,45832,12.2702,0.0055,0.0002
32584,48123,15539,7408,2141366607.1448,1553320707693717498.8157,15540,9.7264,0.0064,0.003
11287,15618,4331,27664,2131370749.9912,1501679155917625883.9459,4332,3.6153,0.0115,0.0056
16464,17809,1345,6337,2069352302.0052,1555632141739964461.1419,1346,13.4904,0.0429,0.0042
26131,92854,66723,7404,2155242338.5206,1534296252779675877.2995,66724,7.3615,0.0001,0.0038
10130,85543,75413,12784,2148461769.8505,1536766130004332059.0582,75414,11.5179,0.0016,0.0028
9620,40812,31192,18264,2144423314.1339,1537781408299061082.8019,31193,9.909,0.0041,0.0022
13606,103983,90377,4518,2144600324.0254,1543105474160075983.2416,90378,8.5497,0.0026,0.0012
32124,100450,68326,6212,2144547294.4467,1544225483392337585.7783,68327,8.1482,0.0035,0.0016
27160,28672,1512,6300,2161874212.9755,1544759478335686852.7192,1513,11.4815,0.0148,0.0149
20708,62889,42181,24740,2153577918.5661,1529693464513353605.492,42182,10.2462,0.001,0.0045
26030,67552,41522,14276,2131942365.4794,1524330679305074144.1941,41523,14.4768,0.0087,0.0013
23035,95668,72633,13742,2141987047.3606,1531889818291402959.2153,72634,9.3973,0.0035,0.001
28358,44990,16632,25562,2150019345.9221,1556617434020875711.709,16633,26.6979,0.0057,0.0067
15960,38029,22069,18909,2146560646.5574,1536453548888331700.2299,22070,10.8558,0.0034,0.0031
4438,73859,69421,22326,2147119305.4833,1528492329337365535.7143,69422,11.8115,0.0017,0.0024
25482,118559,93077,10687,2142466117.3878,1543819785502802592.532,93078,16.8105,0.0034,0.0006
